ܐܦܪܝܩܐ	Afrika
ܝܦܢ	Japan
ܐܡܪܝܩܐ ܬܝܡܢܝܬܐ	Zuid-Amerika
ܢܘܪܒܝܓ	Noorwegen
ܩܘܛܢܝܘܬܐ ܕܐܝܪܠܢܕ	Ierland (land)
ܡܓܪ	Hongarije
ܐܣܦܢܝܐ	Spanje
ܐܘܚܕܢܐ ܡܚܝܕܐ	Verenigde Staten
ܒܠܓܝܩܐ	België
ܠܘܟܣܡܒܘܪܓ	Luxemburg (land)
ܬܒܝܠ	Heelal
ܐܪܥܐ	Aarde (planeet)
ܡܘܬܐ	Dood
ܒܪ ܐܢܫܐ	Mens
ܓܘܪܓ ܘܐܫܝܢܓܛܘܢ	George Washington
ܦܝܢܠܢܕ	Finland
ܣܘܝܕ	Zweden
ܕܐܢܡܐܪܩ	Denemarken
ܦܘܠܢܕ	Polen
ܠܬܘܢܝܐ	Litouwen
ܐܝܛܠܝܐ	Italië
ܣܘܝܣܪܐ	Zwitserland
ܢܡܣܐ	Oostenrijk
ܝܘܢ	Griekenland
ܛܘܪܩܝܐ	Turkije
ܦܘܪܛܘܓܠ	Portugal
ܐܘܪܘܦܐ (ܝܒܫܬܐ)	Europa (werelddeel)
ܐܣܝܐ (ܝܒܫܬܐ)	Azië
ܐܡܪܝܩܐ ܓܪܒܝܝܬܐ	Noord-Amerika
ܐܢܛܐܪܩܛܝܩܐ	Antarctica
ܘܝܩܝܦܕܝܐ	Wikipedia
ܗܘܠܢܕܐ	Nederland
ܢܝܘ ܝܘܪܩ (ܡܕܝܢܬܐ)	New York City
ܘܐܫܢܓܛܘܢ (ܐܪܫܟܝܬܐ)	Washington D.C.
ܒܪܠܝܢ	Berlijn
ܚܫܘܒܐ (ܡܐܟܢܐ)	Computer
ܒܪܢ	Bern (stad)
ܬܣܝܪܝܟ	Zürich (stad)
ܐܢܛܪܢܛ	Internet
ܒܪܐܩ ܐܘܒܐܡܐ	Barack Obama
ܠܘܢܕܘܢ	Londen
ܐܠܟܣܢܕܪܝܐ	Alexandrië
ܚܙܘܪܐ	Appel (plant)
ܦܐܪܝܣ	Parijs
ܡܟܣܝܩܘ	Mexico (land)
ܐܘܩܝܢܘܣ ܐܛܠܢܛܝܐ	Atlantische Oceaan
ܐܘܩܝܢܘܣ ܫܝܢܝܐ	Grote Oceaan
ܒܘܣܛܘܢ	Boston
ܬܪܝܢܒܫܒܐ	Maandag
ܟܢܘܢ ܒ	Januari
ܫܒܛ	Februari
ܐܕܪ	Maart
ܟܘܫ	Ethiopië
ܢܝܣܢ	April
ܐܝܪ	Mei
ܚܙܝܪܢ	Juni
ܬܡܘܙ	Juli
ܐܒ	Augustus (maand)
ܐܝܠܘܠ	September
ܬܫܪܝܢ ܐ	Oktober
ܬܫܪܝܢ ܒ	November
ܟܢܘܢ ܐ	December
ܬܠܬܒܫܒܐ	Dinsdag
ܐܪܒܥܒܫܒܐ	Woensdag
ܚܡܫܒܫܒܐ	Donderdag
ܥܪܘܒܬܐ	Vrijdag
ܫܒܬܐ (ܙܒܢܐ)	Zaterdag
ܚܕܒܫܒܐ	Zondag
ܐܪܝܐ	Leeuw (dier)
ܦܪܢܣܐ	Frankrijk
ܟܠܒܐ	Hond
ܡܠܟܘܬܐ ܡܚܝܕܬܐ	Verenigd Koninkrijk
ܩܛܐ	Kat (dier)
ܩܘܛܢܝܘܬܐ ܥܡܡܝܬܐ ܕܨܝܢ	Volksrepubliek China
ܠܫܢܐ ܦܪܢܣܝܐ	Frans
ܒܪܐܙܝܠ	Brazilië
ܪܘܣܝܐ	Rusland
ܝܡܐ	Zee
ܝܡܐ ܐܘܟܡܐ	Zwarte Zee
Π	Pi (letter)
ܐܠܒܐܡܐ	Alabama
ܣܐܘ ܦܐܘܠܘ	São Paulo (stad)
ܩܝܒܩ (ܗܘܦܪܟܝܐ)	Quebec (provincie)
ܓܪܡܢ	Duitsland
ܒܠܐܪܘܣ	Wit-Rusland
ܠܫܢܐ ܓܪܡܢܝܐ	Duits
ܐܠܗܐ	God (monotheïsme)
ܐܣܛܘܢܝܐ	Estland
ܛܝܣܬܐ	Vliegtuig
ܩܪܒܐ	Oorlog
1 (ܡܢܝܢܐ)	1 (getal)
2 (ܡܢܝܢܐ)	2 (getal)
3 (ܡܢܝܢܐ)	3 (getal)
4 (ܡܢܝܢܐ)	4 (getal)
5 (ܡܢܝܢܐ)	5 (getal)
ܠܐܛܒܝܐ	Letland
ܐܘܩܪܐܝܢܐ	Oekraïne
ܬܫܝܟ	Tsjechië
ܣܠܘܒܩܝܐ	Slowakije
ܣܠܘܒܢܝܐ	Slovenië
ܡܘܠܕܘܒܐ	Moldavië (land)
ܪܘܡܢܝܐ	Roemenië
ܒܘܠܓܐܪܝܐ	Bulgarije
ܪܗܘܡܐ (ܡܕܝܢܬܐ)	Rome (stad)
ܩܘܛܢܝܘܬܐ ܕܡܩܕܘܢܝܐ	Macedonië (land)
ܐܠܒܢܝܐ	Albanië
ܩܪܘܐܛܝܐ	Kroatië
ܒܘܣܢܐ ܘܗܪܬܣܓܘܒܝܢܐ	Bosnië en Herzegovina
ܐܙܪܒܝܓܐܢ	Azerbeidzjan
ܐܢܕܘܪܐ	Andorra
ܩܘܦܪܘܣ	Cyprus
ܓܘܪܓܝܐ (ܐܬܪܐ)	Georgië
ܩܙܩܣܛܐܢ	Kazachstan
ܡܝܠܛܐ	Malta (land)
ܡܘܢܐܩܘ	Monaco
ܛܘܪܐ ܐܘܟܡܐ	Montenegro
ܡܕܝܢܬܐ ܕܘܛܝܩܢ	Vaticaanstad
ܣܢ ܡܪܝܢܘ	San Marino
ܒܪܘܟܣܠ	Brussels Hoofdstedelijk Gewest
ܠܘܕܒܝܓ ܒܐܢ ܒܝܛܗܘܒܢ	Ludwig van Beethoven
ܠܫܢܐ ܛܘܪܩܝܐ	Turks
ܓܙܐܐܪ	Algerije
ܐܘܙܒܩܣܛܐܢ	Oezbekistan
ܘܐܪܣܘ	Warschau
ܚܡܪܐ (ܫܬܝܐ)	Wijn
ܡܝܐ	Water
ܦܪܣ ܚܙܘܐ	Televisie
ܬܫܝܠܝ	Chili
ܐܠ ܓܪܝܩܘ	El Greco
ܝܫܘܥ	Jezus (traditioneel-christelijk)
ܠܫܢܐ (ܡܡܠܠܐ)	Taal
ܫܘܠܛܢ ܛܪܘܢܘܬܐ	Dictatuur
ܡܡܠܠܘܬ ܟܘܟܒܐ	Astronomie
ܡܪܝܡ (ܐܡܗ ܕܝܫܘܥ)	Maria (moeder van Jezus)
ܠܝܟܛܢܫܛܝܢ	Liechtenstein
ܐܕܘܠܦ ܗܝܛܠܪ	Adolf Hitler
ܠܝܢܘܟܣ	Linux
ܠܫܢܐ ܠܐܛܝܢܝܐ	Latijn
ܒܚܪܝܢ	Bahrein
ܐܪܡܢܝܐ	Armenië
ܣܪܒܝܐ	Servië
ܣܗܪܐ	Maan
ܐܝܣܛܢܒܘܠ (ܡܕܝܢܬܐ)	Istanboel
ܐܘܣܛܪܠܝܐ (ܐܬܪܐ)	Australië (land)
ܦܝܣܝܟ	Natuurkunde
ܩܘܪܐܢ	Koran
ܐܣܠܐܡ	Islam
ܟܡܬܪܐ	Peer (plant)
ܠܟ ܒܐܘܢܣܐ	Lech Wałęsa
ܫܠܡܐ (ܫܝܢܐ)	Vrede
ܚܘܝܕܐ ܐܘܪܘܦܝܐ	Europese Unie
ܐܢܬܬܐ	Vrouw
ܛܝܙܐ	Anus (anatomie)
ܫܚܬܐ (ܝܘܠܦܢ ܨܪܘܝܘܬܐ)	Oksel
ܗܒܒܐ	Bloem (plant)
ܝܘܠܦܢ ܨܪܘܝܘܬܐ	Anatomie
ܡܕܝܢܬܐ	Stad
ܢܐܦܠܝܘܢ ܒܘܢܐܦܪܛ	Napoleon Bonaparte
ܟܘܟܒܐ	Ster (hemellichaam)
ܫܡܫܐ	Zon
ܩܪܝܬܐ	Dorp
ܝܡܐ ܕܡܕܢܚܐ	Oostzee
ܫܢܐ	Tand
ܘܝܩܝܡܝܕܝܐ ܩܘܡܡܘܢܣ	Wikimedia Commons
ܟܬܒܐ (ܣܦܪܐ)	Boek (document)
ܝܘܡܐ	Dag
ܠܠܝܐ	Nacht
ܫܢܬܐ (ܙܒܢܐ)	Jaar
ܕܪܐ	Eeuw
ܐܘܣܠܘ	Oslo
ܠܫܒܘܢܐ	Lissabon
ܦܠܝܛܐ	Planeet
ܙܡܪܘܬܐ	Muziek
ܡܘܣܩܒܐ	Moskou
ܠܫܢܐ ܐܝܛܠܝܐ	Italiaans (taal)
ܬܫܐܕ	Tsjaad
ܬܝܡܢܐ	Noord (windstreek)
ܢܝܘ ܙܝܠܢܕ	Nieuw-Zeeland
ܓܪܒܝܐ	Zuid
ܗܢܕܘ	India
ܦܪܙܠܐ	IJzer (element)
ܡܥܪܒܐ	West
ܡܕܢܚܐ	Oost (windstreek)
ܒܢܙܘܝܠܐ	Venezuela
ܛܠܦܣܢܐ	Schaken
ܡܝܢ	Maine
ܣܘܣܝܐ	Paard (dier)
ܐܡܣܛܪܕܐܡ	Amsterdam
ܙܝܢܐ	Gevechtswapen
ܚܝܘܬܐ	Dierenrijk
ܩܘܠܘܡܒܝܐ	Colombia
ܢܝܘ ܗܐܡܦܫܪ	New Hampshire
ܠܝܘܢܪܕܘ ܕܗ ܒܢܬܫܝ	Leonardo da Vinci
ܡܐܣܐܬܫܘܣܬܣ	Massachusetts
ܐܘܛܪܝܟܛ (ܗܘܦܪܟܝܐ)	Utrecht (provincie)
ܟܘܢܝܬܝܟܬ	Connecticut
ܐܝܪܐܢ	Iran
ܥܝܪܐܩ	Irak
ܐܠܐܣܟܐ	Alaska
ܐܝܣܪܐܝܠ	Israël
ܐܘܛܪܝܟܛ (ܡܕܝܢܬܐ)	Utrecht (stad)
ܝܡܢ	Jemen
ܠܫܢܐ ܦܘܠܢܕܝܐ	Pools
ܝܘܪܕܢܢ	Jordanië
ܩܝܪܓܝܙܣܛܐܢ	Kirgizië
ܐܪܝܙܘܢܐ	Arizona (staat)
ܟܘܘܝܬ (ܐܬܪܐ)	Koeweit
ܠܒܢܢ	Libanon
ܐܘܪܝܓܘܢ	Oregon
ܐܡܪܝܩܐ	Amerika (continent)
ܝܘܬܐ	Utah
ܥܘܡܐܢ	Oman
ܦܐܩܣܛܐܢ	Pakistan
ܩܛܪ	Qatar
ܣܥܘܕܝܐ	Saoedi-Arabië
ܝܘܣܦ ܣܛܐܠܝܢ	Jozef Stalin
ܣܘܪܝܐ	Syrië
ܛܐܓܝܩܣܛܐܢ	Tadzjikistan
ܦܪܣ ܩܠܐ	Radio
ܛܘܪܩܡܢܣܛܐܢ	Turkmenistan
ܐܡܝܪܘܬܐ ܥܪܒܝܬܐ ܡܚܝܕܬܐ	Verenigde Arabische Emiraten
ܐܦܓܐܢܣܛܐܢ	Afghanistan
ܕܗܒܐ	Goud
ܡܠܝ	Mali
ܦܝܠܝܦܝܢܝܐ	Filipijnen
ܩܘܛܢܝܘܬܐ ܕܐܦܪܝܩܐ ܡܨܥܝܬܐ	Centraal-Afrikaanse Republiek
ܐܝܣܚܩ ܢܝܘܛܢ	Isaac Newton
ܫܥܘܬܐ (ܓܘܢܐ)	Geel (kleur)
ܬܘܢܣ (ܐܬܪܐ)	Tunesië
ܬܝܡܢܐ ܕܣܘܕܐܢ	Zuid-Soedan
ܩܘܛܢܝܘܬܐ ܕܩܘܢܓܘ	Congo-Brazzaville
ܩܘܛܢܝܘܬܐ ܕܩܘܢܓܘ ܕܝܡܘܩܪܛܝܬܐ	Congo-Kinshasa
ܦܐܦܐ ܝܘܚܢܢ ܦܘܠܘܣ ܬܪܝܢܐ	Paus Johannes Paulus II
ܛܒܝܠܝܣܝ	Tbilisi
ܩܐܡܪܘܢ	Kameroen
ܠܘܒܐ	Libië
ܡܘܪܝܛܢܝܐ	Mauritanië
ܡܓܪܒ	Marokko
ܢܝܓܪ	Niger (land)
ܣܘܕܐܢ	Soedan
ܩܫܬܐ ܕܡܪܢ	Regenboog (optica)
ܗܐܡܒܘܪܓ	Hamburg
ܝܡܬܐ ܕܐܘܢܛܪܝܘ	Ontariomeer
ܝܡܬܐ ܕܣܘܦܝܪܝܘܪ	Bovenmeer
ܓܐܘܓܪܦܝܐ	Aardrijkskunde
ܠܒܐ	Hart
ܡܘܚܐ	Hersenen
ܓܠܕܐ	Huid
ܓܘܢܐ	Kleur
ܦܪܐܓ	Praag
ܙܪܩܐ	Blauw (kleur)
ܟܣܦܐ (ܣܐܡܐ)	Zilver
ܡܫܝܓܢ	Michigan
ܝܡܬܐ ܕܡܝܫܝܓܢ	Michiganmeer
ܐܠܝܢܘܝ	Illinois (staat)
ܢܘܪܬ ܕܐܟܘܬܐ	North Dakota
ܣܐܘܬ ܕܐܟܘܬܐ	South Dakota
ܡܘܢܬܐܢܐ	Montana (staat)
ܘܐܝܘܡܝܢܓ	Wyoming
ܐܘܪܫܠܡ	Jeruzalem
ܐܝܕܐܗܘ	Idaho
ܢܝܒܐܕܐ	Nevada (staat)
ܐܘܩܝܢܘܣ ܗܢܕܘܝܐ	Indische Oceaan
ܟܘܠܘܪܐܕܘ	Colorado (staat)
ܫܝܩܓܘ	Chicago
ܣܬܘܐ	Winter
ܬܕܐܐ	Lente
ܩܝܛܐ	Zomer
ܬܫܪܝܬܐ	Herfst
ܨܕܐܡ ܚܘܣܝܢ	Saddam Hoessein
ܠܫܢܐ ܐܣܦܢܝܐ	Spaans
ܓܘܓܝ	Spinnen (dieren)
ܐܒܐ (ܦܐܪܐ)	Vrucht (plant)
ܒܪܓܝܢܝܐ	Virginia (staat)
ܝܡܬܐ ܕܝܘܪܘܢ	Huronmeer
ܢܝܘ ܝܘܪܩ (ܐܘܚܕܢܐ ܡܚܝܕܐ)	New York (staat)
ܪܘܕ ܐܝܠܐܢܕ	Rhode Island (staat)
ܪܚܫܐ	Insecten
ܡܐܪܝܠܐܢܕ	Maryland
ܕܝܠܐܘܝܪ	Delaware
ܐܘܗܐܝܘ	Ohio (staat)
ܦܢܣܝܠܒܐܢܝܐ	Pennsylvania
ܐܝܛܙܢ	Uetersen
ܐܓܘܣܛܘܣ ܩܣܪ	Imperator Caesar Augustus
ܢܝܘ ܓܝܪܣܝ	New Jersey
ܐܢܕܝܐܢܐ	Indiana
ܪܕܝܬܐ	Auto
ܓܘܪܓܝܐ (ܐܘܚܕܢܐ ܡܚܝܕܐ)	Georgia (staat)
ܣܩܠܝܐ	Sicilië
ܣܢ (ܢܗܪܐ)	Seine
ܛܘܩܝܘ	Tokio
ܦܪܕܝܢܢܕ ܡܓܝܠܢ	Ferdinand Magellaan
ܢܝܘ ܡܝܟܣܝܟܘ	New Mexico
ܐܬܢܘܣ	Athene (stad)
ܡܢܝܣܘܬܐ	Minnesota
ܒܓܕܐܕ (ܡܕܝܢܬܐ)	Bagdad
ܘܝܣܟܘܢܣܢ	Wisconsin
ܐܝܐܘܐ	Iowa (staat)
ܢܝܒܪܐܣܟܐ	Nebraska
ܟܐܢܣܐܣ	Kansas (staat)
ܡܝܙܘܪܝ	Missouri (staat)
ܐܪܟܢܣܐܣ	Arkansas (staat)
ܠܫܢܐ ܕܐܘܪܕܘ	Urdu
ܐܘܟܠܐܗܘܡܐ	Oklahoma
ܝܡܐ ܕܓܪܒܝܐ	Noordzee
ܒܝܝܢܐ	Wenen
ܩܘܦܢܗܐܓܢ	Kopenhagen
ܣܛܘܩܗܘܠܡ	Stockholm
ܗܠܣܢܩܝ	Helsinki
ܕܒܠܢ	Dublin
ܒܪܛܝܣܠܐܒܐ	Bratislava
ܟܬܒܐ ܩܕܝܫܐ	Bijbel (christendom)
ܥܕܬܐ ܫܪܝܪܬܐ ܕܝܫܘܥ	Ware Jezuskerk
ܠܫܢܐ ܐܢܓܠܝܐ	Engels
ܩܘܢܣܦܣܝܘܢ (ܬܫܝܠܝ)	Concepción (Chili)
ܐܘܢܛܐܪܝܘ	Ontario
ܡܐܢܝܛܘܒܐ	Manitoba
ܐܠܒܪܛܐ	Alberta
ܢܘܒܐ ܣܩܘܛܝܐ	Nova Scotia
ܩܘܢܣܩܘܒܘܠܐ	Końskowola
ܢܝܘ ܒܪܘܢܙܘܝܩ	New Brunswick
ܩܘܠܘܡܒܝܐ ܒܪܝܛܝܬܐ	Brits-Columbia
ܓܙܪܬܐ ܕܐܡܝܪܐ ܐܕܘܐܪܕ	Prins Edwardeiland (Canada)
ܣܐܣܩܐܬܫܘܐܢ	Saskatchewan
2012	2012
2011	2011
2010	2010
2009	2009
ܢܝܘܦܐܘܢܕܠܢܕ ܘܠܐܒܪܐܕܘܪ	Newfoundland en Labrador
2008	2008
ܐܘܚܕܢܐ ܓܪܒܝܝܐ-ܡܥܪܒܝܐ	Northwest Territories
ܝܘܩܘܢ	Yukon (territorium)
2005	2005
2006	2006
ܢܘܢܐܒܘܛ	Nunavut
2007	2007
ܡܐܟܘܠܬܐ	Voedsel
ܚܘܝܐ	Slangen
ܩܘܪܘܦ	Kurów (powiat Puławski)
ܟܝܡܝܐ	Scheikunde
1968	1968
ܩܛܠܥܡܐ ܝܗܘܕܝܐ	Holocaust
ܡܕܪܝܕ (ܡܕܝܢܬܐ)	Madrid (stad)
ܗܘܦܪܟܝܣ ܘܐܘܚܕܢܐ ܕܩܢܕܐ	Bestuurlijke indeling van Canada
ܣܢܛܝܐܓܘ ܕܐ ܬܫܝܠܝ	Santiago (Chili)
ܚܐܪܘܬܐ	Vrijheid (filosofie)
ܣܝܕܢܝ	Sydney
ܝܪܘܩܐ	Groen (kleur)
ܡܠܒܘܪܢ	Melbourne
ܣܘܡܩܐ	Rood (kleur)
ܢܘܪܐ (ܕܠܩܐ)	Vuur
ܢܝܠܘܣ	Nijl
ܓܙܐܐܪ (ܡܕܝܢܬܐ)	Algiers
ܬܘܢܣ (ܡܕܝܢܬܐ)	Tunis
ܛܗܪܐܢ	Teheran
ܐܢܩܪܐ	Ankara
ܢܝܐܡܝ	Niamey
ܒܡܩܘ	Bamako
ܕܪܡܣܘܩ	Damascus
ܥܡܐܢ	Amman (stad)
ܒܝܪܘܬ	Beiroet
ܒܝܬ ܨܘܒܐ	Universiteit
ܒܝܬܐ (ܒܢܝܢܐ)	Huis (woning)
ܐܘܣܛܪܠܝܐ (ܝܒܫܬܐ)	Australië (continent)
ܢܗܪܐ	Rivier
ܪܝܫܐ ܕܣܒܪܐ ܛܒܐ	Kaap de Goede Hoop
ܫܘܚܡܠܐ	Investering
ܩܘܪܝܛܝܒܐ	Curitiba (gemeente)
ܥܒܐ	Bos (vegetatie)
ܩܘܢܦܘܫܝܘܣ	Confucius
ܩܢܐ	Vogelnest
ܐܘܪܘ	Euro
ܝܡܐ ܚܘܪܐ ܡܨܥܝܐ	Middellandse Zee
ܓܘܪܓܝܐ	Georgia
ܡܫܝܚܝܘܬܐ	Christendom
ܩܠܒܐ:ܐܘܝܐ	Sjabloon:Voor
ܪܘܙܐ	Rijst
ܝܒܫܬܐ	Continent
ܛܝܪܐ	Vogels
ܐܪܫܟܝܬܐ	Hoofdstad
ܠܫܢܐ ܦܘܪܛܘܓܠܝܐ	Portugees
ܝܪܚܐ	Maand
ܡܘܨܛܦܐ ܟܡܐܠ ܐܛܐܛܘܪܩ	Mustafa Kemal Atatürk
ܐܠܡܐܙܢ	Almazán (gemeente)
ܠܫܢܐ ܝܦܢܝܐ	Japans
ܦܐܬܐ ܪܝܫܝܬܐ	Hoofdpagina
ܦܪܢܣܝܣܩܘ ܓܘܝܐ	Francisco Goya
ܝܡܐ ܐܚܪܝܐ	Kaspische Zee
ܝܡܬܐ ܕܐܝܪܝ	Eriemeer
ܣܠܒܐܕܘܪ ܕܐܠܝ	Salvador Dalí
ܒܢܣܢܬ ܦܢ ܟܘܟ	Vincent van Gogh
ܦܪܝܕܐ ܩܐܠܘ	Frida Kahlo
ܗܢܪܝ ܡܐܛܝܣ	Henri Matisse
ܡܝܟܠܐܢܓܠܘ	Michelangelo Buonarroti
ܦܒܠܘ ܦܝܩܐܣܘ	Pablo Picasso
ܪܡܒܪܢܛ	Rembrandt van Rijn
ܐܢܕܝ ܘܘܪܗܘܠ	Andy Warhol
ܢܝܢܘܐ (ܡܕܝܢܬܐ)	Ninive
ܒܒܠ	Babylon (stad)
ܐܝܪܝܚܘ	Jericho
ܩܛܠܘܢܝܐ	Catalonië
ܡܕܪܝܕ (ܗܘܦܪܟܝܐ)	Madrid (autonome gemeenschap)
ܒܝܬ ܠܚܡ	Bethlehem
ܣܕܪܐ:Candidates for speedy deletion	Categorie:Wikipedia:Nuweg
ܪܫܡܠܘܬܐ	Kapitalisme
ܐܘܡܬܐ	Natie
ܩܪܬܐܓܘ	Carthago
ܣܕܪܐ:ܐܣܛܪܘܢܘܡܝܐ	Categorie:Astronomie
ܨܚܪܐܐ	Sahara
ܒܝܬ ܟܬܒܐ	Bibliotheek (algemeen)
ܫܘܠܛܢܘܬܐ (ܫܘܬܐܣܐ)	Regering
ܬܫܝܢ ܫܝ ܗܘܐܢܓ	Qin Shi Huangdi
ܡܕܢܚܐ ܡܨܥܝܬܐ	Midden-Oosten
ܡܠܟܘܬܐ	Monarchie
ܩܘܛܢܝܘܬܐ	Republiek
ܐܬܪܐ	Staat
ܓܒܐ	Politieke partij
ܝܗܘܕܝܐ	Joden
ܝܡܡܬܐ ܪܘܪܒܬܐ	Grote Meren
ܐܘܩܝܢܘܣ ܬܝܡܢܝܐ	Zuidelijke Oceaan
ܐܕܢܐ (ܝܘܠܦܢ ܨܪܘܝܘܬܐ)	Oor
ܢܚܝܪܐ	Neus
ܥܝܢܐ (ܝܘܠܦܢ ܨܪܘܝܘܬܐ)	Oog (anatomie)
ܥܘܩܒܪܬܐ	Spier (anatomie)
ܙܡܝܪܬܐ	Lied
ܓܡܠܐ	Kamelen
ܫܘܫܡܢܐ	Mieren
ܕܒܫܬܐ	Bijen
ܠܫܢܐ ܗܘܠܢܕܝܐ	Nederlands
ܐܡܐ (ܒܝܬܝܘܬܐ)	Moeder
ܐܒܐ (ܒܝܬܝܘܬܐ)	Vaderschap
1847	1847
ܨܦܪܐ (ܙܒܢܐ)	Ochtend
ܪܡܫܐ	Avond
ܩܛܝܢܬܐ	Minuut (tijd)
ܠܫܢܐ ܪܘܣܝܐ	Russisch
ܩܢܘܢܐ	Recht
ܠܫܢܐ ܨܝܢܝܐ	Chinese talen
ܕܡܐ	Bloed
ܬܓܪܘܡܬܐ	Skelet
ܪܐܬܐ	Long (orgaan)
ܠܫܢܐ ܪܘܡܢܝܐ	Roemeens
ܡܛܪܐ	Regen (neerslag)
ܢܠܣܘܢ ܡܐܢܕܝܠܐ	Nelson Mandela
ܐܒܢܐ	Gesteente
ܥܢܢܐ	Wolk
ܩܢܘܢܐ ܕܠܥܙܐ	Grammatica
ܠܫܢܐ ܓܘܪܓܝܐ	Georgisch
ܝܘܠܦܢ ܡܡܫܚܘܬܐ	Economie
ܙܘܙܐ	Valuta
ܡܕܐܬܐ	Belasting (fiscaal)
ܐܠܦܒܝܬ ܥܪܒܝܐ	Arabisch alfabet
ܐܠܦܒܝܬ ܝܘܢܝܐ	Grieks alfabet
ܐܠܦܒܝܬ ܠܐܛܝܢܝܐ	Latijns alfabet
ܣܕܪܐ:ܦܪܢܣܐ	Categorie:Frankrijk
ܟܢܫܐ	Maatschappij (wereld)
ܓܒܪܐ	Man (geslacht)
ܙܘܘܓܐ	Huwelijk
ܙܕܩܐ ܕܒܪܢܫܐ	Rechten van de mens
ܩܪܒܐ ܓܘܝܐ	Burgeroorlog
ܓܪܡܐ ܕܣܢܘܢܝܬܐ	Borstbeen
ܬܪܝܢܐ	Vruchtensap
ܚܠܒܐ (ܕܝܘܒܐ)	Melk (drank)
ܛܘܪܐ	Berg (landvorm)
ܡܕܒܪܐ	Woestijn
ܠܫܢܐ ܐܠܒܢܝܐ	Albanees
ܠܫܢܐ ܐܪܡܢܝܐ	Armeens
ܝܘܗܐܢ ܓܘܛܢܒܪܓ	Johannes Gutenberg
ܠܫܢܐ ܣܘܝܕܝܐ	Zweeds
ܢܝܩܘܠܐ ܛܣܠܐ	Nikola Tesla
ܡܘܫܐ	Mozes
ܬܕܐ	Borst
ܢܘܗܪܐ (ܚܙܝܬܐ)	Licht
ܠܫܢܐ ܝܘܢܝܐ	Grieks
ܠܫܢܐ ܦܪܣܝܐ	Perzisch
ܬܘܕܝܬܐ	Religie
ܐܒܪܗܡ	Abraham
ܣܦܪܐ ܕܒܪܝܬܐ	Genesis (boek)
ܠܫܢܐ ܩܢܛܘܢܝܐ	Standaardkantonees
ܠܫܢܐ ܡܢܕܪܝܢܝܐ	Mandarijn (taal)
ܦܘܠܘܣ ܫܠܝܚܐ	Paulus (apostel)
ܙܝܓܡܘܢܕ ܦܪܘܝܕ	Sigmund Freud
ܙܠܛܐ	Salade
ܝܗܘܕܝܘܬܐ	Jodendom
ܠܫܢܐ ܥܒܪܝܐ	Hebreeuws
ܟܒܕܐ	Lever
ܛܚܠܐ	Milt
ܟܘܠܝܬܐ	Nier (biologie)
ܫܠܦܘܚܬܐ	Urineblaas
ܐܫܟܐ	Teelbal
ܐܘܩܝܢܘܣ	Oceaan
ܒܘܕܗܐ	Gautama Boeddha
ܡܘܚܡܕ	Mohammed
ܟܪܣܐ	Buik
ܚܒܠܐ ܟܘܒܝܐ	Ruggenmerg
ܘܪܝܕܐ	Ader (anatomie)
ܡܪܒܥܐ	Baarmoeder
ܠܫܢܐ (ܗܕܡܐ)	Tong (anatomie)
ܓܝܕܐ	Zenuw
ܨܘܪܐ (ܝܘܠܦܢ ܨܪܘܝܘܬܐ)	Nek (anatomie)
ܦܘܡܐ	Mond (orgaan)
ܓܓܪܬܐ	Strottenhoofd
ܡܥܝܐ	Ingewanden
ܫܪܝܬܐ	Gewricht
ܬܝܪܬܐ	Klier
ܚܠܒܐ (ܝܘܠܦܢ ܨܪܘܝܘܬܐ)	Middenrif
ܫܪܝܢܐ	Slagader
A	A (letter)
B	B (letter)
ܢܘܛܦܬܐ	Sperma
G	G (letter)
U	U (letter)
Z	Z (letter)
F	F (letter)
J	J (letter)
ܐܠܦܒܝܬ	Alfabet
T	T (letter)
C	C (letter)
R	R (letter)
D	D (letter)
Α	Alfa (letter)
Ω	Omega (letter)
I	I (letter)
Μ	Mu (letter)
E	E (letter)
H	H (letter)
ܗܐܪܠܡ (ܗܘܠܢܕܐ)	Haarlem
K	K (letter)
L	L (letter)
M	M (letter)
N	N (letter)
O	O (letter)
Q	Q (letter)
S	S (letter)
V	V (letter)
W	W (letter)
X	X (letter)
Y	Y (letter)
ܐܢܫܟܕܐ	Enschede
ܗܢܓܠܘ	Hengelo (Overijssel)
Φ	Phi (letter)
ܝܘܢܐ	Duiven (vogels)
ܐܝܠܢܐ	Boom (plant)
Λ	Lambda
ܓܒܬܐ	Kaas
ܥܢܒܬܐ	Druif
ܕܒܫܐ	Honing
ܒܣܪܐ	Vlees
ܫܟܪ	Tafelsuiker
ܣܦܪܙܒܢܐ	Krant
ܙܥܘܩܐ	Telefoontoestel
ܡܪܕܘܬܐ	Cultuur
ܡܥܝܐ ܥܒܝܐ	Dikke darm
ܡܥܝܐ ܩܛܝܢܐ	Dunne darm
ܣܘܪܓܕܐ ܝܘܠܝܝܐ	Juliaanse kalender
ܐܣܝܘܬܐ	Geneeskunde
ܡܠܚܐ (ܐܨܪܐ)	Keukenzout
ܣܕܪܐ:ܒܪܐܙܝܠ	Categorie:Brazilië
ܙܘܝܬܐ (ܡܚܪܘܬܐ)	Hoek (meetkunde)
ܬܘܩܦܐ	Energie
ܣܦܝܢܬܐ	Schip (transportmiddel)
ܩܠܐ (ܨܘܬܐ)	Geluid
ܙܓܘܓܝܬܐ	Glas
ܫܛܝܚܘܬܐ	Oppervlakte
ܡܢܝܢܐ	Getal (wiskunde)
ܪܦܦܐ	Seconde
ܣܥܪܬܐ	Gerst
ܘܘܗܐܢ	Wuhan
ܡܟܬܒܢܘܬܐ ܕܐܬܪܘܬܐ	Lijst van landen in 2015
ܒܝܬ ܢܗܪܝܢ	Mesopotamië
ܕܒܐ	Beren
ܬܠܗܝܐ	Kanker
ܡܠܟܐ	Koning (titel)
ܚܛܬܐ	Tarwe
ܣܘܪܓܕܐ	Kalender
ܟܘܪܗܢܐ	Ziekte
ܣܘܪܓܕܐ ܓܪܝܓܘܪܝܐ	Gregoriaanse kalender
ܟܦܣܐ	Menstruatie
ܥܡܐ ܩܪܕܘܝܐ	Koerden
ܓܫܪܐ	Brug (bouwwerk)
ܡܓܕܠܐ (ܒܢܝܢܐ)	Toren (bouwwerk)
ܐܡܪܝܩܐ ܠܐܛܝܢܝܬܐ	Latijns-Amerika
ܟܗܪܒܐ	Elektriciteit
ܡܙܝܥܢܐ ܕܩܝܕܐ ܓܘܝܐ	Verbrandingsmotor
ܣܝܦܐ (ܙܝܢܐ)	Zwaard (wapen)
ܫܡܥܘܢ ܩܢܢܝܐ	Simon (apostel)
ܩܪܩܦܬܐ	Schedel
ܓܘܡܠܐ!	Joomla!
ܐܦܫܬܐ	Rozijn
ܠܫܢܐ ܕܗܣܝܐܢܓ	Xiangyu
ܠܫܢܐ ܥܪܒܝܐ	Arabisch
ܠܫܢܐ ܐܦܪܝܩܐܢܝܐ	Afrikaans
Β	Bèta (letter)
Γ	Gamma (letter)
Δ	Delta (letter)
Ε	Epsilon
Ζ	Zèta
Η	Èta
Θ	Thèta
Ι	Iota (letter)
Κ	Kappa (letter)
Ν	Nu (letter)
Ξ	Xi (letter)
Ο	Omikron
Ρ	Rho (letter)
Σ	Sigma (letter)
Τ	Tau (letter)
Υ	Ypsilon
Χ	Chi (letter)
Ψ	Psi (letter)
ܐܬܐ	Vlag
ܟܪܦܬܐ	Meubilair
ܟܘܪܣܝܐ	Stoel
ܣܦܬܐ	Lip
ܦܣܡܐ	Snor (haargroei)
ܥܩܠܐ	Voet (anatomie)
1000000000 (ܡܢܝܢܐ)	Miljard
ܓܪܡܐ ܕܨܕܥܐ	Slaapbeen
ܩܠܝܕܐ (ܓܪܡܐ)	Sleutelbeen
ܟܬܦܐ	Schouder
ܦܟܐ ܬܚܬܝܐ	Mandibula (gewervelden)
ܩܠܒܐ:Link FA	Sjabloon:Link FA
ܥܠܡܐ (ܐܪܥܐ)	Wereld (Aarde)
ܘܝܩܝܦܕܝܐ:ܬܪܥܐ ܕܟܢܫܐ	Wikipedia:De kroeg
ܒܝܪܡܘܢܬ	Vermont
ܩܘܣܛܢܛܝܢܘܦܘܠܝܣ	Constantinopel
ܒܝܬ ܟܪܝܗܐ	Ziekenhuis
ܥܕܬܐ	Kerkgebouw
ܕܝܬܝܩܝ ܚܕܬܐ	Nieuwe Testament
9 (ܡܢܝܢܐ)	9 (getal)
1002	1002
ܦܘܕܘܠܣܟ	Podolsk
ܦܐܦܐ	Paus
5	5
4	4
ܢܝܒܐ	Hoektand
3	3
2	2
ܒܝܬ ܥܬܩܐ ܕܠܘܒܪ	Louvre
ܓܒܐ ܕܚܐܪܘܬܐ ܕܦܘܐܪܛܘ ܪܝܩܘ	Partido Independentista Puertorriqueño
6	6
ܕܝܬܝܩܝ ܥܬܝܩܬܐ	Oude Testament
ܥܐܕܐ ܕܒܝܬ ܝܠܕܐ	Kerstmis
ܠܫܢܐ ܪܘܡܐܢܣܝܐ	Romaanse talen
ܡܬܠܬܐ	Driehoek (meetkunde)
ܫܢܬܐ ܟܒܝܫܬܐ	Schrikkeljaar
ܡܘܥܡܪ ܐܠܩܕܐܦܝ	Moammar al-Qadhafi
ب	Ba (Arabische letter)
ܥܐܕܐ ܕܩܝܡܬܐ	Pasen
ܢܝܘ ܝܘܪܩ	New York
ܢܦܛܐ	Aardolie
ܣܐܘܢܐ	Schoen
ܒܝܬ ܥܘܪܦܢܐ	Bank (financiële instelling)
ܟܪܡܐ	Wijngaard
ܐܝܪܠܢܕ (ܓܙܪܬܐ)	Ierland (eiland)
1	1
ܠܘ ܫܘܢ	Lu Xun (schrijver)
10	10
20	20
9	9
7	7
8	8
7 (ܡܢܝܢܐ)	7 (getal)
8 (ܡܢܝܢܐ)	8 (getal)
12	12
ܡܠܐܐ ܘܬܘܒܐ	Getijde (waterbeweging)
ܫܒܘܥܐ	Week
ܓܠܝܕܐ	IJs (water)
ܨܠܘܬܐ ܡܪܢܝܬܐ	Onzevader
ܝܡܬܐ	Meer (watervlakte)
ܝܡܐ ܣܘܡܩܐ	Rode Zee
13	13
ܩܛܘܬܐ (ܝܥܝܬܐ)	Cucumis sativus
ܓܙܪܬܐ	Eiland
ܚܘܪܐ	Wit
ܐܘܟܡܐ	Zwart (kleur)
6 (ܡܢܝܢܐ)	6 (getal)
ܠܫܢܐ ܪܘܫܡܝܐ	Officiële taal
11	11
15	15
14	14
17	17
ܣܦܪ ܡܠܐ	Woordenboek
18	18
19	19
16	16
21	21
ܦܠܣܛܝܢ	Palestina (regio)
10 (ܡܢܝܢܐ)	10 (getal)
ܡܣܘܪܩܐ (ܡܐܢܐ)	Kam (verzorging)
ܠܝܠܐ ܕܘܢܤ	Lila Downs
ܝܡܐ ܕܡܠܚܐ	Dode Zee
ܫܘܚܠܦܐ ܕܫܢܬܐ	Seizoen
ܠܝܒܪܦܘܠ	Liverpool
ܩܘܦܬܐ (ܛܝܪܐ)	Uilen (orde)
ܫܥܬܐ	Uur
ܢܐܘܝ ܕܘܪ ܟܪܘܠܣܟܝ	Nowy Dwór Królewski
ܐܪܙܦܬܐ	Hamer (gereedschap)
ܝܘܢܫܘܦܝܢ	Jönköping (stad)
ܥܘܠܐ ܚܝܐ	Foetus
ܐܠܦܒܝܬ ܣܘܪܝܝܐ	Syrisch alfabet
ܐܠܦܒܝܬ ܐܪܡܝܐ	Aramees alfabet
ܐܣܝܐ ܡܥܪܒܝܬܐ	Zuidwest-Azië
ܙܡܪܐ	Zangkunst
ܫܓܠܐ	Hinkelen
ܩܠܦܬܐ ܕܒܣܡܐ	Kaneel
ܡܙܬܐ	Haar (zoogdier)
ܠܫܢܐ ܐܪܡܝܐ	Aramees
ܨܦܪܐ (ܛܝܪܐ)	Mussen
ܐܦܣܩܘܦܐ	Bisschop
ܨܝܢ (ܐܪܥܐ)	China
ܓܒܐ ܕܝܡܘܩܪܛܝܐ (ܐܘܚܕܢܐ ܡܚܝܕܐ)	Democratische Partij (Verenigde Staten)
ܒܝܐܛܪܝܟܣ ܕܒܝܬ ܗܘܠܢܕܝܐ	Beatrix der Nederlanden
ܡܠܟܘܬܐ ܕܗܘܠܢܕܐ	Koninkrijk der Nederlanden
ܐܒܪܝܠ ܠܐܒܝܢ	Avril Lavigne
ܪܝܫ ܩܘܛܢܝܘܬܐ	President
ܐܪܒܝܐ	Arabisch Schiereiland
ܡܪܩܘܣ ܐܘܢܓܠܣܛܐ	Marcus (evangelist)
ܥܘܠܐ	Embryo
ܠܫܢܐ ܕܗܟܐ	Hakka (taal)
ܫܘܫܡܢܝܬܐ (ܝܥܝܬܐ)	Kardemom
ܠܫܢܐ ܕܓܐܢ	Ganyu
ܒܝܬ ܥܬܩܐ	Museum
ܐܠܦܒܝܬ ܥܒܪܝܐ	Hebreeuws alfabet
ܠܫܢܐ ܣܘܪܝܝܐ	Syrisch
ܒܪܩܐ	Bliksem
ܐܝܕܐ	Hand
ܫܡܥܘܢ ܟܐܦܐ	Petrus
ܬܠ ܐܒܝܒ	Tel Aviv
ܒܐܠܦܐܪܐܝܣܘ	Valparaíso (stad)
ܠܫܢܐ ܫܝܡܝܐ	Semitische talen
ܚܘܣܢܝ ܡܘܒܐܪܟ	Hosni Moebarak
ܘܐܟܐܩܐ	Oaxaca (staat)
ܚܐܘܬܐ	Boter (zuivel)
ܐܘܢܓܠܝܘܢ	Evangelie
ܠܫܢܐ ܕܘܘ	Wuyu
ܪܘܛܪܕܐܡ	Rotterdam
ܩܪܛܐ	Kreta
ܐܘܪܚܐ	Weg
ܩܘܪܨܐ ܚܠܝܨܐ	Compact disc
ܦܪܬ	Eufraat
ܩܝܘܛܘ	Kioto (stad)
ܥܣܪܐ ܦܘܩܕܢܐ	Tien geboden
ܒܪܩܩܐ ܦܪܣܝܐ	Perzische Golf
ܚܠܐ (ܕܚܝܚܐ)	Zand
ܘܪܕܐ	Rozen
ܓܙܪܬܐ ܝܒܫܢܝܬܐ	Schiereiland
ܐܘܪܝܬܐ	Thora
ܟܘܘܝܬ (ܡܕܝܢܬܐ)	Koeweit (stad)
ܡܚܙܝܬܐ	Spiegel (optica)
ܥܡܐ ܥܪܒܝܐ	Arabieren
ܟܘܬܐ	Venster (muur)
ܠܫܢܐ ܝܘܢܝܐ ܥܬܝܩܐ	Oudgrieks
ܠܫܢܐ ܐܟܕܝܐ	Akkadisch
ܕܩܠܬ	Tigris
ܐܬܪܘܬܐ ܕܐܬܪܘܬܐ ܡܚܝܕܐ ܕܐܡܪܝܩܐ	Staten van de Verenigde Staten
ܡܥܡܘܕܝܬܐ	Doop (sacrament)
ܩܘܢܓܘ	Congo
ܐܝܢܛܪܠܝܢܓܘܐ	Interlingua
ܐܘܪܟܐ	Lengte (meetkunde)
ܚܠܡܐ	Droom
ܠܫܢܐ ܩܪܕܘܝܐ	Koerdisch
ܩܡܚܐ	Meel
ܕܢ ܗܐܟ	Den Haag
ܠܫܢܐ ܦܘܢܝܩܝܐ	Fenicisch
ܣܝܢܝ (ܓܙܪܬܐ ܝܒܫܢܝܬܐ)	Sinaï (schiereiland)
ܟܪܘܙܘܬܐ ܕܝܘܚܢܢ	Evangelie volgens Johannes
ܬܪܥܐ (ܒܒܐ)	Deur
ܪܝܗܐܢܐ	Rihanna
ܛܦܪܐ	Nagel (anatomie)
ܐܦܐ	Gelaat
ܨܨܐ (ܨܢܥܬܐ)	Draadnagel
ܙܝܬܐ	Olijf
ܬܠܝܬܝܘܬܐ	Drie-eenheid
ܓܠܠܐ	Golf (natuurkunde)
ܟܬܒܬܐ	Schrijven
ܪܘܚܐ ܕܩܘܕܫܐ	Heilige Geest
100 (ܡܢܝܢܐ)	100 (getal)
ܒܘܪܟܐ	Knie (anatomie)
ܫܘܩܐ (ܬܐܓܪܘܬܐ)	Markt (economie)
ܒܠܛܝ	Bălți (plaats)
1000000 (ܡܢܝܢܐ)	Miljoen
ܛܐܒܐ	Nieuws
ܐܫܬܐ (ܐܣܝܘܬܐ)	Koorts
ܩܫܬܐ ܓܪܒܝܝܬܐ ܕܐܪܥܐ	Noordelijk halfrond
ܡܡܘܢܐ ܕܡܝܟܪܐ	Micro-economie
ܠܝܕܣ	Leeds
ܥܘܩܒܪܐ	Mus (geslacht)
ܦܘܪܬܩܠܐ	Oranje (kleur)
ܒܪܩܩܐ	Baai
ܒܝܬ ܩܒܘܪܐ	Begraafplaats
ܐܣܝܐ (ܫܕܬܐ)	Arts
ܡܩܕܘܢܝܐ	Macedonia
ܦܢܛܝܩܘܣܛܝ	Pinksteren
ܫܓܕܬܐ	Amandelboom
ܟܪܘܙܘܬܐ ܕܠܘܩܐ	Evangelie volgens Lucas
ܩܘܢܣܦܣܝܘܢ (ܗܘܦܪܟܝܐ)	Concepción (provincie van Chili)
ܢܗܪܐ ܕܝܘܪܕܢܢ	Jordaan (rivier)
ܣܦܪ ܝܡܐ	Strand (kust)
ܐܢܛܐܠܝܐ (ܗܘܦܪܟܝܐ)	Antalya (provincie)
ܦܪܟܣܝܣ ܕܫܠܝܚܐ	Handelingen van de apostelen
ܥܪܘܒܬܐ ܕܚܫܐ	Goede Vrijdag
ܚܒܘܫܝܐ	Gevangenis
ܐܕܢܐ (ܗܘܦܪܟܝܐ)	Adana (provincie)
ܝܘܚܢܢ ܡܥܡܕܢܐ	Johannes de Doper
ܨܠܝܒܐ	Kruis (symbool)
ܚܙܒܐܠܠܗ	Hezbollah
ܒܝܬ ܓܒܝܢܐ	Voorhoofd
ܡܙܡܘܪܐ	Psalmen
ܐܬܘܪ	Assyrische Rijk
ܒܢܝܢܐ	Gebouw
ܚܠܒ (ܡܕܝܢܬܐ)	Aleppo (stad)
ܩܫܬܐ ܬܝܡܢܝܬܐ ܕܐܪܥܐ	Zuidelijk halfrond
ܚܠܐ (ܚܡܪܐ)	Azijn
ܒܝܬ ܕܝܢܐ	Rechtbank
ܚܝܦܐ	Haifa
ܪܡܕܐܢ	Ramadan
ܫܛܪܐ ܬܐܒܝܠܝܐ ܕܓܝܢܝܣ	Guinness Book of Records
ܟܘܕܢܝܐ	Muildier/muilezel
ܒܪܩܩܐ ܕܥܕܢ	Golf van Aden
ܓܠܝܢܐ ܕܝܘܚܢܢ	Openbaring van Johannes
ܐܫܬܐ (ܝܘܠܦܢ ܨܪܘܝܘܬܐ)	Bil (anatomie)
ܨܠܘܬܐ ܡܪܝܡܝܬܐ	Weesgegroet
ܝܩܕܐ	Brandstof
ܝܨܝܠܐ	Elleboog
ܟܗܢܐ	Priester
ܕܩܢܐ	Baard (haargroei)
ܢܒܝܐ	Profeet
ܐܘܪܟܝܣܛܪܐ	Orkest
1000 (ܡܢܝܢܐ)	1000 (getal)
ܣܘܦܝܐ ܪܘܛܐܪܘ	Sofia Rotaroe
ܬܫܢܝܬܐ	Verzekering
ܛܘܟܣܐ	Organisatie
ܣܦܪܓܠܐ	Kweepeer
ܐܢܕܪܐܘܣ ܫܠܝܚܐ	Andreas (apostel)
ܬܪܥܣܪ ܫܠܝܚܐ	Apostel
ܢܩܒܬܐ	Vrouwelijk (biologie)
ܕܪܥܐ (ܗܕܡܐ)	Arm (ledemaat)
ܡܬܝ ܡܟܣܐ	Matteüs (apostel)
ܬܐܘܡܐ ܫܠܝܚܐ	Tomas (apostel)
ܦܝܠܝܦܘܣ ܫܠܝܚܐ	Filippus (apostel)
ܒܘܪܨܐ (ܗܘܦܪܟܝܐ)	Bursa (provincie)
ܐܝܘܐܢܢܝܣ ܦܘܡܐ ܕܕܗܒܐ	Johannes Chrysostomus
ܒܢܝܡܝܢ ܢܬܢܝܗܘ	Benjamin Netanyahu
ܐܪܬܒܝܢ (ܗܘܦܪܟܝܐ)	Artvin (provincie)
ܓܒܝܢܐ	Wenkbrauw
ܫܘܪܬܐ	Navel
ܐܕܝܐܡܐܢ (ܗܘܦܪܟܝܐ)	Adıyaman (provincie)
ܝܗܘܕܐ ܫܠܝܚܐ	Judas Taddeüs
ܒܪܬܘܠܡܝ ܫܠܝܚܐ	Bartolomeüs (apostel)
ܝܥܩܘܒ ܒܪ ܙܒܕܝ	Jakobus de Meerdere
ܝܘܚܢܢ ܫܠܝܚܐ	Johannes (apostel)
ܡܬܝܐ ܫܠܝܚܐ	Mattias
ܝܥܩܘܒ ܒܪ ܚܠܦܝ	Jakobus (zoon van Alfeüs)
ܕܟܪܐ	Mannelijk (biologie)
ܐܝܓܢܐܛܝܘܣ ܢܘܪܢܐ	Ignatius van Antiochië
ܪܕܝܘܗܕ	Radiohead
ܒܫܐܪ ܐܠܐܣܕ	Bashar al-Assad
ܪܚܝܐ	Molen
ܨܘܡܐ	Vasten
ܕܝܪܐ	Klooster (gebouw)
ܠܡܐܢܐ	Haven
ܐܦܝܘܢ (ܗܘܦܪܟܝܐ)	Afyonkarahisar (provincie)
ܡܝܟܐܝܠ (ܡܠܐܟܐ)	Michaël (aartsengel)
ܒܝܠܓܝܟ (ܗܘܦܪܟܝܐ)	Bilecik (provincie)
ܒܝܬ ܥܬܩܐ ܕܐܣܪܐܝܠ	Israel Museum
ܒܐܠܝܟܣܝܪ (ܗܘܦܪܟܝܐ)	Balıkesir (provincie)
ܒܝܬ ܝܠܕܐ	Verjaardag
ܬܘܠܥܐ	Wormen (dieren)
ܬܘܩܢ ܓܝܕܝܐ ܩܢܛܪܘܢܝܐ	Centraal zenuwstelsel
ܛܘܪܐ ܕܓܠܝܕܐ	IJsberg
ܡܫܠܡܢܐ	Moslim
ܢܢܥܐ	Munt (geslacht)
ܩܠܒܐ:Commonscat	Sjabloon:Commonscat
ܒܨܪܐ (ܡܕܝܢܬܐ)	Basra
ܐܓܪܬܐ ܕܠܘܬ ܪܗܘܡܝܐ	Brief van Paulus aan de Romeinen
ܬܡܪܐ ܕܥܝܢܐ	Ooglid
ܗܘܦܪܟܝܣ ܕܛܘܪܩܝܐ	Lijst van provincies van Turkije
ܡܪܝ ܓܝܘܪܓܝܣ ܣܗܕܐ	Joris (heilige)
ܐܣܘܬܐ ܕܠܐ ܬܚܘܡܐ	Artsen zonder Grenzen
ܐܪܙܐ (ܡܫܝܚܝܘܬܐ)	Sacrament
ܐܓܪܬܐ ܕܠܘܬ ܦܝܠܝܦܣܝܐ	Brief van Paulus aan de Filippenzen
ܐܢܛܘܠܝܐ	Anatolië
ܡܫܝܚܐ	Messias
ܚܫܡܝܬܐ ܐܚܪܝܬܐ	Het Laatste Avondmaal (Jezus)
ܩܢܘܢܐ ܕܗܝܡܢܘܬܐ	Apostolische geloofsbelijdenis
ܒܢܝ ܐܝܣܪܐܝܠ	Israëlieten
ܡܓܘܫܐ ܬܠܬܐ	Wijzen uit het oosten
ܝܘܚܢܢ ܕܪܡܣܘܩܝܐ	Johannes Damascenus
ܒܒܐ (ܬܪܥܐ)	Poort (doorgang)
ܣܕܪܐ:ܡܠܟܐ	Categorie:Koning
ܣܕܪܐ:ܪܘܟܒ ܫܘܠܛܢܘܬܐ	Categorie:Staatsvorm
ܠܫܢܐ ܕܡܝܢ	Minyu
ܥܘܪܡܫܐ	Milieuverontreiniging
ܒܒܠ (ܗܘܦܪܟܝܐ)	Babil
ܫܘܡܪܐ	Roet (materie)
ܐܫܩܠܘܢ	Asjkelon
ܕܘܢܒܐ	Staart
ܩܐܕܣܝܐ (ܗܘܦܪܟܝܐ)	Al-Qadisiyah
ܡܪܝܡ ܡܓܕܠܝܬܐ	Maria Magdalena
ܡܪܪܬܐ	Galblaas
ܥܕܬܐ ܟܠܕܝܬܐ ܩܬܘܠܝܩܝܬܐ	Chaldeeuws-katholieke Kerk
ܥܕܬܐ ܡܪܘܢܝܬܐ	Maronitische Kerk
ܡܪܬܐ	Gal (stof)
ܩܘܪܒܢܐ	Eucharistie
ܐܕܡ	Adam
ܐܘܘܫܐ	Oorsmeer
ܕܡܥܬܐ	Traan (oog)
ܥܡܬܐ (ܒܝܬܝܘܬܐ)	Tante
ܥܡܐ (ܒܝܬܝܘܬܐ)	Oom
ܟܘܬܝܢܐ	Overhemd
ܝܘܗܐܢ ܐܠܙܪ	Georg Elser
ܒܝܢܓܘܠ (ܗܘܦܪܟܝܐ)	Bingöl (provincie)
ܥܡܐ ܐܪܡܢܝܐ	Armeniërs
ܐܝܕܝܢ (ܗܘܦܪܟܝܐ)	Aydın (provincie)
ܩܛܠܥܡܐ ܐܪܡܢܝܐ	Armeense genocide
ܐܡܐܣܝܐ (ܗܘܦܪܟܝܐ)	Amasya (provincie)
ܦܪܝܙܘܢ ܒܪܝܟ	Prison Break
ܐܓܪܝ (ܗܘܦܪܟܝܐ)	Ağrı (provincie)
ܒܘܪܕܘܪ (ܗܘܦܪܟܝܐ)	Burdur (provincie)
ܐܓܪܬܐ ܩܕܡܝܬܐ ܕܠܘܬ ܩܘܪܢܬܝܐ	Eerste brief van Paulus aan de Korintiërs
ܝܗܘܕܐ ܣܟܪܝܘܛܐ	Judas Iskariot
ܐܒܪܐ	Veer (vogel)
ܡܚܪܐ	Ingenieur
ܚܪܛܘܡܢܐ	Kikkererwt
ܐܬܪܘܬܐ ܕܫܐܡ	Levant
ܬܪܘܕܐ	Lepel (bestek)
ܓܒܪܐܝܠ (ܡܠܐܟܐ)	Gabriël (aartsengel)
ܓܪܡܦܝܠܐ	Ivoor
ܨܘܪ	Tyrus
ܒܘܠܘ (ܗܘܦܪܟܝܐ)	Bolu (provincie)
ܙܢܩܐ	Kin (lichaamsdeel)
ܨܘܡܐ ܕܐܪܒܥܝܢ	Vastentijd
ܐܓܪܐ ܕܒܢܝܢܐ	Dak
ܒܝܛܠܝܣ (ܗܘܦܪܟܝܐ)	Bitlis (provincie)
ܓܠܝܠܐ	Galilea (streek)
ܪܥܡܐ	Donder
ܡܘܨܠ	Mosoel
ܟܪܬܐ	Duim (vinger)
ܥܡܐ ܛܘܪܩܝܐ	Turken
ܦܐܦܐ ܫܢܘܕܐ ܬܠܝܬܝܐ	Paus Shenouda III van Alexandrië
ܒܝܬ ܓܘܣܐ	Bunker (verdedigingswerk)
ܒܝܥܬܐ	Ei (voeding)
ܒܣܕܝܐ	Kussen
ܙܓܐ (ܢܩܘܫܐ)	Klok (bel)
ܫܒܬܐ (ܝܗܘܕܝܘܬܐ)	Sjabbat
ܫܡܝܪܡ	Semiramis
ܫܝܓܪܐ	Tandvlees
ܝܗ	JHWH
ܡܫܝܚܝܐ	Christen
ܟܪܘܙܘܬܐ ܕܡܪܩܘܣ	Evangelie volgens Marcus
ܟܟܪܝܬܐ ܕܕܒܫܐ	Bijenraat
ܐܓܪܬܐ ܕܠܘܬ ܩܘܪܢܬܝܐ ܕܬܪܬܝܢ	Tweede brief van Paulus aan de Korintiërs
ܫܥܘܬܐ (ܡܠܘܐܐ)	Was (substantie)
ܛܥܡܐ	Smaak (zintuig)
ܓܢܬ ܫܒܪܐ	Kleuterschool
ܝܡܬܐ ܕܓܠܝܠܐ	Meer van Tiberias
ܕܝܘܬܐ	Inkt
ܡܪܝ ܝܘܣܦ	Jozef van Nazareth
ܠܘܩܐ ܐܘܢܓܠܣܛܐ	Lucas (evangelist)
ܐܓܪܬܐ ܕܠܘܬ ܥܒܪܝܐ	Brief aan de Hebreeën
ܐܓܪܬܐ ܕܠܘܬ ܓܠܛܝܐ	Brief van Paulus aan de Galaten
ܡܪܝ ܡܝܟܐܝܠ ܪܒܐ	Michaël I de Grote
Ϝ	Digamma
Ϙ	Qoppa
ܥܛܡܐ	Dij
ܬܢܢܐ	Rook
ܡܘܚܘܢܐ	Kleine hersenen
ܐܓܪܬܐ ܕܠܘܬ ܩܘܠܣܝܐ	Brief van Paulus aan de Kolossenzen
ܐܓܪܬܐ ܕܝܥܩܘܒ	Brief van Jakobus
ܐܓܪܬܐ ܩܕܡܝܬܐ ܕܝܘܚܢܢ	Eerste brief van Johannes
ܐܓܪܬܐ ܕܠܘܬ ܦܝܠܡܘܢ	Brief van Paulus aan Filemon
ܐܓܪܬܐ ܕܠܘܬ ܬܣܠܘܢܝܩܝܐ ܕܬܪܬܝܢ	Tweede brief van Paulus aan de Tessalonicenzen
ܐܓܪܬܐ ܩܕܡܝܬܐ ܕܠܘܬ ܬܣܠܘܢܝܩܝܐ	Eerste brief van Paulus aan de Tessalonicenzen
ܐܓܪܬܐ ܩܕܡܝܬܐ ܕܦܛܪܘܣ	Eerste brief van Petrus
ܐܓܪܬܐ ܕܬܪܬܝܢ ܕܦܛܪܘܣ	Tweede brief van Petrus
ܐܓܪܬܐ ܩܕܡܝܬܐ ܕܠܘܬ ܛܝܡܬܐܘܣ	Eerste brief van Paulus aan Timoteüs
Ϛ	Stigma (letter)
ܡܪܕܝܢ (ܗܘܦܪܟܝܐ)	Mardin (provincie)
ܚܡܨ (ܡܕܝܢܬܐ)	Homs
Ͳ	Sampi
ܘܐܟܐܩܐ ܕܝ ܟܘܐܪܝܣ	Oaxaca (stad)
ܐܓܪܬܐ ܕܬܪܬܝܢ ܕܝܘܚܢܢ	Tweede brief van Johannes
ܐܓܪܬܐ ܕܬܠܬ ܕܝܘܚܢܢ	Derde brief van Johannes
ܐܓܪܬܐ ܕܝܗܘܕܐ	Brief van Judas
ܐܓܪܬܐ ܕܠܘܬ ܛܝܡܬܐܘܣ ܕܬܪܬܝܢ	Tweede brief van Paulus aan Timoteüs
ܐܓܪܬܐ ܕܠܘܬ ܛܛܘܣ	Brief van Paulus aan Titus
ܫܝܪܢܐܟ (ܡܕܝܢܬܐ)	Şırnak (stad)
ܐܟܪܐ	Agrariër
ܓܘܣܢܐ	Vluchteling
Ϻ	San (letter)
ܩܠܝܕܐ (ܡܐܢܐ)	Sleutel (slot)
ܥܕܥܐܕܐ	Festival
ܐܪܒܝܠ (ܡܕܝܢܬܐ)	Arbil (stad)
ܪܓܠܐ	Been (ledemaat)
ܚܨܐ	Rug (anatomie)
ܐܠܝܐ ܢܒܝܐ	Elia (profeet)
ܙܚܘܪܝܬܐ (ܬܘܠܥܬܐ)	Zijdevlinder
ܚܘܦܝܐ	Eclips (sterrenkunde)
ܡܚܛܐ	Naald (naaigerei)
ܥܠܡܐ ܥܪܒܝܐ	Arabische wereld
ܩܛܡܐ	As (verbranding)
ܢܘܗܕܪܐ (ܡܕܝܢܬܐ)	Duhok (stad)
ܨܒܥܐ ܕܪܓܠܐ	Teen
ܢܓܪܘܬܐ	Timmerman
ܠܘܚܐ (ܚܫܘܒܬܐ)	Tabletcomputer
ܪܒܝܬܐ	Woekeraar
ܡܟܝܪܘܬܐ	Verloving
ܫܘܪܡܐ	Endeldarm
ܐܪܡܝܐ (ܢܒܝܐ)	Jeremia (profeet)
ܬܠܝܦܐ	Wimper
ܫܥܬܐ ܕܐܪܥܐ	Het Uur der Aarde
ܦܪܡܝܬܐ	Knoop (kleding)
ܟܘܟܒܐ ܕܕܘܝܕ	Davidster
ܡܪܝ ܐܣܛܦܢܘܣ	Stefanus (martelaar)
ܡܫܡܫܢܐ	Diaken
ܢܓܒ	Negev
ܟܢܥܢ	Kanaän (gebied)
ܢܘܨܦܐ	Schemering
ܬܓܪܝܬ	Tikrit
ܚܠܐ (ܥܦܪܐ)	Stof (deeltjes)
ܬܪܥܐ ܕܕܡܐ	Bloeding
ܥܪܒܐ ܕܫܡܫܐ	Zonsondergang
ܐܡܝܫܐ	Moeras
ܡܨܥܝܬܐ (ܨܒܥܐ)	Middelvinger
ز	Zai (Arabische letter)
ܩܘܪܨܠܐ	Enkel
ܒܪ ܐܝܕܐ	Handschoen
ܢܫܒܐ ܕܥܝܢܐ	Netvlies
ܬܘܩܢ ܓܝܕܝܐ ܡܚܕܘܪܝܐ	Perifeer zenuwstelsel
ܛܝܢܐ	Modder
ܓܓܘܠܬܐ	Golgotha
ܗܢܝܢܐ (ܡܡܫܚܘܬܐ)	Rente
ܐܫܘܪ ܒܢܐܦܠ	Assurbanipal
ܓܕܫܐ	Ongeval
ܦܛܪܝܪܟܐ	Patriarch
ا	Alif
ܚܟܐ	Verhemelte
ت	Ta (Arabische letter)
ث	Tha (Arabische letter)
ج	Jim (Arabische letter)
ح	Ḥa (Arabische letter)
خ	Kha (Arabische letter)
د	Dal (Arabische letter)
ذ	Dhal (Arabische letter)
ر	Ra (Arabische letter)
ܪܓܫܐ	Zintuig
س	Sin (Arabische letter)
ܟܪܟ ܣܠܘܟ (ܡܕܝܢܬܐ)	Kirkoek (plaats)
ܒܒܬܐ	Pupil (anatomie)
ܩܒܪܐ	Graf
ܠܒܘܢܬܐ	Olibanum
ܚܡܬ (ܡܕܝܢܬܐ)	Hama (stad)
ܝܫܛܐ	Slokdarm
ܟܝܣܐ ܕܐܫܟܐ	Scrotum
ܕܒܪܐ	Platteland
ܚܪܘܫܬܐ	Luchtpijp
ܓܪܡܐ ܕܥܛܡܐ	Dijbeen
ܒܪܐ (ܒܝܬܝܘܬܐ)	Zoon (familie)
ܫܚܘܪܐ	Houtskool
ܐܘܟܡܐ ܕܥܝܢܐ	Iris (anatomie)
ܫܦܠܘܗܝ ܕܢܝܠܘܣ	Nijldelta
ܐܘܪܡܝܐ	Urmia
Ϸ	Sho (letter)
ܓܙܪܬܐ ܐܝܘܠܝܬܐ	Eolische Eilanden
ܓܒܐ ܕܒܥܬ	Arabische Socialistische Ba'ath-partij
ܦܩܪܐ	Wervel (anatomie)
ܒܪ ܩܠܐ	Echo (geluid)
ܟܝܡܪܐ	Chimaera (mythologie)
ܠܘܓܡܐ	Bovenkaakbeen
ܛܪܘܢܐ	Dictator (modern)
ܬܝܒܘܬܐ	Biecht
ܡܛܘܚܬܐ	Wijsvinger
ܩܒܠܘܬܐ	Verloskunde
ܐܪܙܝܪܐ	Spreeuwen (vogels)
ܣܦܪܐ (ܩܢܘܢܝܐ)	Jurist
Ͱ	Heta
ܥܡܐ ܐܪܡܝܐ	Arameeërs
ܟܢܘܢܬܐ (ܫܪܝܬܐ)	Pols (anatomie)
ܐܒܐ (ܐܠܗܐ)	God de Vader
ܐܢܒܐܪ (ܗܘܦܪܟܝܐ)	Al-Anbar
ܡܪܕܝܢ (ܡܕܝܢܬܐ)	Mardin (stad)
ܣܪܛܢܐ	Cancer
ܡܘܪܘܢ	Vormsel
ܚܠܡܬܐ	Tepel
ܢܘܠܐ ܕܓܘܓܝ	Spinnenweb
ܐܫܥܝܐ	Jesaja (profeet)
ܒܝܬ ܟܬܒܐ ܐܬܪܝܐ ܕܐܣܪܐܝܠ	Nationale Bibliotheek van Israël
ܥܪܫܐ	Kies
ܢܝܢܘܐ (ܗܘܦܪܟܝܐ)	Ninawa
ܢܘܗܕܪܐ (ܗܘܦܪܟܝܐ)	Duhok (gouvernement)
ܘܐܣܛ (ܗܘܦܪܟܝܐ)	Wasit
ܨܠܐܚ ܐܠܕܝܢ (ܗܘܦܪܟܝܐ)	Salah ad Din
ܟܢܘܫܝܐ ܕܠܫܢܐ ܥܒܪܝܐ	Academie voor de Hebreeuwse Taal
ܥܘܕ	Oed
ܒܓܕܐܕ (ܗܘܦܪܟܝܐ)	Bagdad (gouvernement)
ܣܪܓܐ	Zadel (dier)
ܒܨܪܐ (ܨܒܥܐ)	Ringvinger
ܩܛܝܣܦܘܢ	Ctesiphon
ܟܒܘܫܐ	Nachtmerrie
ܢܓܦ (ܗܘܦܪܟܝܐ)	An-Najaf
ܟܪܟ ܣܠܘܟ (ܗܘܦܪܟܝܐ)	Kirkoek (provincie)
ܕܢܚܐ ܕܫܡܫܐ	Zonsopkomst
ܬܐܪܬܐ	Geweten
ܒܨܪܐ (ܗܘܦܪܟܝܐ)	Basra (gouvernement)
ܡܫܚܐ ܕܟܪܝܗܐ	Ziekenzalving
ܦܠܫܬ	Filistijnen
ܐܠܥܐ (ܝܘܠܦܢ ܨܪܘܝܘܬܐ)	Rib (anatomie)
ܥܕܬܐ ܐܝܓܘܦܛܝܬܐ	Koptisch-orthodoxe Kerk
ܐܦܪܝܡ ܣܘܪܝܝܐ	Efrem de Syriër
ܐܝܙܝܕܝܐ	Jezidi's
ܪܝܫܘܢ ܠܬܣܝܘܢ	Risjon Letsion
ܟܢܪܐ	Lier (muziekinstrument)
ܥܕܬܐ ܕܡܕܢܚܐ ܕܐܬܘܪܝܐ	Assyrische Kerk van het Oosten
ܬܠܐ ܕܚܕ ܐܝܠܢ	One Tree Hill (televisieserie)
ܡܘܪܐ	Mirre
ܦܕܪܠܝܐ	Federalisme
ܐܠܝܫܥ	Elisa (profeet)
ܗܟܐܪܝ (ܡܕܝܢܬܐ)	Hakkâri (stad)
ܣܢܚܪܝܒ	Sanherib
ܩܘܪܝܐܠܝܣܘܢ	Kyrie (mis)
ܟܢܘܫܝܐ ܕܐܣܪܐܝܠ ܕܝܘܠܦܢܐ ܘܐܢܫܝܬܐ	Israëlische Academie van Wetenschappen
ܣܘܟܢܐ	Roer (schip)
ܥܕܬܐ ܣܘܪܝܝܬܐ ܐܪܬܘܕܟܣܝܬܐ	Syrisch-orthodoxe Kerk van Antiochië
ܟܣܬܐ	Voer (voeding)
ܩܡܫܠܝ	Kamishli
ܡܘܬܢܐ (ܗܘܦܪܟܝܐ)	Al-Muthanna
ܡܝܫܢ (ܗܘܦܪܟܝܐ)	Maysan
ܣܘܠܝܡܐܢܝܐ (ܗܘܦܪܟܝܐ)	Suleimaniya (gouvernement)
ܐܪܒܝܠ (ܗܘܦܪܟܝܐ)	Arbil (gouvernement)
ܚܠܒ (ܗܘܦܪܟܝܐ)	Aleppo (gouvernement)
ܟܪܒܠܐܐ (ܗܘܦܪܟܝܐ)	Karbala (gouvernement)
ܕܝ ܩܐܪ (ܗܘܦܪܟܝܐ)	Dhi Qar
ܐܢܕܪܢܝܩ ܡܐܪܓܐܪܝܐܢ	Andranik Margarian
ܓܘܙܐ	Okkernootfamilie
ܕܝܐܠܐ (ܗܘܦܪܟܝܐ)	Diyala (gouvernement)
ܟܒܒ	Khabab
ش	Sjin (Arabische letter)
ܩܪܫܬܐ	Plafond (bouw)
ص	Sad (Arabische letter)
ض	Dad (Arabische letter)
ظ	Dza (Arabische letter)
ع	Ain (Arabische letter)
غ	Gain (Arabische letter)
ف	Fa (Arabische letter)
ق	Qaf (Arabische letter)
ܚܨܪܐ	Pink (vinger)
ܐܡܬܐ (ܝܘܠܦܢ ܨܪܘܝܘܬܐ)	Onderarm
ܣܝܢܝ	Sinaï
ܬܐܘܡܐ	Thomas
ܐܝܒܪܝܐ	Iberia
ܚܡܬ (ܗܘܦܪܟܝܐ)	Hama (gouvernement)
ܟܢܘܢܬܐ ܕܐܝܕܐ	Handwortelbeen
ܐܝܣܪܐܝܠ (ܬܘܚܡܐ ܐܚܪܢܐ)	Israël (doorverwijspagina)
ܡܠܐܟܐ	Engel
ܡܣܘܪܩܐ ܕܐܝܕܐ	Middenhandsbeen
ܡܠܟܘܬܐ ܕܒܝܬ ܥܣܪ ܥܝܢܐ	Osroene
ܕܪܥܐ (ܡܕܝܢܬܐ)	Daraa
ܨܕܥܐ	Slaap (anatomie)
ܣܘܣܝܐ ܐܝܣܠܢܕܝܐ	IJslander (paard)
ܩܠܐ	Muzieknoot
ܓܪܡܐ	Bot (anatomie)
ܠܒܠܒܬܐ	Huig
ܙܓܐ ܕܣܦܝܢܬܐ	Scheepsbel
ك	Kaf (Arabische letter)
ل	Lam (Arabische letter)
م	Mim (Arabische letter)
ن	Nun (Arabische letter)
ه	Ha (Arabische letter)
و	Waw (Arabische letter)
ي	Ya (Arabische letter)
ܥܪܒܝܐ	Arab
ܓܝܕܐ ܕܓܢܫܝܐ	Nervus ischiadicus
ܒܪܬܐ (ܒܝܬܝܘܬܐ)	Dochter
ܚܣܟܗ (ܡܕܝܢܬܐ)	Al-Hasakah (plaats)
ܛܐܪܩ ܥܙܝܙ	Tariq Aziz
ܡܣܘܪܩܐ ܕܪܓܠܐ	Middenvoetsbeen
ܥܪܩ	Arak (Nabije Oosten)
ܫܠܦܐ	Lemmet (mes)
ܛܘܪ ܠܒܢܢ	Libanon (gebergte)
ܐܘܛܪܝܟܛ	Utrecht
ܟܝܢܐ	Natuur
ܪܗܘܡܐ	Rum
ܩܝܒܩ	Quebec
ܥܡܐ ܐܬܘܪܝܐ/ܣܘܪܝܝܐ	Assyriërs (volk)
ܛܘܪܐ ܕܣܝܢܝ	Sinaïberg
ܦܘܪܬܥܢܐ	Vlooien
ܟܪܘܙܘܬܐ ܕܡܬܝ	Evangelie volgens Matteüs
ܡܕܝܢܬܐ ܡܝܬܬܐ	Dode steden in Syrië
ܢܘܗܕܪܐ	Duhok
ܐܓܪܬܐ ܕܠܘܬ ܐܦܣܝܐ	Brief van Paulus aan de Efeziërs
ܚܡܬ	Hama
ܒܢܦܫܐ	Violet
ܢܨܪܬ	Nazareth (Israël)
ܥܕܬܐ ܥܬܝܩܬܐ ܕܡܕܢܚܐ	Oude Kerk van het Oosten
ܟܬܒܐ ܕܡܘܪܡܘܢ	Boek van Mormon
ܐܝܓܢܐܛܝܘܣ ܡܘܫܐ ܩܕܡܝܐ ܕܐܘܕ	Ignace Moussa I Daoud
ܒܫܐܪܐ ܦܛܪܘܣ ܐܠܪܐܥܝ	Béchara Boutros Raï
ܡܪܝ ܦܘܠܝܩܪܦܘܣ ܐܘܓܝܢ ܐܝܕܝܢ	Polycarpus Augin Aydin
ܥܡܢܘܐܝܠ ܬܠܝܬܝܐ ܕܠܝ	Emmanuel III Delly
ܥܡܘܕܐ ܦܩܪܝܐ	Wervelkolom
ܒܝܬ ܫܥܝܐ	Stadion
ܓܘܕ ܫܪܠܘܛ	Good Charlotte
ܒܪ ܨܘܪܐ	Kraag
ܚܣܚܘܣܐ	Kraakbeen
ܛܘܪ ܥܒܕܝܢ	Tur Abdin
ܡܪܝ ܩܘܪܝܩܘܣ ܣܗܕܐ ܘܕܝܘܠܝܛܐ ܝܡܗ	Quiricus en Julitta
ܐܝܣܛܢܒܘܠ (ܗܘܦܪܟܝܐ)	Istanboel (provincie)
ܝܘܢܝܐ	Grieken
ܓܗܢܐ	Gehenna
ܝܥܩܘܒ ܒܘܪܕܥܢܐ	Jacobus Baradaeus
ܐܓܢܛܝܘܣ ܝܘܣܦ ܬܠܝܬܝܐ ܝܘܢܢ	Ignace Joseph III Younan
ܬܠܫܝܬܐ ܕܩܛܠܐ ܕܐܕܘܠܦ ܗܝܛܠܪ	Lijst van aanslagen op Adolf Hitler
ܬܐܓܘܪܬܐ	Handel (economie)
ܡܛܟܣܬܐ ܐܬܘܪܝܬܐ ܕܝܡܩܪܛܝܬܐ	Assyrische Democratische Organisatie
ܡܬܐ	Heimat
ܫܝܪܢܐܟ (ܗܘܦܪܟܝܐ)	Şırnak (provincie)
ܥܘܩܣܐ	Angel (insect)
ܟܗܢܘܬܐ	Wijding
ܚܒܘܪ	Khabur (Eufraat)
ܗܕܡܐ ܓܘܝܐ	Orgaan
ܡܥܠܘܠܐ	Ma'loula
ܐܘܪܘܦܐ	Europa
ܡܕܝܕ	Midyat (stad)
ܐܣܝܪܝܣܩܐ	Assyriska Föreningen
ܥܕܬܐ ܣܘܪܝܝܬܐ ܩܬܘܠܝܩܝܬܐ	Syrisch-katholieke Kerk
ܐܘܣܛܪܠܝܐ	Australia
ܡܦܩܬܐ ܦܫܝܛܬܐ	Peshitta
ܐܪܚܘܬܐ	Gastvrijheid
ܫܪܓܐ ܕܢܦܛܐ	Olielamp
ܚܘܐ	Eva (persoon)
ܗܘܦܪܟܝܣ ܕܥܝܪܐܩ	Deelgebieden van Irak
ܩܛܠܥܡܐ ܐܬܘܪܝܐ	Assyrische genocide
ܚܬܢܐ (ܒܝܬܝܘܬܐ)	Bruidegom
ܒܝܬ ܟܬܒܐ ܕܐܫܘܪ ܒܢܐܦܠ	Bibliotheek van Nineve
ܣܪܦܝܘܢ	Serapion de scholastiek
ܒܕܘܩܐ	Scouting
ܥܘܕܪܢܐ:ܚܒܝܫܬ̈ܐ	Portaal:Hulp en beheer
ܓܦܬܐ	Klimplant
ܡܝܟܐܝܠ	Michael
ܐܝܓܢܐܛܝܘܣ ܙܟܝ ܩܕܡܝܐ ܥܝܘܐܨ	Ignatius Zakka I Iwas
ܐܣܛܘܡܟܐ	Maag
ܟܢܘܢܬܐ ܕܪܓܠܐ	Voetwortelbeen
ܓܢܬܐ	Tuin
ܒܪܐ (ܐܠܗܐ)	God de Zoon
ܚܝܠܐ ܠܒܢܝܐ	Libanese Strijdkrachten
ܕܒܘܪܐ	Wespen
ܘܝܩܝܦܕܝܐ:ܐܝܙܓܕܘܬܐ	Wikipedia:Ambassade
ܫܠܝܬܐ	Placenta
ܒܝܬ ܛܘܣܐ	Vliegveld
ܒܝܬ ܫܡܪܝܐ	Samaria (regio)
ܐܓܢܣ ܡܘ	Agnes Monica
ܦܪܢܣܘ ܗܪܝܪܝ	Franso Hariri
ܣܕܪܐ:ܓܪܡܢ	Categorie:Duitsland
ܣܕܪܐ:ܐܝܛܠܝܐ	Categorie:Italië
ܣܕܪܐ:ܐܬܪܘܬܐ ܡܚܝܕܐ ܕܐܡܪܝܩܐ	Categorie:Verenigde Staten
ܣܕܪܐ:ܪܘܣܝܐ	Categorie:Rusland
ܣܕܪܐ:ܩܢܕܐ	Categorie:Canada
ܣܕܪܐ:ܐܝܣܪܐܝܠ	Categorie:Israël
ܣܕܪܐ:ܛܘܪܩܝܐ	Categorie:Turkije
ܣܕܪܐ:ܡܨܪܝܢ	Categorie:Egypte
ܣܕܪܐ:ܐܝܪܐܢ	Categorie:Iran
ܕܝܪܐ ܕܡܪܝ ܓܒܪܐܝܠ	Mor Gabriel-klooster
ܥܐܕܐ	Feest- en gedenkdagen
ܣܕܪܐ:ܥܝܪܐܩ	Categorie:Irak
ܣܕܪܐ:ܗܘܠܢܕܐ	Categorie:Nederland
ܣܕܪܐ:ܦܘܠܢܕ	Categorie:Polen
ܣܕܪܐ:ܛܝܪܐ	Categorie:Vogel
ܣܕܪܐ:ܝܥܝܬܐ	Categorie:Plant
ܣܕܪܐ:ܬܘܕܝܬܐ	Categorie:Religie
ܣܕܪܐ:ܝܕܥܬܐ	Categorie:Wetenschap
ܩܘܠ ܬܘܪܗ	Kol Tora
ܦܪܡܬܐ ܕܣܡܠܐ	Genocide van Simele
ܓܪܫܘܢܝ	Garshuni
ܨܘܒܐ	Nusaybin (stad)
ܕܪܥܐ (ܗܘܦܪܟܝܐ)	Daraa (gouvernement)
ܝܘܠ ܦܘܪܕܒܢܕ	Joël Voordewind
ܡܪܝܡ (ܚܬܗ ܕܡܘܫܐ)	Mirjam
ܣܕܪܐ:ܬܘܚܡܐ ܐܚܪܢܐ	Categorie:Wikipedia:Doorverwijspagina
ܣܕܪܐ:ܡܫܝܚܝܘܬܐ	Categorie:Christendom
ܣܕܪܐ:ܐܣܠܐܡ	Categorie:Islam
ܣܕܪܐ:ܝܗܘܕܝܘܬܐ	Categorie:Jodendom
ܦܩܥܬܐ ܕܢܝܢܘܐ	Vlakte van Nineve
ܠܩܐ ܕܣܦܝܢܬܐ	Roeiriem
ܚܪܒܘܩܬܐ	Knoopsgat
ܬܪܢܓܠܐ	Haan (kip)
ܙܚܘܪܝܬܐ (ܓܘܢܐ)	Scharlakenrood
ܐܢܩܪܐ (ܗܘܦܪܟܝܐ)	Ankara (provincie)
ܐܢܕܪܐܘܣ	André
ܐܝܪܠܢܕ	Ierland
ܟܬܒܬ ܐܝܕܐ	Handschrift (persoon)
ܝܘܢܢ	Jona (profeet)
ܐܨܪܐ	Condiment
ܕܝܪܝܟ	Al-Malikiyah
ܫܘܫܡܬܐ	Sesam
ܣܕܪܐ:ܘܝܩܝܦܕܝܐ	Categorie:Wikipedia
ܣܕܪܐ:ܝܒܫܬܐ	Categorie:Continent
ܝܙܦܬܐ	Schuld (debet)
ܦܨܝܕܐ	Vijver
ܐܪܓܘܢܐ	Paars
ܢܘܪܢܝܐ	Piramide (ruimtelijke figuur)
ܘܝܩܝܦܕܝܐ:HotCat	Wikipedia:HotCat
ܒܛܐ	Eenden
ܗܝܟܠܐ ܕܫܠܝܡܘܢ	Joodse tempel
ܠܘܝܣ ܪܘܦܐܝܠ ܩܕܡܝܐ ܣܟܘ	Louis Raphaël I Sako
ܩܠܒܐ:ܓܕܫܐ ܗܫܝܐ	Sjabloon:Hoofdpagina - in het nieuws
ܣܕܪܐ:ܡܟܬܒܢܘܬܐ ܕܐܬܪܘܬܐ	Categorie:Land
ܘܝܩܝܦܕܝܐ:ܡܕܒܪܢܐ	Wikipedia:Moderator
ܣܕܪܐ:ܫܕܬܐ	Categorie:Beroep
ܘܝܩܝܦܕܝܐ:ܒܘܬ̈ܐ	Wikipedia:Bots
ܣܕܪܐ:ܙܒܢܐ	Categorie:Tijd
ܣܕܪܐ:ܙܘܙܐ	Categorie:Geld
ܣܕܪܐ:ܝܘܠܦܢ ܨܪܘܝܘܬܐ	Categorie:Anatomie
ܣܕܪܐ:ܐܣܝܘܬܐ	Categorie:Geneeskunde
ܫܡܥܘܢ (ܫܡܐ)	Simon (voornaam)
ܡܨܪܝܢ	Egypte (land)
ܩܠܒܐ:Bot	Sjabloon:Bot
ܩܢܕܐ	Canada
ܣܕܪܐ:ܝܘܢ	Categorie:Griekenland
ܣܕܪܐ:ܣܘܝܕ	Categorie:Zweden
ܐܡܪܐ	Lam (schaap)
ܩܠܒܐ:ܐܫܛܪܘܬܐ	Sjabloon:Sjabdoc
ܣܕܪܐ:User languages	Categorie:Wikipedia:Babel
ܦܘܠܚܢܐ	Bedrijf
ܩܠܒܐ:Softredirect	Sjabloon:Softredirect
ܩܠܒܐ:Delete	Sjabloon:Nuweg
ܣܕܪܐ:ܠܫܢܐ	Categorie:Taal
ܣܕܪܐ:ܩܢܘܢܐ ܕܠܥܙܐ	Categorie:Grammatica
ܘܝܩܝܦܕܝܐ:General disclaimer	Wikipedia:Vrijwaringsclausule
ܣܕܪܐ:Noindexed pages	Categorie:Wikipedia:Niet te indexeren pagina's
ܘܝܩܝܦܕܝܐ:ܕܘܒܪܐ	Wikipedia:Conventies
ܩܠܒܐ:Navbox	Sjabloon:Navigatie
ܣܕܪܐ:ܩܠܒܐ ܐܬܘܬܐ ܕܐܝܣܘ	Categorie:Wikipedia:Sjablonen vlag
ܩܠܒܐ:ܡܦܐܬܐ ܩܠܒܐ	Sjabloon:Tnavbar
ܩܠܒܐ:Clear	Sjabloon:Clearboth
ܘܝܩܝܦܕܝܐ:ܡܟܬܒܘܬܐ ܕܡܓܠܐ ܠܟܠ ܘܝܩܝܦܕܝܐ	Wikipedia:Archief/Wikipedia:Artikelen die elke Wikipedia zou moeten hebben
ܣܕܪܐ:ܐܠܝܩܛܪܘܢܝܘܬܐ	Categorie:Elektronica
ܣܕܪܐ:ܝܪܚܐ ܕܫܢܬܐ	Categorie:Maand
ܩܠܒܐ:Babel	Sjabloon:Babel
ܩܠܒܐ:Commons	Sjabloon:Commons
ܩܠܒܐ:Reflist	Sjabloon:References
ܩܠܒܐ:User ar-1	Sjabloon:Gebruiker ar-1
ܩܠܒܐ:User az	Sjabloon:Gebruiker az
ܩܠܒܐ:See also	Sjabloon:Zie ook
ܩܠܒܐ:User de	Sjabloon:Gebruiker de
ܩܠܒܐ:User es	Sjabloon:Gebruiker es
ܩܠܒܐ:User en-3	Sjabloon:Gebruiker en-3
ܩܠܒܐ:User en-1	Sjabloon:Gebruiker en-1
ܩܠܒܐ:User en-2	Sjabloon:Gebruiker en-2
ܩܠܒܐ:User en-4	Sjabloon:Gebruiker en-4
ܩܠܒܐ:User en	Sjabloon:Gebruiker en
ܩܠܒܐ:User fa	Sjabloon:Gebruiker fa
ܩܠܒܐ:User fr-1	Sjabloon:Gebruiker fr-1
ܩܠܒܐ:User he-2	Sjabloon:Gebruiker he-2
ܩܠܒܐ:User he-1	Sjabloon:Gebruiker he-1
ܩܠܒܐ:User sk	Sjabloon:Gebruiker sk
ܩܠܒܐ:User tr	Sjabloon:Gebruiker tr
ܩܠܒܐ:User ja	Sjabloon:Gebruiker ja
ܩܠܒܐ:User fr	Sjabloon:Gebruiker fr
ܩܠܒܐ:User he	Sjabloon:Gebruiker he
ܣܕܪܐ:ܐܣܝܐ	Categorie:Azië
ܣܕܪܐ:ܕܪܐ ܕܥܣܪܝܢ ܘܚܕ	Categorie:21e eeuw
ܩܠܒܐ:Mod	Sjabloon:Modulo
ܩܠܒܐ:User sv	Sjabloon:Gebruiker sv
ܩܠܒܐ:User it	Sjabloon:Gebruiker it
ܣܕܪܐ:ܐܨܪܐ	Categorie:Condiment
ܩܠܒܐ:Edit	Sjabloon:Edit
ܩܠܒܐ:Sidebar	Sjabloon:Zijbalk generiek
ܩܠܒܐ:ܐܬܪܐ	Sjabloon:Infobox land
ܣܕܪܐ:User en	Categorie:Wikipedia:Gebruiker en
ܣܕܪܐ:User zh	Categorie:Wikipedia:Gebruiker zh
ܩܠܒܐ:ܐܠܦܒܝܬ ܥܪܒܝܐ	Sjabloon:Navigatie Arabisch alfabet
ܣܕܪܐ:User zh-N	Categorie:Wikipedia:Gebruiker zh-M
ܩܠܒܐ:ܨܢܕܘܩ ܪܡܙܐ2	Sjabloon:Infobox generiek
ܩܠܒܐ:User zh	Sjabloon:Gebruiker zh
ܣܕܪܐ:ܦܐܦܐ	Categorie:Paus
ܩܠܒܐ:User nl-1	Sjabloon:Gebruiker nl-1
ܩܠܒܐ:User nl-2	Sjabloon:Gebruiker nl-2
ܣܕܪܐ:ܪܝܫܝ ܩܘܛܢܝܘܬܐ	Categorie:President
ܩܠܒܐ:User ru	Sjabloon:Gebruiker ru
ܩܠܒܐ:IPA	Sjabloon:IPA
ܣܕܪܐ:ܗܪܘܡܐ	Categorie:Specerij
ܣܕܪܐ:ܦܠܫܬ	Categorie:Palestina
ܣܕܪܐ:ܡܠܐܟܐ	Categorie:Engel
ܣܕܪܐ:ܢܒܝܐ	Categorie:Profeet
ܩܠܒܐ:ܨܢܕܘܩ ܡܕܒܪܢܐ	Sjabloon:Infobox ambtsbekleder
ܩܠܒܐ:Sortname	Sjabloon:SortNaam
ܩܠܒܐ:Border	Sjabloon:Border
ܩܠܒܐ:GUA	Sjabloon:GT
ܩܠܒܐ:User nl	Sjabloon:Gebruiker nl
ܩܠܒܐ:ܡܣܦܩ ܩܐܫ	Sjabloon:Purge
ܩܠܒܐ:ܨܢܕܘܩ ܐܡܢܐ	Sjabloon:Infobox kunstenaar
ܩܠܒܐ:ܡܦܠܚܢܐ	Sjabloon:Gebruikerlinks
ܣܕܪܐ:ܬܘܢܣ	Categorie:Tunesië
ܩܠܒܐ:Oppose	Sjabloon:Tegen
ܩܠܒܐ:COL	Sjabloon:CO
ܩܠܒܐ:PER	Sjabloon:PE
ܩܠܒܐ:User ar-2	Sjabloon:Gebruiker ar-2
ܩܠܒܐ:User ar-3	Sjabloon:Gebruiker ar-3
ܩܠܒܐ:User ar	Sjabloon:Gebruiker ar
ܩܠܒܐ:ܝܘܡܐ ܕܫܒܘܥܐ	Sjabloon:Zijbalk weekdagen
ܣܕܪܐ:ܡܕܝܢܬܐ ܒܐܘܚܕܢܐ ܡܚܝܕܐ	Categorie:Stad in de Verenigde Staten
ܩܠܒܐ:ܬ.ܐ.	Sjabloon:Dp
ܩܠܒܐ:No	Sjabloon:Nietuitgevoerd
ܣܕܪܐ:ܩܠܒܐ ܨܢܕܘܩܐ	Categorie:Wikipedia:Sjablonen infobox
ܩܠܒܐ:ܩܘܕܝܟܘܣ ܕܣܕܪܐ	Sjabloon:Hoofding categorieindex
ܩܠܒܐ:ܐܠܦܒܝܬ ܥܒܪܝܐ	Sjabloon:Infobox Hebreeuwse letter
ܣܕܪܐ:User yue	Categorie:Wikipedia:Gebruiker yue
ܣܕܪܐ:User az	Categorie:Wikipedia:Gebruiker az
ܣܕܪܐ:User sk	Categorie:Wikipedia:Gebruiker sk
ܣܕܪܐ:User fr	Categorie:Wikipedia:Gebruiker fr
ܣܕܪܐ:User ja	Categorie:Wikipedia:Gebruiker ja
ܣܕܪܐ:User la	Categorie:Wikipedia:Gebruiker la
ܣܕܪܐ:User pt	Categorie:Wikipedia:Gebruiker pt
ܣܕܪܐ:User ro	Categorie:Wikipedia:Gebruiker ro
ܣܕܪܐ:User sv	Categorie:Wikipedia:Gebruiker sv
ܣܕܪܐ:User ko-N	Categorie:Wikipedia:Gebruiker ko-M
ܩܠܒܐ:User yue	Sjabloon:Gebruiker yue
ܣܕܪܐ:ܗܘܦܪܟܝܣ ܕܥܝܪܐܩ	Categorie:Provincie van Irak
ܣܕܪܐ:User ar	Categorie:Wikipedia:Gebruiker ar
ܣܕܪܐ:User da	Categorie:Wikipedia:Gebruiker da
ܣܕܪܐ:User sk-N	Categorie:Wikipedia:Gebruiker sk-M
ܣܕܪܐ:User de	Categorie:Wikipedia:Gebruiker de
ܣܕܪܐ:User el	Categorie:Wikipedia:Gebruiker el
ܣܕܪܐ:User en-N	Categorie:Wikipedia:Gebruiker en-M
ܣܕܪܐ:User es	Categorie:Wikipedia:Gebruiker es
ܣܕܪܐ:User fa	Categorie:Wikipedia:Gebruiker fa
ܣܕܪܐ:User fi	Categorie:Wikipedia:Gebruiker fi
ܣܕܪܐ:User he	Categorie:Wikipedia:Gebruiker he
ܣܕܪܐ:User hy	Categorie:Wikipedia:Gebruiker hy
ܣܕܪܐ:ܠܫܢܐ ܥܒܪܝܐ	Categorie:Hebreeuws
ܣܕܪܐ:ܡܕܝܢܬܐ ܒܐܝܣܪܐܝܠ	Categorie:Stad in Israël
ܣܕܪܐ:User it	Categorie:Wikipedia:Gebruiker it
ܣܕܪܐ:User ko	Categorie:Wikipedia:Gebruiker ko
ܣܕܪܐ:ܒܬܫܪܝܢ ܐܚܪܝ	Categorie:November
ܣܕܪܐ:ܝܡܡܐ	Categorie:Zee
ܩܠܒܐ:ܐܠܦܒܝܬ ܝܘܢܝܐ	Sjabloon:Zijbalk Grieks alfabet
ܣܕܪܐ:ܦܛܪܝܪܟܘ ܕܥܕܬܐ ܣܘܪܝܝܬܐ ܩܬܘܠܝܩܝܬܐ	Categorie:Syrisch-katholiek patriarch van Antiochië
ܩܠܒܐ:ܢܒܝܐ ܕܕܝܬܝܩܝ ܥܬܝܩܬܐ	Sjabloon:Navigatie profeten uit de Tenach
ܣܕܪܐ:ܒܝܬܝܘܬܐ	Categorie:Verwantschap
ܬܪܥܐ:ܬܘܕܝܬܐ	Portaal:Religie
ܣܕܪܐ:ܪܝܫܝ ܩܘܛܢܝܘܬܐ ܥܠ ܐܬܪܐ	Categorie:President naar land
ܣܕܪܐ:User ru	Categorie:Wikipedia:Gebruiker ru
ܣܕܪܐ:User ru-3	Categorie:Wikipedia:Gebruiker ru-3
ܣܕܪܐ:User tl	Categorie:Wikipedia:Gebruiker tl
ܣܕܪܐ:User tmr	Categorie:Wikipedia:Gebruiker tmr
ܣܕܪܐ:User tr	Categorie:Wikipedia:Gebruiker tr
ܣܕܪܐ:ܙܡܪܐ	Categorie:Musicus
ܩܠܒܐ:Lang	Sjabloon:Lang
ܣܕܪܐ:ܪܫܘܡܐ	Categorie:Kunstschilder
ܩܠܒܐ:ܫܠܝܚܐ ܕܡܫܝܚܐ	Sjabloon:Navigatie apostelen
ܩܠܒܐ:Busy/Doc	Sjabloon:Druk
ܩܠܒܐ:CHI	Sjabloon:CL
ܣܕܪܐ:ܢܝܓܪ	Categorie:Niger
ܣܕܪܐ:ܝܘܠܦܢ ܩܢܘܢܝܐ	Categorie:Rechtsgeleerdheid
ܣܕܪܐ:ܣܥܪܐ	Categorie:Haardracht
ܩܠܒܐ:User ar-4	Sjabloon:Gebruiker ar-4
ܣܕܪܐ:ܢܗܪܘܬܐ	Categorie:Rivier
ܩܠܒܐ:User he-3	Sjabloon:Gebruiker he-3
ܩܠܒܐ:User he-4	Sjabloon:Gebruiker he-4
ܩܠܒܐ:User ko	Sjabloon:Gebruiker ko
ܩܠܒܐ:User pt	Sjabloon:Gebruiker pt
ܣܕܪܐ:User nl	Categorie:Wikipedia:Gebruiker nl
ܣܕܪܐ:User no	Categorie:Wikipedia:Gebruiker no
ܣܕܪܐ:ܣܘܪܝܐ	Categorie:Syrië
ܣܕܪܐ:ܕܪܐ ܩܕܡܝܐ	Categorie:1e eeuw
ܣܕܪܐ:ܓܙܪܬܐ ܝܒܫܢܝܬܐ	Categorie:Schiereiland
ܣܕܪܐ:ܗܘܦܪܟܝܣ ܕܗܘܠܢܕܐ	Categorie:Provincie van Nederland
ܣܕܪܐ:ܡܢܝܢܐ	Categorie:Natuurlijk getal
ܣܕܪܐ:ܡܕܝܢܬܐ ܕܥܝܪܐܩ	Categorie:Stad in Irak
ܣܕܪܐ:ܥܝܢܐ (ܨܪܘܝܘܬܐ)	Categorie:Oog
ܣܕܪܐ:ܓܘܪܓܝܐ	Categorie:Georgië
ܣܕܪܐ:ܟܘܘܝܬ	Categorie:Koeweit
ܣܕܪܐ:ܠܒܢܢ	Categorie:Libanon
ܣܕܪܐ:ܪܝܫܝ ܩܘܛܢܝܘܬܐ ܕܐܬܪܘܬܐ ܡܚܝܕܐ ܕܐܡܪܝܩܐ	Categorie:President van de Verenigde Staten
ܣܕܪܐ:ܝܘܪܕܢܢ	Categorie:Jordanië
ܣܕܪܐ:ܦܐܪܐ	Categorie:Fruit
ܣܕܪܐ:ܝܘܠܦܢ ܟܘܪܗܢܐ	Categorie:Pathologie
ܣܕܪܐ:ܓܒܐ	Categorie:Politieke partij
ܣܕܪܐ:ܕܝܬܝܩܝ ܚܕܬܐ	Categorie:Nieuwe Testament
ܣܕܪܐ:ܕܝܬܝܩܝ ܥܬܝܩܬܐ	Categorie:Oude Testament
ܣܕܪܐ:ܐܘܩܝܢܘ	Categorie:Oceaan
ܣܕܪܐ:ܓܪܡܐ	Categorie:Skelet
ܣܕܪܐ:ܚܝܘܬܐ	Categorie:Dierenrijk
ܣܕܪܐ:ܛܘܪܐ	Categorie:Gebergte
ܣܕܪܐ:ܣܘܥܪܢܐ	Categorie:Evenement
ܣܕܪܐ:ܟܘܪܗܢܐ	Categorie:Ziekte
ܣܕܪܐ:User pl	Categorie:Wikipedia:Gebruiker pl
ܣܕܪܐ:ܩܣܪ	Categorie:Keizer
ܣܕܪܐ:ܡܕܒܪܐ	Categorie:Woestijn
ܣܕܪܐ:ܝܡܡܬܐ	Categorie:Meer
ܩܠܒܐ:ܨܢܕܘܩ ܪܡܙܐ ܕܠܫܢܐ	Sjabloon:Infobox taal
ܣܕܪܐ:ܩܛܠܥܡܐ	Categorie:Bloedbad
ܣܕܪܐ:ܡܠܟܘܬܐ ܕܗܘܠܢܕܐ	Categorie:Koninkrijk der Nederlanden
ܨܝܢ	China (doorverwijspagina)
ܣܕܪܐ:ܠܫܢܐ ܘܠܥܙܐ ܨܝܢܝܐ	Categorie:Dialect in China
ܛܪܘܝܐܢܝ	Trojany (Mazovië)
ܣܕܪܐ:ܢܒܝܐ ܕܕܝܬܝܩܝ ܥܬܝܩܬܐ	Categorie:Profeet uit de Hebreeuwse Bijbel
ܣܕܪܐ:ܦܛܪܝܪܟܘ ܕܥܕܬܐ ܟܠܕܝܬܐ ܩܬܘܠܝܩܝܬܐ	Categorie:Chaldeeuws-katholiek patriarch van Babylon
ܣܕܪܐ:ܦܛܪܝܪܟܘ	Categorie:Patriarch
ط	Tah (Arabische letter)
ܣܕܪܐ:ܒܝܬ ܟܬܒܐ	Categorie:Bibliotheek
ܣܕܪܐ:ܫܢܬܐ ܥܕܬܢܝܬܐ	Categorie:Kerkelijk jaar
ܣܕܪܐ:ܐܪܙܐ	Categorie:Sacrament
ܣܕܪܐ:ܒܝܬ ܢܗܪܝܢ	Categorie:Mesopotamië
ܣܕܪܐ:ܕܝܪ̈ܬܐ ܣܘܪ̈ܝܝܬܐ	Categorie:Klooster in de Syrisch-orthodoxe Kerk
ܣܕܪܐ:ܓܘܢܐ	Categorie:Kleur
ܣܕܪܐ:ܦܣܩܐ ܕܝܘܡܐ	Categorie:Dagdeel
ܣܕܪܐ:ܫܢܐ	Categorie:Gebit
ܣܕܪܐ:ܩܕܝܫܐ ܒܡܫܝܚܝܘܬܐ ܣܘܪܝܝܬܐ	Categorie:Kerkvader van het Syrisch christendom
ܣܕܪܐ:ܦܛܪܝܪܟܘ ܕܥܕܬܐ ܣܘܪܝܝܬܐ ܐܪܬܘܕܟܣܝܬܐ	Categorie:Syrisch-orthodox patriarch van Antiochië
ܣܕܪܐ:ܩܠܒܐ	Categorie:Wikipedia:Sjablonen op functie
ܣܕܪܐ:ܩܕܝܫܐ	Categorie:Heilige
ܩܪܕܐ (ܪܚܫܐ)	Teken (dieren)
ܩܠܒܐ:User nl-4	Sjabloon:Gebruiker nl-4
ܩܠܒܐ:User nl-3	Sjabloon:Gebruiker nl-3
ܩܠܒܐ:Tim	Sjabloon:Tim
ܬܪܥܐ:ܐܘܩܝܢܘܣܝܐ	Portaal:Oceanië
ܢܘܓܗܐ	Dageraad
ܚܡܣܐ	Gember
ܟܘܕܐ	Kraamvloed
ܕܝܠܢܝܐ:ܫܘܚܠܦ̈ܐ ܚܕ̈ܬܐ	Speciaal:RecenteWijzigingen
ܘܙܐ	Ganzen
