Saot Amerika	Zuid-Amerika
Norway	Noorwegen
Ireland	Ierland (land)
Hungary	Hongarije
Spain	Spanje
Yunaeted Stet blong Amerika	Verenigde Staten
Belgium	België
Luxembourg	Luxemburg (land)
Finland	Finland
Sweden	Zweden
Denmark	Denemarken
Poland	Polen
Litwania	Litouwen
Itali	Italië
Switzerland	Zwitserland
Austria	Oostenrijk
Greece	Griekenland
Turkey	Turkije
Portugal	Portugal
Yurop	Europa (werelddeel)
Esia	Azië
Wikipedia	Wikipedia
Netherlands	Nederland
Berlin	Berlijn
Barak Obama	Barack Obama
Uruguay	Uruguay
London	Londen
Paris	Parijs
Mexico	Mexico (land)
Pasifik	Grote Oceaan
Kalifornia	Californië
Boston, Massachusetts	Boston
Franis	Frankrijk
Unaeted Kingdom	Verenigd Koninkrijk
China	Volksrepubliek China
Brazil	Brazilië
Rusia	Rusland
Alabama	Alabama
Germany	Duitsland
Belarus	Wit-Rusland
Iceland	IJsland
Estonia	Estland
David Cameron	David Cameron
Wan	1 (getal)
Tu	2 (getal)
Tri	3 (getal)
Fo	4 (getal)
Faef	5 (getal)
Latvia	Letland
Ukraine	Oekraïne
Czechia	Tsjechië
Slovakia	Slowakije
Slovenia	Slovenië
Vilnius	Vilnius
Moldova	Moldavië (land)
Romania	Roemenië
Bulgaria	Bulgarije
Rome	Rome (stad)
Macedonia	Macedonië (land)
Albania	Albanië
Croatia	Kroatië
Bosnia and Herzegovina	Bosnië en Herzegovina
Azerbaijan	Azerbeidzjan
Andorra	Andorra
Cyprus	Cyprus
Georgian Republic	Georgië
Kazakhstan	Kazachstan
Malta	Malta (land)
Monaco	Monaco
Montenegro	Montenegro
Vatican Siti	Vaticaanstad
San Marino	San Marino
Indonesia	Indonesië
Warsaw	Warschau
Wota	Water
Chile	Chili
Jisas Kraes	Jezus (traditioneel-christelijk)
Nicolas Sarkozy	Nicolas Sarkozy
Singapore	Singapore
Saens	Wetenschap
Liechtenstein	Liechtenstein
Spot	Sport
Wol Wo Tu	Tweede Wereldoorlog
Armenia	Armenië
Serbia	Servië
Ostrelia	Australië (land)
Argentina	Argentinië
Peru	Peru
Baeoloji	Biologie
Islam	Islam
Boteni	Plantkunde
Flaoa	Bloem (plant)
Wikimidia Commons	Wikimedia Commons
Moskow	Moskou
San-Peterburg	Sint-Petersburg
Niu Zilan	Nieuw-Zeeland
India	India
Aean	IJzer (element)
Ripablik blong Vanuatu	Vanuatu
Papua New Guinea	Papoea-Nieuw-Guinea
Venezuela	Venezuela
Maine	Maine
Animol	Dierenrijk
Paraguay	Paraguay
Colombia	Colombia
Budisim	Boeddhisme
Bolivia	Bolivia
Niu Hampshire	New Hampshire
Massachusetts	Massachusetts
Connecticut	Connecticut
Hawaii	Hawaï
Alaska	Alaska
Florida	Florida (staat)
Arizona	Arizona (staat)
Laos	Laos
Oregon	Oregon
Yuta	Utah
Burma	Myanmar
Vietnam	Vietnam
Saot Koria	Zuid-Korea
Bangladesh	Bangladesh
Bhutan	Bhutan
Twitter	Twitter
Julius Caesar	Julius Caesar
Yunaeted Nesen	Verenigde Naties
Jiografi	Aardrijkskunde
Bren	Hersenen
Prague	Praag
Michigan	Michigan
Illinois	Illinois (staat)
Not Dakota	North Dakota
Saut Dakota	South Dakota
Montana	Montana (staat)
Wyoming	Wyoming
Giorgio Napolitano	Giorgio Napolitano
Idaho	Idaho
Washington (Bundesstaat)	Washington (staat)
Nevada	Nevada (staat)
Colorado	Colorado (staat)
Delhi	Delhi (stad)
Virginia	Virginia (staat)
West Virginia	West Virginia
Niu York (Bundesstaat)	New York (staat)
Rhode Island	Rhode Island (staat)
Maryland	Maryland
Delaware	Delaware
Ohio	Ohio (staat)
Pennsylvania	Pennsylvania
Uetersen	Uetersen
Augustus	Imperator Caesar Augustus
Niu Yersey	New Jersey
Indiana	Indiana
Georgia	Georgia (staat)
Texas	Texas (staat)
Not Carolina	North Carolina
Saut Carolina	South Carolina
Barcelona	Barcelona (Spanje)
Mississippi	Mississippi (staat)
Tennessee	Tennessee
Niu Mexico	New Mexico
Minnesota	Minnesota
Caracas	Caracas
Wisconsin	Wisconsin
Iowa	Iowa (staat)
Nebraska	Nebraska
Kansas	Kansas (staat)
Hindi	Hindi
Missouri	Missouri (staat)
Louisiana	Louisiana (staat)
Kentucky	Kentucky
Arkansas	Arkansas (staat)
Oklahoma	Oklahoma
Vienna	Wenen
Stockholm	Stockholm
Wrocław	Wrocław
Baebol	Bijbel (christendom)
Ho Chi Minh City	Ho Chi Minhstad
Tru Jisas Jioj	Ware Jezuskerk
Andorra la Vella	Andorra la Vella
Dong Hoi	Đồng Hới
Concepción	Concepción (Chili)
Końskowola	Końskowola
Kurów	Kurów (powiat Puławski)
Kemistri	Scheikunde
Madrid	Madrid (stad)
Sydney	Sydney
Delmenhorst	Delmenhorst
Osasco	Osasco (Brazilië)
Curitiba	Curitiba (gemeente)
Confucius	Confucius
Category:Matematikis	Categorie:Wiskunde
Faroe aelan	Faeröer
Kristaniti	Christendom
Céline Dion	Céline Dion
Kontinen	Continent
Kapitol	Hoofdstad
Monzón	Monzón
Almazán	Almazán (gemeente)
Nambawan Pej	Hoofdpagina
Category:Candidates for speedy deletion	Categorie:Wikipedia:Nuweg
Kaontri	Land (geografie)
Indianapolis, Indiana	Indianapolis
Elmshorn	Elmshorn
Qin Shi Huang	Qin Shi Huangdi
Ae	Oog (anatomie)
Kamel	Kamelen
Obesin	Aubergine (plant)
Dakdak	Anatidae
Toktok Rusia	Russisch
Nelson Mandela	Nelson Mandela
Volkeno	Vulkaan
Bigwin	Tropische cycloon
Category:Franis	Categorie:Frankrijk
Kofi	Koffie
Seoul	Seoel
Toktok Ukraine	Oekraïens
Dipsi	Oceaan
Buddha	Gautama Boeddha
Muhammed	Mohammed
Martin Luther	Maarten Luther
Michael Schumacher	Michael Schumacher
Elisabet II	Elizabeth II van het Verenigd Koninkrijk
Ronald Reagan	Ronald Reagan
Fernando Alonso	Fernando Alonso
Gordon Brown	Gordon Brown
Category:Venezuela	Categorie:Venezuela
Lugo	Lugo (Spanje)
Category:Brazil	Categorie:Brazilië
Oktri	Eik
Kanal	Kanaal (waterweg)
Leji	Lychee
Kokonas	Kokospalm
Santiago de Compostela	Santiago de Compostella
Oviedo	Oviedo (stad)
Mérida	Mérida (Spanje)
Template:Link FA	Sjabloon:Link FA
Busan	Busan
Vermont	Vermont
Denver, Colorado	Denver
Phoenix, Arizona	Phoenix (Arizona)
Austin, Texas	Austin (Texas)
Columbus, Ohio	Columbus (Ohio)
Flaeg blong Rusia	Vlag van Rusland
Sacramento, Kalifornia	Sacramento (Californië)
Honolulu, Hawaii	Honolulu
Providence, Rhode Island	Providence (Rhode Island)
Naen	9 (getal)
Bien Hoa	Biên Hòa (stad)
Nha Trang	Nha Trang
Rafael Correa	Rafael Correa
Breinigerberg	Breinigerberg
Moai	Moai
Daejeon	Daejeon
Sejong	Sejong (stad)
Incheon	Incheon
Nashville, Tennessee	Nashville (Tennessee)
Sol Lek Siti	Salt Lake City
Seven	7 (getal)
Eit	8 (getal)
Lord's Prayer	Onzevader
Galik	Knoflook
Kukamba	Cucumis sativus
Sikis	6 (getal)
Moshchena	Mosjtsjena
Paltoga	Paltoga
Santiago de los Caballeros de Mérida	Mérida (Venezuela)
Atlanta, Georgia	Atlanta
Ten	10 (getal)
Albany, Niu York	Albany (New York)
Ca Mau	Cà Mau (stad)
Harrisburg, Pennsylvania	Harrisburg (Pennsylvania)
Da Lat	Đà Lạt
Phan Thiet	Phan Thiết
Hoknaet	Kerkuil
Antoni Gaudí	Antoni Gaudí
Trenton, Niu Yersey	Trenton (New Jersey)
Thai Nguyen	Thái Nguyên (stad)
Jefferson City, Missouri	Jefferson City (Missouri)
Jackson, Mississippi	Jackson (Mississippi)
Augusta, Maine	Augusta (Maine)
Baton Rouge, Louisiana	Baton Rouge
Lansing, Michigan	Lansing (Michigan)
Concord, New Hampshire	Concord (New Hampshire)
Lincoln, Nebraska	Lincoln (Nebraska)
Annapolis, Maryland	Annapolis (Maryland)
Springfield, Illinois	Springfield (Illinois)
Frankfort, Kentucky	Frankfort (Kentucky)
Saint Paul, Minnesota	Saint Paul (Minnesota)
Montgomery, Alabama	Montgomery (Alabama)
Juneau, Alaska	Juneau (Alaska)
Zhengzhou	Zhengzhou
Avril Lavigne	Avril Lavigne
Little Rock, Arkansas	Little Rock (Arkansas)
Buon Ma Thuot	Buôn Ma Thuột
Hartford, Connecticut	Hartford (Connecticut)
Dover, Delaware	Dover (Delaware)
Tok Pisin	Tok Pisin
Anastacia	Anastacia
Yufreres	Eufraat
Vinh Long	Vĩnh Long (Vĩnh Long)
Tequixquiac	Tequixquiac
Oklahoma City, Oklahoma	Oklahoma City
Bislama	Bislama
Boise, Idaho	Boise
Al Bayda	Al Bayda
Bambu	Bamboe
Thanh Hoa	Thanh Hóa (stad in Thanh Hóa)
Port Moresby	Port Moresby
Ben Tre	Bến Tre (stad)
Arancón	Arancón
Twelef	12 (getal)
Tallahassee, Florida	Tallahassee
Bismarck, Not Dakota	Bismarck (North Dakota)
Leven	11 (getal)
Avoka	Avocado
Cleveland, Ohio	Cleveland (Ohio)
John Calvin	Johannes Calvijn
Sint-Truiden	Sint-Truiden
Port Vila	Port Vila
Auckland Grammar School	Auckland Grammar School
Angers	Angers
Columbia, Saut Carolina	Columbia (South Carolina)
Santa Fe, Niu Mexico	Santa Fe (New Mexico)
Helena, Montana	Helena (Montana)
Des Moines, Iowa	Des Moines (Iowa)
Ágreda	Ágreda
Nawita	Octopoda
Pierre, Saut Dakota	Pierre (South Dakota)
Carson City, Nevada	Carson City (Nevada)
Topeka, Kansas	Topeka (Kansas)
Raleigh, Not Carolina	Raleigh (North Carolina)
Ulsan	Ulsan
Gwangju	Gwangju
Grepfrut	Grapefruit
Julia Gillard	Julia Gillard
Hamlet	Hamlet
Sebastian Vettel	Sebastian Vettel
Kevin Rudd	Kevin Rudd
Montehermoso	Montehermoso
Salem, Oregon	Salem (Oregon)
Josef Smit	Joseph Smith
Busan Stesen	Station Busan
Oganaesesen blong ol Leba Raonwol	Internationale Arbeidsorganisatie
Iolu Abil	Iolu Abil
Namba	Telwoord
Coronel Fabriciano	Coronel Fabriciano
Alla Pugacheva	Alla Poegatsjova
Flaeg blong Azerbaijan	Vlag van Azerbeidzjan
Sompiniong	Paddenstoel (schimmel)
Dziecinów	Dziecinów (powiat Otwocki)
Gdov	Gdov
Tenczynek	Tenczynek
Rudawa	Rudawa (Klein-Polen)
Blumak	Acanthurus lineatus
François Arago	François Arago
Memba Kaontri blong Unaeted Neisen	Lidstaten van de Verenigde Naties
Natanggura	Cycas revoluta
St Peter's College (Auckland)	St Peter's College Auckland
Alan García	Alan García
John Wycliffe	John Wyclif
Caltojar	Caltojar
God	God (algemeen)
Napoleong	Napoleonvis
Flaeg blong Vanuatu	Vlag van Vanuatu
Lou Reed	Lou Reed
Robert Gates	Robert Gates
William Tyndale	William Tyndale
Apaxco	Apaxco
Efate	Efate
Yumi, Yumi, Yumi	Yumi, Yumi, Yumi
Kalkot Mataskelekele	Kalkot Mataskelekele
Michael Somare	Michael Somare
Lluís Domènech i Montaner	Lluís Domènech i Montaner
Bry-sur-Marne	Bry-sur-Marne
Almaluez	Almaluez
Derek Sikua	Derek Sikua
Ambae Aelan	Ambae
Buk Blong Momon	Boek van Mormon
Coritiba Foot Ball Club	Coritiba Foot Ball Club
Aliud	Aliud
Baraona	Baraona
Blufis	Papegaaivissen
Tornesch	Tornesch
Blakbokis	Pteropus anetianus
Markdorf	Markdorf
Tafea	Tafea
Shefa	Shefa
Sanma	Sanma
Malampa	Malampa
Yonawa	Jonava
Grin pijin	Ptilinopus
Waeldakdak	Wenkbrauweend
Sigal	Witkopmeeuw
Pigazzano	Pigazzano
Torba	Torba (Vanuatu)
Almarza	Almarza
Aldealices	Aldealices
Aldealafuente	Aldealafuente
Alentisque	Alentisque
Adradas	Adradas
Alconaba	Alconaba
Abejar	Abejar
Almajano	Almajano
Arenillas	Arenillas
Aldealpozo	Aldealpozo
Alcubilla de las Peñas	Alcubilla de las Peñas
Aldealseñor	Aldealseñor
Alcubilla de Avellaneda	Alcubilla de Avellaneda
Casarejos	Casarejos
Almazul	Almazul
Alpanseque	Alpanseque
Arcos de Jalón	Arcos de Jalón
Aldehuela de Periáñez	Aldehuela de Periáñez
Almenar de Soria	Almenar de Soria
Ausejo de la Sierra	Ausejo de la Sierra
Arévalo de la Sierra	Arévalo de la Sierra
Las Aldehuelas	Las Aldehuelas
Bliecos	Bliecos
Blacos	Blacos
Penama	Penama
Barca	Barca (Spanje)
List blong provens blong Vanuatu	Provincies van Vanuatu
Luganville	Luganville
Młoszowa	Młoszowa
Kakao	Cacaopoeder
Isangel	Isangel
Smalfala grin pijin	Greys jufferduif
Pijin blong hariken	Wigstaartpijlstormvogel
Bigfala grin pijin	Vanuatujufferduif
Nalaklak	Vanuatubrilvogel
Category:Germany	Categorie:Duitsland
Category:Itali	Categorie:Italië
Category:Yunaeted Stet blong Amerika	Categorie:Verenigde Staten
Category:Rusia	Categorie:Rusland
Category:Kanada	Categorie:Canada
Category:United Kingdom	Categorie:Verenigd Koninkrijk
Category:Spain	Categorie:Spanje
Category:China	Categorie:China
Category:India	Categorie:India
Category:Niu Zilan	Categorie:Nieuw-Zeeland
Sola	Sola (Vanuatu)
Category:Bangladesh	Categorie:Bangladesh
Category:Poland	Categorie:Polen
Category:Saot Koria	Categorie:Zuid-Korea
Category:Ukraine	Categorie:Oekraïne
Category:Vietnam	Categorie:Vietnam
Category:Pijin	Categorie:Vogel
Category:Baeoloji	Categorie:Biologie
Category:Histri	Categorie:Geschiedenis
Category:Jiografi	Categorie:Geografie
Category:Sosaeti	Categorie:Mens en maatschappij
Category:Rilijin	Categorie:Religie
Category:Saens	Categorie:Wetenschap
Category:Yunaeted Nesen	Categorie:Verenigde Naties
Saratamata	Saratamata
Category:Budisim	Categorie:Boeddhisme
Category:Kristaniti	Categorie:Christendom
Category:Islam	Categorie:Islam
Ba Ria	Bà Rịa (stad)
Bochotnica	Bochotnica
Benedicta Boccoli	Benedicta Boccoli
Category:Wikipedia Manejmen	Categorie:Wikipedia:Beheer
Category:Kultur	Categorie:Cultuur
Category:Kontinen	Categorie:Continent
Bigfala Apostasi	Grote Afval
Annarita Del Piano	Anna Rita Del Piano
Category:Pipol blong Yunaeted Stet blong Amerika	Categorie:Amerikaans persoon
Sergio Mattarella	Sergio Mattarella
Category:Kaontri	Categorie:Land
Category:Pipol	Categorie:Persoon
Category:Intanet	Categorie:Internet
Template:Bot	Sjabloon:Bot
Kanada	Canada
Category:Hungary	Categorie:Hongarije
Category:Czechia	Categorie:Tsjechië
Category:Litwania	Categorie:Litouwen
Category:Slovakia	Categorie:Slowakije
Category:Yurop	Categorie:Europa
Template:Documentation	Sjabloon:Sjabdoc
Category:Wikipedians by language	Categorie:Wikipedia:Babel
Template:Softredirect	Sjabloon:Softredirect
Template:Delete	Sjabloon:Nuweg
Category:Toktok	Categorie:Taal
Category:Wikipedia	Categorie:Encyclopedie Wikipedia
Category:Pages with broken file links	Categorie:Wikipedia:Pagina's met onjuiste bestandsverwijzingen
Wikipedia:Statistics	Wikipedia:Statistieken
Category:Buk	Categorie:Boek
Template:Babel	Sjabloon:Babel
Template:Commons	Sjabloon:Commons
Template:Link GA	Sjabloon:Link GA
Template:User eo-1	Sjabloon:Gebruiker eo-1
Template:User en-2	Sjabloon:Gebruiker en-2
Template:User es-1	Sjabloon:Gebruiker es-1
Template:User sk	Sjabloon:Gebruiker sk
Template:User fr-2	Sjabloon:Gebruiker fr-2
Category:Azerbaijan	Categorie:Azerbeidzjan
Category:Esia	Categorie:Azië
Template:Mod	Sjabloon:Modulo
Template:User it	Sjabloon:Gebruiker it
Template:States blog United States	Sjabloon:Navigatie bestuurlijke indeling Verenigde Staten
Category:User en	Categorie:Wikipedia:Gebruiker en
Category:Croatia	Categorie:Kroatië
Category:User en-2	Categorie:Wikipedia:Gebruiker en-2
Category:Hed blong Stet	Categorie:Staatshoofd
Template:Purge	Sjabloon:Purge
Template:Interwiki	Sjabloon:InterWiki
Category:Galicia	Categorie:Galicië
Category:User sk	Categorie:Wikipedia:Gebruiker sk
Category:User eo	Categorie:Wikipedia:Gebruiker eo
Category:User fr	Categorie:Wikipedia:Gebruiker fr
Category:User fr-2	Categorie:Wikipedia:Gebruiker fr-2
Category:User it-N	Categorie:Wikipedia:Gebruiker it-M
Category:User sk-N	Categorie:Wikipedia:Gebruiker sk-M
Category:User de	Categorie:Wikipedia:Gebruiker de
Category:User eo-1	Categorie:Wikipedia:Gebruiker eo-1
Category:User es	Categorie:Wikipedia:Gebruiker es
Category:User es-1	Categorie:Wikipedia:Gebruiker es-1
Category:User it	Categorie:Wikipedia:Gebruiker it
Category:Saens blong Pipol	Categorie:Sociale wetenschap
Category:Not Dakota	Categorie:North Dakota
Category:Louisiana	Categorie:Louisiana
Category:Arizona	Categorie:Arizona
Category:Kentucky	Categorie:Kentucky
Category:Armenia	Categorie:Armenië
Category:Vanuatu	Categorie:Vanuatu
Category:Pipol blong Vanuatu	Categorie:Vanuatuaans persoon
Category:Hed blong Stet blong Yunaeted Stet blong Amerika	Categorie:President van de Verenigde Staten
Category:Paraguay	Categorie:Paraguay
Category:Papua Nui Guini	Categorie:Papoea-Nieuw-Guinea
Category:Andorra	Categorie:Andorra
Category:Peru	Categorie:Peru
Category:Albania	Categorie:Albanië
Category:Fis	Categorie:Vis
Category:Dipsi	Categorie:Oceaan
Category:Animol	Categorie:Dierenrijk
Category:Asturias	Categorie:Asturië
Category:Wol	Categorie:Wereld
Category:Catalonia	Categorie:Catalonië
Trojany	Trojany (Mazovië)
Category:Provens blong Vanuatu	Categorie:Provincie van Vanuatu
Category:Buk Blong Momon	Categorie:Boek van Mormon
Category:Stesen blong Saot Koria	Categorie:Spoorwegstation in Zuid-Korea
Category:Sanma	Categorie:Sanma
Category:Penama	Categorie:Penama
Category:Soria	Categorie:Soria
Category:Aragón	Categorie:Aragón
Special:RecentChanges	Speciaal:RecenteWijzigingen
