Hĭ-ciŭ	Afrika
Nĭk-buōng	Japan
Nàng Mī-ciŭ	Zuid-Amerika
Nò̤-ŭi	Noorwegen
Ĭng-gáik-làng	Engeland
Sŭ-gáik-làng	Schotland
Ŭi-ī-sê̤ṳ	Wales
Báe̤k Ái-ī-làng	Noord-Ierland
Ái-ī-làng	Ierland (land)
Hungary	Hongarije
Să̤-băng-ngà	Spanje
Mī-guók	Verenigde Staten
Bī-lé-sì	België
Luxembourg	Luxemburg (land)
Ṳ̄-dêu	Heelal
Dê-giù	Aarde (planeet)
Sĕng-mêng	Leven
Sī	Dood
Nè̤ng	Mens
Huăng-hī	Geluk (emotie)
George Washington	George Washington
Wikidata	Wikidata
Hŭng-làng	Finland
Sôi-diēng	Zweden
Dăng-măk	Denemarken
Pŏ̤-làng	Polen
Lithuania	Litouwen
É-dâi-lé	Italië
Sô̤i-sê̤ṳ	Zwitserland
Ó̤-dê-lé	Oostenrijk
Hĭ-lé-nà̤	Griekenland
Tū-ī-gì	Turkije
Bì-ciū	Bier
Può-dò̤-ngà	Portugal
Ĕu-ciŭ	Europa (werelddeel)
Ā-ciŭ	Azië
Báe̤k Mī-ciŭ	Noord-Amerika
Nàng-gĭk-ciŭ	Antarctica
Wikipedia	Wikipedia
Hò̤-làng	Nederland
Ĭng-gĕng	Penis
PHP	PHP
Niū-iók-chê	New York City
Washington, D.C.	Washington D.C.
Gô-gĭng-săng	San Francisco
Báik-lìng	Berlijn
Los Angeles	Los Angeles
Diêng-nō̤	Computer
Sŭ-là̤-sié	Zürich (stad)
Barack Obama	Barack Obama
Uruguay	Uruguay
MediaWiki	MediaWiki
Lùng-dŭng	Londen
Bìng-guō	Appel (plant)
Bă-là̤	Parijs
Mĕ̤k-să̤-gŏ̤	Mexico (land)
Dâi-să̤-iòng	Atlantische Oceaan
Tái-bìng-iòng	Grote Oceaan
California	Californië
Boston	Boston
Lā̤-bái-ék	Maandag
Huōi-sĭng	Mars (planeet)
Kenya	Kenia
Ethiopia	Ethiopië
Gŭng-ciō (nguòng-siū)	Monarch (staatshoofd)
Ghana	Ghana
Lā̤-bái-nê	Dinsdag
Lā̤-bái-săng	Woensdag
Lā̤-bái-sé	Donderdag
Lā̤-bái-ngô	Vrijdag
Lā̤-bái-lĕ̤k	Zaterdag
Lā̤-bái-nĭk	Zondag
Săi (mà-kuŏ dông-ŭk)	Leeuw (dier)
Huák-guók	Frankrijk
Kēng	Hond
Ĭng-guók	Verenigd Koninkrijk
Mà	Kat (dier)
Dṳ̆ng-huà Ìng-mìng Gê̤ṳng-huò-guók	Volksrepubliek China
Huák-ngṳ̄	Frans
Wiktionary	Wiktionary
Ngṳ̀	Vissen (dieren)
Ciū	Alcoholische drank
Bă-să̤	Brazilië
Ngò̤-lò̤-sṳ̆	Rusland
Hāi	Zee
Alabama	Alabama
Wikimedia	Wikimedia Foundation
Jimmy Wales	Jimmy Wales
Dáik-guók	Duitsland
Belarus	Wit-Rusland
Dáik-ngṳ̄	Duits
Bĭng-dō̤	IJsland
Estonia	Estland
Tū-sĭng	Saturnus (planeet)
Hĭ-gĭ	Vliegtuig
Ciéng-cĕng	Oorlog
1	1 (getal)
2	2 (getal)
3	3 (getal)
4	4 (getal)
5	5 (getal)
0	0 (getal)
George W. Bush	George W. Bush
Latvia	Letland
Ukraine	Oekraïne
Ciék-káik	Tsjechië
Slovakia	Slowakije
Slovenia	Slovenië
Moldova	Moldavië (land)
Romania	Roemenië
Bulgaria	Bulgarije
Lò̤-mā	Rome (stad)
Macedonia Gê̤ṳng-huò-guók	Macedonië (land)
Albania	Albanië
Croatia	Kroatië
Bosnia gâe̤ng Herzegovina	Bosnië en Herzegovina
Azerbaijan	Azerbeidzjan
Andorra	Andorra
Cyprus	Cyprus
Georgia (guók-gă)	Georgië
Kazakhstan	Kazachstan
Malta	Malta (land)
Monaco	Monaco
Montenegro	Montenegro
Vaticano	Vaticaanstad
San Marino	San Marino
Gū-bă	Cuba (land)
Belize	Belize (land)
Barbados	Barbados
Java	Java (programmeertaal)
Éng-dô-nà̤-să̤-ā	Indonesië
Tū-ī-gì-ngṳ̄	Turks
Nàng-hĭ	Zuid-Afrika
Algeria	Algerije
Wiki Dù-cṳ̆-guāng	Wikisource
Uzbekistan	Oezbekistan
Huà-să	Warschau
Può-dò̤-ciū	Wijn
Cūi	Water
Chà	Hout
Diêng-sê	Televisie
Chile	Chili
Ià-sŭ	Jezus (traditioneel-christelijk)
Galileo Galilei	Galileo Galilei
Cūi-sĭng	Mercurius (planeet)
Lĭk-sṳ̄	Geschiedenis
Gĭng-sĭng	Venus (planeet)
Ngṳ̄-ngiòng	Taal
Ái	Liefde
Mŭk-sĭng	Jupiter (planeet)
Ngṳ̀ng-ò̤	Melkweg (sterrenstelsel)
Tiĕng-uòng-sĭng	Uranus (planeet)
Hāi-uòng-sĭng	Neptunus (planeet)
Tiĕng-ùng	Astronomie
Sĭng-gă-pŏ̤	Singapore
Kuŏ-hŏk	Wetenschap
Mìng-uòng-sĭng	Pluto (dwergplaneet)
Ciŏng-lài	Toekomst
Séng-mū Mā-lé-ā	Maria (moeder van Jezus)
Liechtenstein	Liechtenstein
Adolf Hitler	Adolf Hitler
Dâ̤-nê-ché̤ṳ Sié-gái Dâi-ciéng	Tweede Wereldoorlog
Wiki Gáu-kuŏ-cṳ̆	Wikibooks
Wiki Ngṳ̄-liŏh	Wikiquote
Wiki Dâi-hŏk	Wikiversity
Cṳ̆ng	Klok (tijd)
Ubuntu	Ubuntu (Linuxdistributie)
Linux	Linux
Só-hŏk	Wiskunde
Lá-dĭng-ngṳ̄	Latijn
Bahrain	Bahrein
Armenia	Armenië
Serbia	Servië
Nguŏk-giù	Maan
Istanbul	Istanboel
Ó̤-ciŭ	Australië (land)
Ŭk-lī	Natuurkunde
Argentina	Argentinië
Peru	Peru
Dièu-siēng Mìng-ciō-ciō-ngiê Ìng-mìng Gê̤ṳng-huò-guók	Noord-Korea
Gāng-puŏ-câi	Cambodja
Gū-làng-gĭng	Koran
Kṳ̄ng-lṳ̀ng	Dinosauriërs
Ĭ-sṳ̆-làng-gáu	Islam
Lì	Peer (plant)
Lùng-lùng	Wiel (voortbeweging)
Huò-bìng	Vrede
Nṳ̄-gái	Vrouw
Gū-chiŏng-kĕ̤ng	Anus (anatomie)
Nìng-mùng	Citroen (vrucht)
Bă-ciĕu	Banaan (vrucht)
Huă	Bloem (plant)
Napoléon Bonaparte	Napoleon Bonaparte
Sĕng-lī	Fysiologie
Hèng-sĭng	Ster (hemellichaam)
Nĭk-tàu	Zon
Victor Hugo	Victor Hugo
Dâi-iòng-ciŭ	Oceanië
Tái-iòng-hiê	Zonnestelsel
Ngāi	Tand
Kĭng	Waterstof (element)
Wiki Gê̤ṳng-hiōng	Wikimedia Commons
Cṳ̆	Boek (document)
Nĭk	Dag
Dĕ̤ng Timor	Oost-Timor
Màng-buŏ	Nacht
Nièng	Jaar
Ó̤-sṳ̆-lṳ̆k	Oslo
Lī-sṳ̆-buōng	Lissabon
Táng	Koolstof
Dâng	Stikstof (element)
Iōng	Zuurstof (element)
Giàng-sĭng	Planeet
Kleopatra 7-sié	Cleopatra VII
Ĭng-ngŏk	Muziek
É-dâi-lé-ngṳ̄	Italiaans (taal)
Séng Peterburg	Sint-Petersburg
Chad	Tsjaad
Lé̤ṳ	Aluminium
Sĭng-să̤-làng	Nieuw-Zeeland
Éng-dô	India
Tuvalu	Tuvalu
Tiék	IJzer (element)
Tonga	Tonga (land)
Samoa	Samoa
Solomon Gùng-dō̤	Salomonseilanden
Vanuatu	Vanuatu
Papua New Guinea	Papoea-Nieuw-Guinea
William Shakespeare	William Shakespeare
Palau	Palau (land)
Nauru	Nauru
Micronesia Lièng-băng	Micronesia
Iòng (gĭng-sṳ̆k)	Lood (element)
Marshall Gùng-dō̤	Marshalleilanden
Kiribati	Kiribati
Mūng-gū	Mongolië
Fiji	Fiji
Venezuela	Venezuela
Guók-cié chiông-gì	Schaken
Genghis Khan	Dzjengis Khan
Maine	Maine
Mā	Paard (dier)
Ū-ké	Gevechtswapen
Dông-ŭk	Dierenrijk
Suriname	Suriname
Paraguay	Paraguay
Guyana	Guyana
Ecuador	Ecuador
Colombia	Colombia
Hŭk-gáu	Boeddhisme
Bolivia	Bolivia
Dè̤ng	Koper (element)
Trinidad gâe̤ng Tobago	Trinidad en Tobago
Sĭk-ŭk	Planten
Séng Vincent gâe̤ng Grenadines	Saint Vincent en de Grenadines
New Hampshire	New Hampshire
Séng Lucia	Saint Lucia
Séng Kitts gâe̤ng Nevis	Saint Kitts en Nevis
Cĭng-kṳ̄ng	Schimmels
Jamaica	Jamaica
Grenada	Grenada
Massachusetts	Massachusetts
Guatemala	Guatemala
Bahamas	Bahama's
Connecticut	Connecticut
Giĕ	Kip (vogel)
Antigua gâe̤ng Barbuda	Antigua en Barbuda
Hawaii	Hawaï
Honduras	Honduras
Dominica	Dominica
Dominica Gê̤ṳng-huò-guók	Dominicaanse Republiek
Dṳ̆	Varken (tam)
Báe̤k-bĭng-iòng	Noordelijke IJszee
Haiti	Haïti
El Salvador	El Salvador
Ĭ-lāng	Iran
Iraq	Irak
Alaska	Alaska
Costa Rica	Costa Rica
Ī-sáik-liĕk	Israël
Panama	Panama (land)
Yemen	Jemen
Bâng-dŭk	Virus (biologie)
Pŏ̤-làng-ngṳ̄	Pools
Jordan	Jordanië
Nicaragua	Nicaragua
Florida	Florida (staat)
Kyrgyzstan	Kirgizië
Arizona	Arizona (staat)
Kuwait	Koeweit
Lō̤-kuŏ	Laos
Lebanon	Libanon
Oregon	Oregon
Maldives	Maldiven
Mī-ciŭ	Amerika (continent)
Utah	Utah
Ngù	Rund
Mā-lài-să̤-ā	Maleisië
Miēng-diêng	Myanmar
Nepal	Nepal
Oman	Oman
Pakistan	Pakistan
Qatar	Qatar
Saudi Ā-lá-báik	Saoedi-Arabië
Sri Lanka	Sri Lanka
Joseph Stalin	Jozef Stalin
Syria	Syrië
Platon	Plato
Tajikistan	Tadzjikistan
Dṳ̆ng-huà Mìng-guók	Taiwan
Aristoteles	Aristoteles
Tái-guók	Thailand
Huōi-chiă	Trein
Turkmenistan	Turkmenistan
Ā-lá-báik Lièng-hăk Dâi-gŭng-guók	Verenigde Arabische Emiraten
Băh-gĭng	Platina
Uŏk-nàng	Vietnam
Dâi-hàng Mìng-guók	Zuid-Korea
Afghanistan	Afghanistan
Gĭng	Goud
Suez Ông-ò̤	Suezkanaal
Bangladesh	Bangladesh
Mali	Mali
Sokrates	Socrates (filosoof)
Angola	Angola
Bhutan	Bhutan
Ùng-lài	Brunei
Tanzania	Tanzania
Cūi-ngṳ̀ng	Kwik
Hĭ-lĭ-pĭng	Filipijnen
Dṳ̆ng-hĭ Gê̤ṳng-huò-guók	Centraal-Afrikaanse Republiek
Isaac Newton	Isaac Newton
Albert Einstein	Albert Einstein
Uòng-sáik	Geel (kleur)
Togo	Togo
Tunisia	Tunesië
Zambia	Zambia
Zimbabwe	Zimbabwe
Báe̤k-gĭng	Peking
Nàng Sudan	Zuid-Soedan
Benin	Benin
Botswana	Botswana
Wiki Sĭng-ùng	Wikinews
Burkina Faso	Burkina Faso
Burundi	Burundi
Comoros	Comoren
Congo Gê̤ṳng-huò-guók	Congo-Brazzaville
Congo Mìng-ciō Gê̤ṳng-huò-guók	Congo-Kinshasa
Djibouti	Djibouti (land)
Chiáh-dô̤ Guinea	Equatoriaal-Guinea
Eritrea	Eritrea
Gabon	Gabon
Gambia	Gambia (land)
Guinea	Guinee
Guinea-Bissau	Guinee-Bissau
Côte d'Ivoire	Ivoorkust
Cameroon	Kameroen
Cabo Verde	Kaapverdië
Lesotho	Lesotho
Liberia	Liberia
Libya	Libië
Madagascar	Madagaskar
Malawi	Malawi
Mauritania	Mauritanië
Mauritius	Mauritius (land)
Morocco	Marokko
Mozambique	Mozambique
Namibia	Namibië
Niger	Niger (land)
Nigeria	Nigeria
Charles Darwin	Charles Darwin
Uganda	Oeganda
Rwanda	Rwanda
Séng Tomé gâe̤ng Príncipe	Sao Tomé en Principe
Senegal	Senegal
Seychelles	Seychellen
Carl Linnaeus	Carolus Linnaeus
Sierra Leone	Sierra Leone
Somalia	Somalië
Julius Caesar	Julius Caesar
Sudan	Soedan
Swaziland	Swaziland
Kê̤ṳng	Regenboog (optica)
Lièng-hăk-guók	Verenigde Naties
Dê-cék	Geologie
Dê-lī	Aardrijkskunde
Sĭng-câung	Hart
Puòi-hŭ	Huid
Ngàng-sáik	Kleur
Làng-sáik	Blauw (kleur)
Ngṳ̀ng	Zilver
Sék	Tin (element)
Michigan	Michigan
Illinois	Illinois (staat)
North Dakota	North Dakota
South Dakota	South Dakota
Montana	Montana (staat)
Wyoming	Wyoming
Idaho	Idaho
Washington	Washington (staat)
Nevada	Nevada (staat)
Éng-dô-iòng	Indische Oceaan
Kosovo	Kosovo
Colorado	Colorado (staat)
分類:Hŭng-lôi	Categorie:Alles
Chicago	Chicago
Dĕ̤ng-tiĕng	Winter
Chŭng-tiĕng	Lente
Hâ-tiĕng	Zomer
Chiŭ-tiĕng	Herfst
Saddam Hussein	Saddam Hoessein
Osama bin Laden	Osama bin Laden
Să̤-băng-ngà-ngṳ̄	Spaans
Philadelphia	Philadelphia (Pennsylvania)
Tĭ-tṳ̆	Spinnen (dieren)
Guō-sĭk	Vrucht (plant)
Cièng	Geld
Virginia	Virginia (staat)
West Virginia	West Virginia
Huăng-ciĕu	Capsicum annuum
Niū-iók-ciŭ	New York (staat)
Rhode Island	Rhode Island (staat)
Kŏng-tṳ̀ng	Insecten
Maryland	Maryland
Delaware	Delaware
Vladimir Lenin	Vladimir Lenin
Ohio	Ohio (staat)
Pennsylvania	Pennsylvania
Augustus	Imperator Caesar Augustus
Microsoft Windows	Microsoft Windows
New Jersey	New Jersey
Hŭng-làng-ngṳ̄	Fins
Indiana	Indiana
Ké-chiă	Auto
Georgia	Georgia (staat)
Texas	Texas (staat)
North Carolina	North Carolina
South Carolina	South Carolina
Manila	Manilla
Dĕ̤ng-gĭng	Tokio
Uòng-lì	Ananas
Mississippi	Mississippi (staat)
Tennessee	Tennessee
New Mexico	New Mexico
Ngà-diēng	Athene (stad)
Minnesota	Minnesota
Baghdad	Bagdad
Wisconsin	Wisconsin
Iowa	Iowa (staat)
Nebraska	Nebraska
Kansas	Kansas (staat)
Hŏng-giāng	Sigaret
Missouri	Missouri (staat)
Louisiana	Louisiana (staat)
Kentucky	Kentucky
Arkansas	Arkansas (staat)
Oklahoma	Oklahoma
Madonna	Madonna (zangeres)
Aceh	Atjeh
Séng-gĭng	Bijbel (christendom)
Phnom Penh	Phnom Penh
Hù Cé-mìng Chê	Ho Chi Minhstad
Ò̤-nô̤i	Hanoi
Cĭng Ià-sŭ Gáu-huôi	Ware Jezuskerk
Ĭng-ngṳ̄	Engels
Màng-gók	Bangkok
Kuala Lumpur	Kuala Lumpur
Bangka Belitung Gùng-dō̤	Banka-Billiton
Dài-báe̤k	Taipei (stad)
Concepción	Concepción (Chili)
Bengkulu	Bengkulu (provincie)
Końskowola	Końskowola
Nê-iōng-huá-táng	Koolstofdioxide
Jambi	Jambi (provincie)
Siè	Slangen
Lampung	Lampung
Guŏng-sók	Lichtsnelheid
Riau	Riau
Riau Gùng-dō̤	Riouwarchipel
Nàng Sumatra	Zuid-Sumatra
Lò̤-mā Dá̤-guók	Romeinse Keizerrijk
Mì-niōng	Microsoft
Kó-lū-hŭ	Kurów (powiat Puławski)
Huá-hŏk	Scheikunde
Sièng-sŏng	Zoutzuur
Ôi-sĭng	Natuurlijke maan
Kă-giù	Voetbal
Să̤ Sumatra	West-Sumatra
Mā-dáik-lī	Madrid (stad)
Michael Jackson	Michael Jackson
Cê̤ṳ-iù	Vrijheid (filosofie)
Cṳ̆-niòng-giāng	Meisje
Sék-nà̤	Sydney
Liŏh-sáik	Groen (kleur)
È̤ng-sáik	Rood (kleur)
Huōi	Vuur
Sĭng Nàng Wales	Nieuw-Zuid-Wales
Nile Ò̤	Nijl
Banten	Bantam (provincie)
Dṳ̆ng Jawa	Midden-Java
Chēng-chiū-sĭng	Komeet
Dĕ̤ng Jawa	Oost-Java
Jakarta	Jakarta
Ăng-kā-lá	Ankara
Să̤ Jawa	West-Java
Yogyakarta	Jogjakarta
Dṳ̆ng Kalimantan	Midden-Kalimantan
Dĕ̤ng Kalimantan	Oost-Kalimantan
Báe̤k Kalimantan	Noord-Kalimantan
Nàng Kalimantan	Zuid-Kalimantan
Hŏk-hâu	School (instelling)
Să̤ Kalimantan	West-Kalimantan
Dâi-hŏk	Universiteit
Wikipedia:Să-buàng	Wikipedia:Zandbak
Chió	Huis (woning)
Dê-dù	Kaart (cartografie)
Ò̤	Rivier
Osasco	Osasco (Brazilië)
Chiĕng-lī-giáng	Telescoop (optica)
分類:Dài-uăng lĭk-sṳ̄	Categorie:Geschiedenis van Taiwan
Curitiba	Curitiba (gemeente)
Sĕng-lìng	Bos (vegetatie)
分類:Uŏk-nàng lĭk-sṳ̄	Categorie:Geschiedenis van Vietnam
Iók-báik-cṳ̆	Job (boek)
Cĭng-ngiòng	Spreuken
Kūng-cṳ̄	Confucius
Hà	Tienpotigen
分類:Só-hŏk	Categorie:Wiskunde
Bali	Bali (eiland)
Ĕu-nguòng	Euro
Mī-gĭng	Amerikaanse dollar
Dâi-lièu	Liao-dynastie
Hòng-ciŭ	Hangzhou
Gĭ-dók-gáu	Christendom
Dĕ̤ng Nusa Tenggara	Oost-Nusa Tenggara
Să̤ Nusa Tenggara	West-Nusa Tenggara
Dṳ̆ng Sulawesi	Midden-Celebes
Gĭng-guók	Jin-dynastie (1115-1234)
Gorontalo	Gorontalo (provincie)
Báe̤k Sulawesi	Noord-Celebes
Dĕ̤ng-nàng Sulawesi	Zuidoost-Celebes
Nàng Sulawesi	Zuid-Celebes
Să̤ Sulawesi	West-Celebes
Seattle	Seattle
Dêu	Rijst
Maluku	Maluku (provincie)
Báe̤k Maluku	Noord-Molukken
Papua	Papoea (provincie)
Să̤ Papua	West-Papoea
Cēu	Vogels
Siū-dŭ	Hoofdstad
Può-dò̤-ngà-ngṳ̄	Portugees
Nguŏk	Maand
Cōng	Diamant
Nĭk-buōng-ngṳ̄	Japans
Báik-kuŏ-ciòng-cṳ̆	Encyclopedie
Tàu Hiĕk	Hoofdpagina
Saratov	Saratov
Làng-giù	Basketbal
Olympic Ông-dông-huôi	Olympische Spelen
Diòng-gĕ̤ng	Jangtsekiang
Che Guevara	Che Guevara
Mò̤ Dĕk-dŭng	Mao Zedong
Să̤-ăng	Xi'an
Lá-sák	Lhasa
Séng-gău	Geslachtsgemeenschap
Ĭng-dô̤	Vagina
Diék-hŏk	Filosofie
分類:Ché̤ṳk-káik chēng-dṳ̀	Categorie:Wikipedia:Nuweg
Gáung-kìng	Piano (instrument)
Dà	Thee (drank)
Marco Polo	Marco Polo
Hebe Camargo	Hebe Camargo
Gê̤ṳng-sāng-ciō-ngiê	Communisme
Cṳ̆-buōng-ciō-ngiê	Kapitalisme
Guók-gă	Land (geografie)
Mìng-cŭk	Natie
Carthago	Carthago
Uōng-hiĕk liù-lāng-ké	Webbrowser
分類:Tiĕng-ùng	Categorie:Astronomie
Hŭk	Boeddha (verlichte)
Lī Bĕk	Li Bai
Dù-cṳ̆-guāng	Bibliotheek (algemeen)
Sĕng-tái	Ecologie
Céng-dê	Politiek
Mìng-ciō	Democratie
Cìng-dièu	Qin-dynastie
Nobel Ciōng	Nobelprijs
Cìng Sṳ̄-huòng	Qin Shi Huangdi
Dṳ̆ng-dĕ̤ng	Midden-Oosten
Háng-dièu	Han-dynastie
Làu Băng	Han Gaozu
Háng Ùng-dá̤	Han Wendi
Háng Gīng-dá̤	Han Jingdi
Háng Ū-dá̤	Han Wudi
Sĕng-ŭk	Organisme
Rabindranath Tagore	Rabindranath Tagore
Gŭng-ciō-cié-dô	Monarchie
Siâ-huôi-ciō-ngiê	Socialisme
Cṳ̆ng-chói	Zoen
Nguòng-dièu	Yuan-dynastie
Háng Hióng-dá̤	Han Xiandi
Nazi Dáik-guók	Nazi-Duitsland
Christopher Columbus	Christoffel Columbus
Dâng Huò	Zheng He
Panama Ông-ò̤	Panamakanaal
Céng-dièu	Jin-dynastie (265-420)
Nàng-bĭng-iòng	Zuidelijke Oceaan
Uòng-ò̤	Gele Rivier
Sṳ̆-mā Ièng	Sima Yan
Ngê	Oor
Pé	Neus
Mĕ̤k-ciŭ	Oog (anatomie)
Hŭng-muòng	Steekmuggen
Săi-ngṳ̀	Haaien
Lŏk-dò̤	Kamelen
Chiông	Olifanten
Mā-ngiê	Mieren
Sùi-dièu	Sui-dynastie
Hò̤-làng-ngṳ̄	Nederlands
Sùi Ùng-dá̤	Sui Wendi
Sùi Iòng-dá̤	Sui Yangdi
Să̤-hâ	Westelijke Xia
Sóng-dièu	Song-dynastie
Ögedei	Ögedei Khan
Güyük	Güyük Khan
Möngke	Möngke Khan
Kublai	Koeblai Khan
Huă-chái	Bloemkool
Giò (sĭk-ŭk)	Aubergine (plant)
Siók	Sneeuw
Niè-giāng	Kind (leeftijdsgroep)
Cā-tàu	Ochtend
Hŭng-cṳ̆ng	Minuut (tijd)
Ngò̤-lò̤-sṳ̆-ngṳ̄	Russisch
Huák-lŭk	Recht
Hièng-huák	Grondwet
Háng-ngṳ̄	Chinese talen
Sá̤-bàu	Cel (biologie)
Háik	Bloed
Hié (ké-guăng)	Long (orgaan)
Romania-ngṳ̄	Roemeens
Bulgaria-ngṳ̄	Bulgaars
Ṳ̄	Regen (neerslag)
Dê-cīng	Aardbeving
Cūi-căi	Overstroming
Hāi-lâung	Tsunami
Hùng	Wolk
Hŭng-tăi	Tropische cycloon
Hŭng	Wind (meteorologie)
Georgia-ngṳ̄	Georgisch
Háng-cê	Hanzi
Dièu-siēng-cê	Hangul
Lá-dĭng cê-mō̤	Latijns alfabet
Ùng-hŏk	Literatuur
分類:Ĭng-ngŏk	Categorie:Muziek
分類:Ùng-hŏk	Categorie:Literatuur
È̤ng-làu-máe̤ng	Droom van de rode kamer
Hù-lì	Vossen
Harry Potter	Harry Potter (boekenreeks)
Chiū-ìng	Masturbatie
Siâ-huôi	Maatschappij (wereld)
Gáu-ṳ̆k	Onderwijs
Nàng-gái	Man (geslacht)
Ìng-guòng	Rechten van de mens
Temür	Temür Khan
Gă-pĭ	Koffie
Săng	Berg (landvorm)
Khayisan	Külüq Khan
Sŏng Dṳ̆ng-săng	Sun Yat-sen
Hiŏng-gē̤ng	Hongkong
Miami	Miami
Hàng Ciéng	Koreaanse Oorlog
Siū-ék	Seoel
Siông-hāi	Shanghai
Ùng-huá Dâi-gáik-mêng	Culturele Revolutie
Chĭng-dièu	Qing-dynastie
Uŏk-nàng Ciéng-cĕng	Vietnamoorlog
Thomas Edison	Thomas Edison
Armenia-ngṳ̄	Armeens
Ukraine-ngṳ̄	Oekraïens
HTML	HyperText Markup Language
Steven Spielberg	Steven Spielberg
Mŏ̤h-ngiòng	Mo Yan
Sôi-diēng-ngṳ̄	Zweeds
Dăng-măk-ngṳ̄	Deens
Nò̤-ŭi-ngṳ̄	Noors
Luxembourg-ngṳ̄	Luxemburgs
Ciék-káik-ngṳ̄	Tsjechisch
Karl Marx	Karl Marx
Nĕng-nĕng	Borst
Guŏng	Licht
Hĭ-lé-nà̤-ngṳ̄	Grieks
Ái-ī-làng-ngṳ̄	Iers
Kié-ngò̤	Pinguïns
Pŏ̤-sṳ̆-ngṳ̄	Perzisch
Cŭng-gáu	Religie
Hàng-guók-ngṳ̄	Koreaans
Cháung-sié-gé	Genesis (boek)
Chók-Ăi-gĭk-gé	Exodus (boek)
Háng-ngṳ̄ Guăng-uâ	Mandarijn (taal)
Uŏk-nàng-ngṳ̄	Vietnamees
Sigmund Freud	Sigmund Freud
Tái-guók-ngṳ̄	Thai (taal)
Mā-lài-ngṳ̄	Maleis
Mūng-gū-ngṳ̄	Mongools
Bandar Seri Begawan	Bandar Seri Begawan
Hĭ-báik-lài-ngṳ̄	Hebreeuws
Ŭi-ī-sê̤ṳ-ngṳ̄	Welsh (taal)
Sŭ-gáik-làng-ngṳ̄	Schots-Gaelisch
Vientiane	Vientiane (stad)
Lō̤-cṳ̄	Laozi
Găng-câung	Lever
Sṳ̆-mā Chiĕng	Sima Qian
Ciŏ Hĭ	Zhu Xi
Cìng-gāng	Emotie
Dâi-iòng	Oceaan
Victoria Nṳ̄-uòng	Victoria van het Verenigd Koninkrijk
Sék-giă-mèu-nà̤	Gautama Boeddha
Mŭk-hâng-mĕk-dáik	Mohammed
Hŭ-ngék	Ademhaling (mens)
Ṳ̀-gă	Confucianisme
Bók-lō̤	Buik
Dô̤-gáu	Taoïsme
Chói-siĕk	Tong (anatomie)
Dâiu-gáuk	Nek (anatomie)
Chói	Mond (orgaan)
Elizabeth 2-sié	Elizabeth II van het Verenigd Koninkrijk
Dòng-dièu	Tang-dynastie
Dòng Gŏ̤-cū	Tang Gaozu
Dòng Tái-cŭng	Tang Taizong
Dòng Gŏ̤-cŭng	Tang Gaozong
Dòng Iô-cŭng	Tang Ruizong
Ū Cáik-tiĕng	Wu Zetian
Dòng Hièng-cŭng	Tang Xuanzong
Dòng Sé̤ṳk-cŭng	Tang Suzong
Dòng Dâi-cŭng	Tang Daizong
Dòng Dáik-cŭng	Tang Dezong
Cê-mō̤	Letter
Siēu-hŏk	Lagere school
Mìng-dièu	Ming-dynastie
Ciŏ Nguòng-ciŏng	Hongwu
Ronald Reagan	Ronald Reagan
Gióng-ùng Huòng-dá̤	Jianwen
Īng-lŏk Huòng-dá̤	Yongle
Hùng-hĭ Huòng-dá̤	Hongxi
Sŏng-dáik Huòng-dá̤	Xuande
Mìng Ĭng-cŭng	Zhengtong
Gīng-tái Huòng-dá̤	Jingtai (keizer)
Sìng-huá Huòng-dá̤	Chenghua
Hùng-dé Huòng-dá̤	Hongzhi
Céng-dáik Huòng-dá̤	Zhengde
Gă-cêng Huòng-dá̤	Jiajing
Lè̤ng-kéng Huòng-dá̤	Longqing
Uâng-lĭk Huòng-dá̤	Wanli
Tái-chiŏng Huòng-dá̤	Taichang
Tiĕng-kiē Huòng-dá̤	Tianqi
Sùng-dĭng Huòng-dá̤	Chongzhen
Gĭng Céng-nĭk	Kim Jong-il
Nguòng-só ciŭ-gĭ-biēu	Periodiek systeem
Chăng-màng	Blindheid
Sá̤-kṳ̄ng	Bacteriën
Chéu	Boom (plant)
Può-dò̤	Druif
Huăng-giāng-sṳ̀	Aardappel
Tòng	Tafelsuiker
Uòng-dâu	Sojaboon
Séng-sék	Informatie
Bó̤-cāi	Krant
Diêng-uâ	Telefoontoestel
Ùng-huá	Cultuur
Huáng-ngṳ̄	Sanskriet
Dâi-diòng	Dikke darm
Siēu-diòng	Dunne darm
Ĭ-hŏk	Geneeskunde
Sièng	Keukenzout
Huá-hŏk nguòng-só	Chemisch element
Unix	Unix
Ùi-gì	Go (bordspel)
Káh-dièu-nó̤h	Speelgoed
Diêng-īng	Film (cinematografie)
Gĭng-sṳ̆k	Metaal
Kă-dăk-chiă	Fiets
Mièng-huă	Katoen
Sók-dô	Snelheid
Sì-găng	Tijd
Cāi	Papier
Só-lâiu	Plastic
Miêng-cék	Oppervlakte
Gŭng-chióh	Meter
Iù-diĕng-bău	Mais
Duâi-măk	Gerst
Dĕ̤ng-nàng-ā	Zuidoost-Azië
Sīng-iòng	Shenyang
Tṳ̀ng-kéng	Chongqing
Tiĕng-cĭng	Tianjin
Ū-háng	Wuhan
Gū Ăi-gĭk	Oude Egypte
Gū Hĭ-lé-nà̤	Oude Griekenland
Hṳ̀ng	Beren
Britney Spears	Britney Spears
Ngàng	Kanker
Măk	Tarwe
Cié-sē̤	Sorgo
Pó̤-sióng	Handicap (medisch)
Lĭk-huák	Kalender
Sìng-gĭng-bâng	Psychische aandoening
Gregorius Lĭk-huák	Gregoriaanse kalender
Tutankhamun	Toetanchamon
Nguŏk-gĭng	Menstruatie
Mà-chiók	Mahjong
Ông-ò̤	Kanaal (waterweg)
Detroit	Detroit (Michigan)
Diòng-siàng	Chinese Muur
Gĭng-cê-ták	Piramide (bouwwerk)
Osman Dá̤-guók	Ottomaanse Rijk
Guók-nô̤i sĕng-sāng cūng-dĭk	Bruto binnenlands product
Diêng	Elektriciteit
Ché̤ṳng	Vuurwapen
Lòng-gĭ-ché̤ṳng	Machinegeweer
Sáung-buàng	Abacus (rekentuig)
Tāng-káik	Tank (voertuig)
Liĕk-chiĕ	Lychee
Ià-cī	Kokospalm
Tò̤	Perzik
Cáung-ngṳ̄	Zhuang (taal)
Siŏng-ngṳ̄	Xiangyu
Mì-ngù-ī-ngṳ̄	Oeigoers
Lâung-gŏ̤	Taart
Wiki Ŭk-cṳ̄ng	Wikispecies
Nĕng-dáe̤k	Beha
Ā-lá-báik-ngṳ̄	Arabisch
Dièu-siēng Tái-cŭng	Taejong van Joseon
Lù Ū-hièng	Roh Moo-hyun
Páuk Céng-hĭ	Park Chung-hee
Siĕng-ìng-ciōng	Cactusfamilie
Siŏh-tàu-lâung	Kiezelsteen
Iòng-bék	Potlood
Gă-sĭ	Meubilair
Dó̤h	Tafel (meubilair)
Ó̤-muòng	Macau
Iē-giāng	Stoel
Hù Gīng-dò̤	Hu Jintao
Sĭk Gê̤ṳng-bìng	Xi Jinping
Dòng-gêng-lĕ̤k	Giraffe (dier)
Chĭng-dáung	Shenzhen
Guōng-dĕ̤ng	Guangdong
Guōng-să̤	Guangxi
Sŭ-lièng	Sovjet-Unie
Kiák-sióng-gĭ	Fotocamera
Kagoshima-gâing	Kagoshima (prefectuur)
C ngṳ̄-ngiòng	C (programmeertaal)
Kă	Voet (anatomie)
Ciēng	Gekkonidae
Dô-dâing	Hagedissen
Giĕng-tàu	Schouder
Wikipedia:Bō̤-ciéng hō̤ ùng	Wikipedia:Etalage
模板:Link FA	Sjabloon:Link FA
Sié-gái	Wereld (Aarde)
Wikipedia:Duâi chéu â	Wikipedia:De kroeg
Busan	Busan
Lèng-huă	Heilige lotus
Vermont	Vermont
Denver	Denver
Guōng-ciŭ	Kanton (stad)
Ciōng Gái-sĭk	Chiang Kai-shek
Gŏng Dĕk-mìng	Jiang Zemin
Ŭng Gă-bō̤	Wen Jiabao
Nàng-gĭng	Nanking
Làu Dáik-huà	Andy Lau
Diŏng Hŏk-iū	Jacky Cheung
Báe̤k-gĭng Dâi-hŏk	Universiteit van Peking
Chĭng-huà Dâi-hŏk	Tsinghua-universiteit
Ŭ-lū-mŭk-cà̤	Ürümqi
Gŏng-sŭ	Jiangsu
Ciék-gŏng	Zhejiang
Dâing Siēu-bìng	Deng Xiaoping
Lò̤-mā Gê̤ṳng-huò-guók	Romeinse Republiek
Câung-kṳ̆	Tibet (gebied)
Să̤-câung	Tibetaanse Autonome Regio
Ciŭ Ŏng-lài	Zhou Enlai
Dṳ̆ng-guók Gê̤ṳng-sāng-dōng	Communistische Partij van China
Chiū-gĭ	Mobiele telefoon
Dò̤-nēu	Struisvogel
Kŏng-hĭ Huòng-dá̤	Kangxi
Dièu-siēng	Korea
Gŏ̤ Hèng-giông	Gao Xingjian
Lī Bèng	Li Peng
Lòng	Wolf
Bìng-iōng	Pyongyang
Sĭng-iók Séng-gĭng	Nieuwe Testament
9	9 (getal)
Kiék	Schorpioenen (orde)
Gièng-lè̤ng Huòng-dá̤	Qianlong
Dṳ̆ng-guók Dâi-lṳ̆k	Vasteland van China
Háik-lṳ̀ng-gĕ̤ng-sēng	Heilongjiang
Mā Ĭng-gāu	Ma Ying-jeou
Lè̤	Ezel (dier)
Sé-chiŏng	Sichuan
Gô-iók Séng-gĭng	Oude Testament
Séng-dáng-cáik	Kerstmis
Săng-gáe̤k-hìng	Driehoek (meetkunde)
Muammar Gaddafi	Moammar al-Qadhafi
Lâu-hū	Tijger
Daejeon	Daejeon
Daegu	Daegu
Sié-cŭng Dĕk-biék Cê̤ṳ-dé-chê	Sejong (stad)
Incheon	Incheon
Gyeonggi Dô̤	Gyeonggi-do
Bô-uăk-cáik	Pasen
Ò̤-báe̤k	Hebei
Bŏk Hĭ-lài	Bo Xilai
GNU Cê̤ṳ-iù Ùng-dáung Hṳ̄-kō̤-céng	GNU-licentie voor vrije documentatie
Uŏng Cĭng-ôi	Wang Tsjing-Wei
Dìng Cūi-biēng	Chen Shui-bian
À̤	Schoen
Ngṳ̀ng-hòng	Bank (financiële instelling)
Lū Séng	Lu Xun (schrijver)
7	7 (getal)
8	8 (getal)
Lĕ̤k	Hertachtigen
Hù	Meer (watervlakte)
Sáung-tàu	Knoflook
Chái-guă	Cucumis sativus
Dō̤	Eiland
Băh-sáik	Wit
Ŭ-sáik	Zwart (kleur)
6	6 (getal)
Moshchena	Mosjtsjena
Huăng-kê	Tomaat
George H. W. Bush	George H.W. Bush
Paltoga	Paltoga
Quảng Bình	Quảng Bình (provincie)
Atlanta	Atlanta
Benito Mussolini	Benito Mussolini
Sṳ̀-diēng	Woordenboek
Tàu	Hoofd (anatomie)
Hiê-lìng-dóng	Wellington (stad in Nieuw-Zeeland)
Dâi Bók-liĕk-diĕng Dō̤	Groot-Brittannië
Las Vegas	Las Vegas (Nevada)
10	10 (getal)
Alfred Nobel	Alfred Nobel
Tàu-sĕ̤	Kam (verzorging)
Guòng-lĭk	Macht (sociale wetenschappen)
Mà-hùng-cēu	Uilen (orde)
Dēng-cṳ̆ng	Uur
Ké-chiông	Meteorologie
Đà Nẵng	Đà Nẵng (stad)
Káh-chiók	Ekster
Làng-huă	Orchideeënfamilie
Gă-săk	Kakkerlakken
Ngáuk-ngṳ̀	Krokodilachtigen
Lā-lì	Manis
Nàng-muōi-sĭng	Glimwormen
Holocene	Holoceen
Hāi-báu	Zeehonden
Bà̤-bá-cēu	Winterkoning
Ciáh-giāng	Ringmus
Niccolò Cusano Dâi-hŏk	Università degli Studi Niccolò Cusano
Long An	Long An (provincie)
Thái Nguyên	Thái Nguyên (provincie)
Herodotus	Herodotus
Othello	Othello (toneelstuk)
Nĭk-buōng-hāi	Japanse Zee
Dĕ̤ng-ā	Oost-Azië
Dĕ̤ng-ĕu	Oost-Europa
Vĩnh Phúc	Vĩnh Phúc (provincie)
Chĕ̤ng	Stengelui
Liù-giù-guók	Koninkrijk Riukiu
Dièu-siēng uòng-dièu	Joseondynastie
Gŏ̤-là̤	Goryeo
Dâi-hàng Dá̤-guók	Keizerrijk Korea
Buŏk-hāi-guók	Bohai
Gŏ̤-gău-là̤	Koguryo
Bì-bà-dâu-giék	Vleermuizen
Báik-cá̤	Paekche
Sĭng-lò̤	Silla (Korea)
Tàu-huók	Haar (zoogdier)
Hàng Hĭ	Han Fei
Uòng-dá̤	Huang Di
Diéu-ngṳ̀-dài Liĕk-dō̤	Senkaku-eilanden
Gê̤ṳng-huò-dōng (Mī-guók)	Republikeinse Partij (Verenigde Staten)
Dṳ̆ng-guók	China
Mìng-ciō-dōng (Mī-guók)	Democratische Partij (Verenigde Staten)
Cūi-tiák	Otter (dier)
Sìng-dŭ	Chengdu
Buò-gŭng-ĭng	Taraxacum
Dâng-ciŭ	Zhengzhou
Cūng-tūng	President
Muāng-ciŭ-guók	Mantsjoekwo
Gù-cŭi	Streptopelia
Só̤h	Touw
Dṳ̆ng-guók Guók-mìng-dōng	Kwomintang
Ngâng	Zwaangans
Ĕng-gŏ̤	Papegaaiachtigen
Gă-huák	Optellen
Dài-uăng-sēng	Taiwan (provincie)
Dŏ̤	Mes (voorwerp)
Băng-mā	Zebra (dier)
Guók-cié biĕu-cūng cṳ̆-hô̤	Internationaal Standaard Boeknummer
Đồng Nai	Đồng Nai (provincie)
Sóc Trăng	Sóc Trăng (provincie)
Quảng Ngãi	Quảng Ngãi (provincie)
Hà Tĩnh	Hà Tĩnh (provincie)
Cà Mau	Cà Mau (provincie)
Quảng Nam	Quảng Nam
Bến Tre	Bến Tre (provincie)
Khánh Hòa	Khánh Hòa (provincie)
Káh-gă-ngṳ̄	Hakka (taal)
Sơn La	Sơn La (provincie)
Huŏng-ngiòng	Dialect
Lev Trotsky	Leon Trotski
Quảng Ninh	Quảng Ninh (provincie)
Lạng Sơn	Lạng Sơn (provincie)
Bắc Ninh	Bắc Ninh (provincie)
Gáng-ngṳ̄	Ganyu
Mà-hṳ̀ng	Reuzenpanda
Muāng-ngṳ̄	Mantsjoe (taal)
Chiū	Hand
Dô Hū	Du Fu
Gùng-dō̤	Archipel
Niŏh-niŏh	Blad
Bŭk-buó	Waterval
Yasser Arafat	Yasser Arafat
Câung-ngṳ̄	Tibetaans
Ngù-ngṳ̄	Wuyu
Tasmania	Tasmanië
Ì-cô̤	Zeep (reiniging)
Hŭk-săng	Foshan
Ciĕu-huò Tiĕng-huòng	Hirohito
Al-Qaeda	Al Qaida
Mò̤-táuk-chiă	Motorfiets
Ò̤-mā	Nijlpaard
Anastacia	Anastacia
Sĕk Gái	Tien geboden
Huă-báu	Luipaard
Să̤-ngiù	Neushoorns
Lò̤-buàng	Kompas
Buáng-dō̤	Schiereiland
Sĭng-giŏng	Sinkiang
Mŭk-guă	Papaja
Mì-sĕng-só	Vitamine
Gái-làng-chái	Wittekool
Giáng	Spiegel (optica)
Ciŭ-dièu	Zhou-dynastie
Kāng-muòng-giāng	Venster (muur)
Băh Gṳ̆ng	Witte Huis (Washington D.C.)
Gīng-chák	Politie
Báe̤k-hāi-dô̤	Hokkaido (Japan)
Nobel Huò-bìng Ciōng	Nobelprijs voor de Vrede
Sáu	Hoest
Hák-chê	Niezen
Káung-mìng	Slaap (rust)
Gèng-hāi	Aralmeer
Dé̤ṳk	Bamboe
Hù Cé-mìng	Hồ Chí Minh
Hòa Bình	Hòa Bình (provincie)
Queensland	Queensland
Tù	Bodem
Ù-huă-guō	Vijgenboom
Hưng Yên	Hưng Yên (provincie)
Dòng-dô	Lengte (meetkunde)
Kon Tum	Kon Tum (provincie)
Hậu Giang	Hậu Giang (provincie)
Máe̤ng	Droom
Yên Bái	Yên Bái (provincie)
Bắc Giang	Bắc Giang (provincie)
Thừa Thiên-Huế	Thừa Thiên-Huế
Bắc Kạn	Bắc Kạn (provincie)
Lai Châu	Lai Châu (provincie)
Hà Nam	Hà Nam
Lào Cai	Lào Cai (provincie)
Mìng-dĕ̤ng-ngṳ̄	Mindong
Hannibal	Hannibal Barkas
Mìng-báe̤k-ngṳ̄	Minbei
Mìng-nàng-ngṳ̄	Minnanyu
Thanh Hóa	Thanh Hóa (provincie)
Kiên Giang	Kiên Giang
Quảng Trị	Quảng Trị (provincie)
Nghệ An	Nghệ An
An Giang	An Giang (provincie)
Tây Ninh	Tây Ninh (provincie)
Phú Thọ	Phú Thọ (provincie)
Duâi-sĭng-sĭng	Gorilla's
Trà Vinh	Trà Vinh (provincie)
Bạc Liêu	Bạc Liêu (provincie)
Gia Lai	Gia Lai
Tiền Giang	Tiền Giang
Bình Phước	Bình Phước (provincie)
Đồng Tháp	Đồng Tháp
Thái Bình	Thái Bình (provincie)
Hà Giang	Hà Giang (provincie)
Đắk Lắk	Đắk Lắk
Cáung-cŭk	Zhuang (volk)
Bình Định	Bình Định (provincie)
Lâm Đồng	Lâm Đồng
Đắk Nông	Đắk Nông (provincie)
Phú Yên	Phú Yên
Hải Dương	Hải Dương (provincie)
Dièu-ciŭ-uâ	Chaozhouhua
Iók-hâng Hók Ĭng	Evangelie volgens Johannes
Dài-uăng-uâ	Taiwanees
Muòng	Deur
Chiēng-gák	Nagel (anatomie)
Cao Bằng	Cao Bằng (provincie)
Bình Dương	Bình Dương (provincie)
Bình Thuận	Bình Thuận (provincie)
Bà Rịa-Vũng Tàu	Bà Rịa-Vũng Tàu
Ninh Bình	Ninh Bình (provincie)
Ninh Thuận	Ninh Thuận
Nam Định	Nam Định (provincie)
Điện Biên	Điện Biên (provincie)
Sìng-lṳ̀ng	Jackie Chan
Méng	Gelaat
Ùng-ngiòng-ùng	Klassiek Chinees
Gāng-lāng	Olijf
Săng-ôi-ék-tā̤	Drie-eenheid
Sŏng-cṳ̄	Sunzi
Sĭng-săng	Onderwijzer
Cleveland	Cleveland (Ohio)
Dăk-lâi Lā-mà	Dalai lama
Huă-sĕng	Pinda
100	100 (getal)
Kă-kók-tàu	Knie (anatomie)
Hâing	Abrikoos
Ngāng-giáng	Bril
Cê̤ṳ-lài-huōi	Lucifer (voorwerp)
Chê-diòng	Markt (economie)
Nàng Dṳ̆ng-guók Hāi	Zuid-Chinese Zee
Dièu-siēng Sié-cŭng	Sejong de Grote van Joseon
Hăk-gĭng	Legering
Bĭng-siŏng	Koelkast
Nobel Ùng-hŏk Ciōng	Nobelprijs voor de Literatuur
Huăng-sṳ̀	Zoete aardappel
Uòng-hāi	Gele Zee
Akihito	Akihito
Newton ông-dông-hŏk dêng-lŭk	Wetten van Newton
Să̤-guă	Watermeloen
Biobío Dâi-hŏk	Universiteit van de Bio-Bio
Huòng-dá̤	Keizer
Ìng-mìng-bê	Chinese renminbi
Tā̤-cék	Inhoud (volume)
Cèng-sáik	Oranje (kleur)
Gă-sĭ-huă	Gereedschap
Ĭ-sĕng	Arts
Iéng (cēu)	Zwaluwen (zangvogels)
Kó	Broek (kledingstuk)
Lô-gă Hók Ĭng	Evangelie volgens Lucas
Mìng-ciō-dōng	Democratische Partij
Ciŏng-tàu	Baksteen
Tiō-uòng	Ellips (wiskunde)
Sìng-huák	Vermenigvuldigen
Sé̤ṳ-dù Hèng-diông	Handelingen van de apostelen
Uòng-dô̤ Sĕk-nê Sĭng-cô̤	Dierenriem
Huá-siŏh	Fossiel
Gēng-huák	Aftrekken (wiskunde)
Cī-cī	Zaad (plant)
Chiĕk	Krabben
Gă-dŏ̤	Schaar (gereedschap)
Niêu	Urine
Ăng-hŭi	Anhui
Ngiăh	Voorhoofd
Sĭ-piĕng	Psalmen
Chungcheong Báe̤k-dô̤	Chungcheongbuk-do
Chungcheong Nàng-dô̤	Chungcheongnam-do
Gangwon Dô̤ (Dâi-hàng Mìng-guók)	Gangwon-do
Nô̤i Mūng-gū	Binnen-Mongolië
Gĭng Nĭk-sìng	Kim Il-sung
Gyeongsang Nàng-dô̤	Gyeongsangnam-do
Gyeongsang Báe̤k-dô̤	Gyeongsangbuk-do
Jeolla Báe̤k-dô̤	Jeollabuk-do
Jeolla Nàng-dô̤	Jeollanam-do
Jeju Dĕk-biék Cê̤ṳ-dé-dô̤	Jeju-do
Huăng-cièng-giāng	Munt (betaalmiddel)
Bă-biĕk-ták	Toren van Babel
Ulsan	Ulsan
Gwangju	Gwangju
Chó	Azijn
Kangwŏn Dô̤ (Dièu-siēng Mìng-ciō-ciō-ngiê Ìng-mìng Gê̤ṳng-huò-guók)	Kangwŏn-do
Michael Jordan	Michael Jordan
Lé-ê-gé	Leviticus
Gṳ̆ng-gṳ̆ng	Wortel (plant)
Bì-bà (cūi-guō)	Loquat
Hamlet	Hamlet
Huà Guók-hŭng	Hua Guofeng
Sāng	Paraplu
Làu Hiēu-pŏ̤	Liu Xiaobo
Hók-gióng	Fujian (China)
Mūng-gū-cŭk	Mongolen
Mĕk-sê Liŏh	Openbaring van Johannes
Hièng-câung	Xuanzang
Gū-chiŏng	Bil (anatomie)
Mìng-chòng	Bed
Hāi-nàng	Hainan
Háng-ngṳ̄ Pĭng-ĭng	Hanyu pinyin
Băh-gák	Rotsduif
Găng-sé̤ṳk	Gansu
Taliban	Taliban
Huŏi-sáik	Grijs
Sĭng-mêng-gé	Deuteronomium
Sŭ-ciŭ	Suzhou (Jiangsu)
Ŭng-ciŭ	Wenzhou
Háng-cŭk	Han-Chinezen
Nìng-pŏ̤	Ningbo
Chói-chiŭ	Baard (haargroei)
Cāi-iêu	Vliegeren
Hăk-ī-bĭng	Harbin
Mā-kì	Bloedzuigers
1000	1000 (getal)
Mìng-só-gé	Numeri
Cáu-sèng	Keuken (ruimte)
Hùng-nàng	Yunnan
Lō̤-uă	Corvus (geslacht)
Săng-dĕ̤ng	Shandong
È̤ng-ĕ̤ng	Duizendpoten
Ò̤-nàng	Henan (China)
Mì-mò̤	Wenkbrauw
Bók-sài	Navel
Lièu-nìng	Liaoning
Hióng-liông	Vector (wiskunde)
Cretaceous	Krijt (periode)
Tochigi-gâing	Tochigi (prefectuur)
Chói-mò̤-cēu	IJsvogels
Dàu	Dobbelsteen
Cūi-nà̤	Cement (bouwmateriaal)
Gék-lìng	Jilin (provincie)
Dĕ̤ng Dṳ̆ng-guók Hāi	Oost-Chinese Zee
Hāi-chĕk	Zeeroverij
Gūi	Spook
Bóng-dó̤	Afval (vuilnis)
Hù-nàng	Hunan
Jurassic	Jura (periode)
Chĭng-hāi	Qinghai
Mì-ngù-ī-cŭk	Oeigoeren
Ă-piéng	Opium
Chiū-cī	Ring (sieraad)
Hù-báe̤k	Hubei
Săng-să̤	Shanxi
Cĕ̤ng-sáik	Bruin
Giòng-găng	Verkrachting
Gói-ciŭ	Guizhou
Triassic	Trias
Sék-sáuk	Krekels
Cāi-piéu	Bankbiljet
SQL	SQL
Iók-cṳ̆-ā-gé	Jozua (boek)
Cŏng-cṳ̄	Zhuangzi
Cṳ̀-hĭ Tái-hâiu	Cixi (keizerin)
Kan Naoto	Naoto Kan
Miyagi-gâing	Miyagi (prefectuur)
模板:Commons category	Sjabloon:Commonscat
Lò̤-mā Cṳ̆	Brief van Paulus aan de Romeinen
Pău-ŭk-siáng	Parabool (wiskunde)
Dô̤-dáik	Moraal
Iwate-gâing	Iwate (prefectuur)
Ĭ-siòng-chiă	Naaimachine
Dièu-siēng Lò̤-dông-dōng	Koreaanse Arbeiderspartij
Nàng-báe̤k-dièu	Zuidelijke en Noordelijke Dynastieën
Chái Ĭ-lìng	Jolin Tsai
Pì-lĭk-bī Cṳ̆	Brief van Paulus aan de Filippenzen
Ngā-gŏ-cṳ̆	Hooglied
Mā-lăk-gĭ-cṳ̆	Maleachi (boek)
模板:Taxobox	Sjabloon:Taxobox
分類:Guók-uòng	Categorie:Koning
分類:Gŭng-ciō	Categorie:Monarch
Diŏng Ngiê-mèu	Zhang Yimou
模板:Dṳ̆ng-guók lĭk-sṳ̄	Sjabloon:Zijbalk geschiedenis China
Gĭng Céng-ŏng	Kim Jong-un
Mìng-ngṳ̄	Minyu
Gŏng-să̤	Jiangxi
Nìng-hâ	Ningxia
Lùng-sùng	Drakenboot
Noda Yoshihiko	Yoshihiko Noda
Yingluck Shinawatra	Yingluck Shinawatra
Siŏh-gă-cŏng	Shijiazhuang
Chṳ̄	Muroidea
Ciŏ-hāi	Zhuhai
Sáng-tàu	Shantou
Dâng-gŏng	Zhanjiang
Mùi-ciŭ	Meizhou
Chĭng-uōng	Qingyuan
Dĕ̤ng-uāng	Dongguan
Dṳ̆ng-săng-chê	Zhongshan (stadsprefectuur)
Dièu-ciŭ	Chaozhou
Tàng-táik	Meervalachtigen
Gé̤ṳk-huă	Chrysanthemum
Sofie gì Sié-gái	De wereld van Sofie
Ordovician	Ordovicium
Silurian	Siluur
Hók-gióng-sēng (Dṳ̆ng-huà Mìng-guók)	Fujian (Republiek China)
Mièu-lĭk	Miaoli (xiàn)
Dāng-nòng	Galblaas
Devonian	Devoon
Hók-ciŭ	Fuzhou (Fujian)
Nàng-bìng	Nanping
Buò-dièng	Putian
Săng-mìng	Sanming
Ciòng-ciŭ	Quanzhou
Â-muòng	Xiamen
Ciŏng-ciŭ	Zhangzhou
Lṳ̀ng-ngàng	Longyan
Nìng-dáik	Ningde
Să̤-nìng	Xining
Să̤-iù-gé	De reis naar het westen
Săng-guók Iēng-ngiê	Roman van de Drie Koninkrijken
Cūi-hū	Verhaal van de wateroever
Ā-dŏng	Adam
Aomori-gâing	Aomori (prefectuur)
Fukushima-gâing	Fukushima (prefectuur)
Tái-nguòng	Taiyuan
Hải Phòng	Hải Phòng
Sĭng-dé̤ṳk (gâing)	Hsinchu (xiàn)
Dâi-lièng	Dalian
Hĭ-Pŏ̤ Ciéng-cĕng	Perzische Oorlogen
Permian	Perm (periode)
Biēu-chĭng	Neef
Cambrian	Cambrium
Iòng-ciók	Kaars
Chiba-gâing	Chiba (prefectuur)
Pău	Pompelmoes
Lô-dáik-gé	Ruth (boek)
Mà-hù	Echte libellen
Dáng-ī-lī	Daniël (boek)
Páuk-káik	Poker
Mô̤	Hoed
Gŏ̤-lìng-dŏ̤ Cièng Cṳ̆	Eerste brief van Paulus aan de Korintiërs
Aichi-gâing	Aichi (prefectuur)
Lī-ngṳ̀	Karper
Muāng-ciŭ	Mantsjoerije
Sê̤ṳ-sṳ-gé	Rechters
Pŏ̤-lìng-chái	Spinazie
Akita-gâing	Akita (prefectuur)
Pièu-gĕng	Lepel (bestek)
Dê̤ṳ	Eetstokjes
Mĕ̤k-lê	Jasminum
Nàng-dàu	Nantou (xiàn)
Gié-tiàng-chiă	Taxi (vervoer)
Â-hài	Kin (lichaamsdeel)
Gŭ	Paddenstoel (schimmel)
Ibaraki-gâing	Ibaraki (prefectuur)
Lài-gŭng	Donder
Siĕu-sŏng	Salpeterzuur
Ngù-giāng-kó	Spijkerbroek
Bō̤-siŏh	Edelsteen
Chāu-māng	Caelifera
Diòng-chŭng	Changchun
Milan Kundera	Milan Kundera
Lâung	Ei (voeding)
Lĕ̤k-sé Sê̤ṳ-giông	Tiananmenprotest
Diêu Ciē-iòng	Zhao Ziyang
Hù Iêu-băng	Hu Yaobang
Fukuda Yasuo	Yasuo Fukuda
Sṳ̀ng-chéu (Sṳ̀ng-báh)	Dennenfamilie
Gī-hò̤-chiă	Passer (gereedschap)
Táng-sŏng	Diwaterstofcarbonaat
Liòng-chióh	Liniaal
Chăng-màng-chṳ̄	Mollen
Dṳ̆ng-hâ Iâ cĭ Máe̤ng	A Midsummer Night's Dream (toneelstuk)
Tié-tàu-să-hô	Barbier
Mā-kō̤ Hók Ĭng	Evangelie volgens Marcus
Diê (dông-ŭk)	Oester (gerecht)
Kaesŏng	Kaesŏng
Hwanghae Báe̤k-dô̤	Hwanghae-pukto
P'yŏng'an Báe̤k-dô̤	P'yŏngan-pukto
Hamgyŏng Báe̤k-dô̤	Hamgyŏng-pukto
Hamgyŏng Nàng-dô̤	Hamgyŏng-namdo
P'yŏng'an Nàng-dô̤	P'yŏngan-namdo
Namp'o	Namp'o
Ryanggang Dô̤	Ryanggang-do
Tò̤-huòng	Taoyuan (xiàn)
Sŭk-mī	Kleefrijst
Gĭng-dŭ	Kioto (prefectuur)
Ōsaka-hū	Osaka (prefectuur)
Cék-ngṳ̀	Goudvis (dier)
Fukuoka-gâing	Fukuoka (prefectuur)
Ehime-gâing	Ehime
Gŏ̤-lìng-dŏ̤, Hâiu Cṳ̆	Tweede brief van Paulus aan de Korintiërs
Gàu-ūng	Lumbricina
Sā̤-ĭ-gĭ	Wasmachine
Gék	Mandarijn (vrucht)
Gé̤ṳ	Zaag
Yamagata-gâing	Yamagata (prefectuur)
Éu-dê-huòng	Kleuterschool
Dài-uăng Hāi-hiĕk	Straat van Taiwan
Lù-guói	Aloë
Yamaguchi-gâing	Yamaguchi (prefectuur)
Kanagawa-gâing	Kanagawa (prefectuur)
Nagano-gâing	Nagano (prefectuur)
Iĕng-huă	Vuurwerk
Mì-pŏ̤-lù	Magnetron (oven)
Saitama-gâing	Saitama (prefectuur)
Mie-gâing	Mie (prefectuur)
Hĭ-báik-lài Cṳ̆	Brief aan de Hebreeën
Gă-lăk-tái Cṳ̆	Brief van Paulus aan de Galaten
Muàng-ngṳ̀	Palingachtigen
Céng-gŏng	Jinjiang
Siŏng-dièu	Shang-dynastie
Gunma-gâing	Gunma (prefectuur)
Hyōgo-gâing	Hyogo (prefectuur)
Miyazaki-gâing	Miyazaki (prefectuur)
Kumamoto-gâing	Kumamoto (prefectuur)
Ă-cì	Zangcicaden
Koizumi Jun'ichirō	Junichiro Koizumi
Ī-sê̤ṳ-táik-cṳ̆	Ester (boek)
Diòng-dô-cṳ̆	Prediker (boek)
Hatoyama Yukio	Yukio Hatoyama
Gŏ̤-lò̤-să̤ Cṳ̆	Brief van Paulus aan de Kolossenzen
Ngā-gáuk Cṳ̆	Brief van Jakobus
Iók-hâng Ék Cṳ̆	Eerste brief van Johannes
Pì-lé-muòng Cṳ̆	Brief van Paulus aan Filemon
Táik-sák-lò̤-nà̤-giă, Hâiu Cṳ̆	Tweede brief van Paulus aan de Tessalonicenzen
Táik-sák-lò̤-nà̤-giă Cièng Cṳ̆	Eerste brief van Paulus aan de Tessalonicenzen
Bī-dáik Cièng Cṳ̆	Eerste brief van Petrus
Bī-dáik Hâiu Cṳ̆	Tweede brief van Petrus
Tì-mò̤-tái Cièng Cṳ̆	Eerste brief van Paulus aan Timoteüs
Dòng-lòng	Bidsprinkhanen
Gifu-gâing	Gifu (prefectuur)
Ishikawa-gâing	Ishikawa (prefectuur)
Nara-gâing	Nara (prefectuur)
Wakayama-gâing	Wakayama (prefectuur)
Shizuoka-gâing	Shizuoka (prefectuur)
Shiga-gâing	Shiga (prefectuur)
Iók-hâng Nê Cṳ̆	Tweede brief van Johannes
Ī-suói-ā-cṳ̆	Jesaja (boek)
Iók-hâng Săng Cṳ̆	Derde brief van Johannes
Iù-dâi Cṳ̆	Brief van Judas
Tì-mò̤-tái Hâiu Cṳ̆	Tweede brief van Paulus aan Timoteüs
Tì-dŏ̤ Cṳ̆	Brief van Paulus aan Titus
Nùng-mìng	Agrariër
Ià-lé-mī-cṳ̆	Jeremia (boek)
Ī-sê̤ṳ-lá-cṳ̆	Ezra (boek)
Nà̤-hĭ-mī-cṳ̆	Nehemia (boek)
Iók-ngī-cṳ̆	Joël (boek)
Băh-lô	Kleine zilverreiger
Chŭng-cáik	Chinees nieuwjaar
Sō-siè	Sleutel (slot)
Abe Shinzō	Shinzo Abe
Asō Tarō	Taro Aso
Séng-cṳ̆-tā̤	Egyptische hiërogliefen
Niigata-gâing	Niigata (prefectuur)
Yamanashi-gâing	Yamanashi (prefectuur)
Shimane-gâing	Shimane (prefectuur)
Toyama-gâing	Toyama (prefectuur)
Okayama-gâing	Okayama (prefectuur)
Kă-tōi	Been (ledemaat)
Piăng	Rug (anatomie)
Piĕ	Brief
Sáik-màng	Kleurenblindheid
Carboniferous	Carboon
Ciŏng-huá	Changhua (xiàn)
Fukui-gâing	Fukui (prefectuur)
Ōita-gâing	Oita (prefectuur)
Tottori-gâing	Tottori (prefectuur)
Nùng-lĭk	Chinese kalender
Kōchi-gâing	Kochi (prefectuur)
Uâng-iū īng-lĭk dêng-lŭk	Gravitatiewet van Newton
Chèng-gēng	Zijdevlinder
Páuk Gê̤ṳng-hiê	Park Geun-hye
Dài-nàng	Tainan (stad)
Cĕng	Naald (naaigerei)
Muāng-cŭk	Mantsjoes
Kìng-giāng	Tang (gereedschap)
Anna Karenina	Anna Karenina
Gáung-gṳ̆ng	Wapening
Tiè-mà	Huilen
Hùng-lìng	Yunlin
Diāng	Pan (voorwerp)
Kă-cāi	Teen
Lāng	Speeksel
Diò-să-hô	Kok (beroep)
Bĭng-lòng	Betelpalm
Dâi-céng Tiĕng-huòng	Yoshihito
Băng-sièng Lā-mà	Pänchen lama
Mŭk-gê̤ṳng	Tuinhibiscus
Muòi-kṳ̄ng	Beschimmeling
Gĭng-cá̤	Economie (systeem)
Mĕ̤k-tiák	Wimper
Nguòng-cṳ̄-bék	Balpen
Norodom Sihanouk	Norodom Sihanouk
Saga-gâing	Saga (prefectuur)
Tokushima-gâing	Tokushima (prefectuur)
Lòng-dâung	Bilzekruid
Lòi-sĭ-gā	Schroevendraaier
Sĭk-sĭk	Vleugel (vogel)
Kagawa-gâing	Kagawa (prefectuur)
Thaksin Shinawatra	Thaksin Shinawatra
Kê	Diospyros
Săng-guók (Dièu-siēng)	Drie koninkrijken van Korea
Bék	Pen
Ŭng-dìng	Stof (deeltjes)
Huăng-siŏh-liù	Guave
Duâi-tàu-giáng	Loep
Gă-ngiê (gâing)	Chiayi (xiàn)
Puái-dáu	Noen (tijd)
Huōi-căi	Brand (vuur)
Chiū-ló̤h	Handschoen
Nagasaki-gâing	Nagasaki (prefectuur)
Hâ-dièu	Xia-dynastie
Cá̤-nàng	Jinan
Dṳ̆ng-guók Káung-nĭk Ciéng-cĕng	Tweede Chinees-Japanse Oorlog
Sarawak	Sarawak (staat)
Hŭng-cūi	Feng Shui
Chiéu	Lachen (gedrag)
Ngô̤-mâng gâe̤ng Piĕng-giéng	Pride and Prejudice (boek)
Oda Nobunaga	Oda Nobunaga
Dăng-hù	Koraal (zoölogie)
Lī Sìng-uāng	Syngman Rhee
Iòng-bék-chó̤	Gum (materiaal)
Nàng-chiŏng	Nanchang
Tokugawa Ieyasu	Tokugawa Ieyasu
Bók-séu-gáung	Roestvast staal
Sáu-chiū	Bezem
Dŭk-cài	Autocratie
Kŭng-dièu	Airconditioning
Diòng-să	Changsha
Pèng	Verf
Mìng-dê Tiĕng-huòng	Meiji (keizer)
Kă-âu-dăng	Hiel
Ā-mò̤-sê̤ṳ-cṳ̆	Amos (boek)
Ŏ̤-bă-dī-ā-cṳ̆	Obadja (boek)
Itō Hirobumi	Ito Hirobumi
Nguŏh	Jade (mineraal)
Só-gé̤ṳ-kó guāng-lī hiê-tūng	Databasemanagementsysteem
Dâu-hô	Tofoe
Mì-hèu	Makaken
Mī-giă-cṳ̆	Micha (boek)
Bù-sák	Bodhisattva
Hăk-gĭ-cṳ̆	Haggai (boek)
Ī-să̤-giék	Ezechiël (boek)
Chiū-biēu	Horloge
ASP.NET	ASP.NET
Iók-nā-cṳ̆	Jona (boek)
Sabah	Sabah
Ià-lé-mī-ăi-gŏ̤	Klaagliederen
Tái-gáng	Eunuch
Nàng-nìng	Nanning
Ê-só	Mononatriumglutamaat
Nā-ŭng-cṳ̆	Nahum (boek)
Hăk-bă-gók-cṳ̆	Habakuk (boek)
Sák-gā-lé-ă-cṳ̆	Zacharia (boek)
Guók-gê̤ṳng Nô̤i-ciéng	Chinese Burgeroorlog
Uŏk-nàng Gê̤ṳng-huò-guók	Zuid-Vietnam
Chiĕu-chê	Supermarkt
Ciŏng Cṳ̄-ì	Zhang Ziyi
Lák-tàu	Alopecia androgenetica
Gulliver Lṳ̄-hèng-gé	Gullivers reizen
Gŏ̤-hṳ̀ng	Kaohsiung
Naha-chê	Naha (Okinawa)
Buŏk-hāi	Bohaizee
Báh-chói	Geeuwreflex
Hâung Ṳ̄	Xiang Yu
Putrajaya	Putrajaya
Kŏng-mìng	Kunming
Nĭk-guŏng-dĕng	Fluorescentielamp
Jane Eyre	Jane Eyre
Johor	Johor
Ngâung	Mentale retardatie
Huòi-cŭk	Hui (volk)
Làng-ciŭ	Lanzhou
Hŏ̤-să̤-cṳ̆	Hosea (boek)
Tiék-cĭng	Roest (metaal)
Dĕ̤ng-kiĕ	Zeekatten (inktvissen)
Lìng Cáik-sṳ̀	Lin Zexu
Săng-guók	Drie Koninkrijken (China)
Chŭng-chiŭ Sì-dâi	Periode van Lente en Herfst
Ciéng-guók Sì-dâi	Periode van de Strijdende Staten
Puō-ngì	Puyi
Mā-lăk-gă	Malakka (staat)
Oracle	Oracle Database
Hăk-bùi	Hefei
Huák-lùng-gŭng	Falun Gong
Kelantan	Kelantan
Lŏk-iòng	Luoyang
Toyotomi Hideyoshi	Toyotomi Hideyoshi
Kana	Kana (Japans)
Câung-cŭk	Tibetanen
Pulau Pinang	Penang (staat)
Hamasaki Ayumi	Ayumi Hamasaki
Să̤-huăng-ngā-cṳ̆	Sefanja (boek)
Dâi-nĭk-buōng Dá̤-guók	Japans Keizerrijk
Hṳ̆ng-nù	Xiongnu
Mâing-cṳ̄	Mencius
Kedah	Kedah
Perak	Perak
Hŏk-ôi	Academische graad
Gié-lìng	Guilin
Terengganu	Terengganu
Selangor	Selangor
Iòng (dông-ŭk)	Bokken
Hāi-kāu	Haikou
Chāu-buōng sĭk-ŭk	Kruidachtig
Pahang	Pahang (staat)
Bă-là̤ Séng-mū-iêng (Siēu-siók)	De klokkenluider van de Notre Dame (boek)
Chiông-gì	Chinees schaken
Gói-iòng	Guiyang
Gáung-bék	Vulpen
Ngù Dìng-iēng	Ngô Đình Diệm
Dĭng-hiŏng-kó̤	Ansjovissen
Miêng	Noedels
Hiêng-câi	Heden
Lèng-gēng	Longan
Mì-lĕk-hŭk	Maitreya
Guăng-ĭng	Avalokitesvara
Bìng-dĕ̤ng	Pingtung (xiàn)
Gēu-gī	Boksdoorn
Lĕ̤k-dèu-gáuk	Rib (anatomie)
Dâng Sìng-gŭng	Koxinga
Nguŏk-biāng	Maancake
Ciŭ Īng-kŏng	Zhou Yongkang
Cṳ̆-gák Liông	Zhuge Liang
Ció-ĭng Hù-hô̤	Zhuyin
Tù-kēng	Veenmollen
Dṳ̆ng-guók Ìng-mìng Gāi-huóng-gŭng	Volksbevrijdingsleger
Sìng-ū Tiĕng-huòng	Jimmu
Ciē-chái	Nori (eetbaar zeewier)
Dennis Rodman	Dennis Rodman
È̤ng-dà	Zwarte thee
Cò̤ Chó̤	Cao Cao
Tài-tàu	Onthoofding
Cūi-ngù	Boktorren
Ŭi-nà̤-sṳ̆ Sĕng-lī-nè̤ng	The Merchant of Venice
Ū-ì-săng	Wuyigebergte
Ŭ-sŭ-lī-gĕ̤ng	Oessoeri
Dĕ̤ng-cé	Kortste dag
Tiĕng-huòng	Keizer van Japan
Kăi-hŭng	Kaifeng
Sĭng-dài-bê	Taiwanese dollar
Nguòng Sié-kāi	Yuan Shikai
Gă-lṳ̀ng Huòng-dá̤	Gia Long
John Wesley	John Wesley
Siăh	Eten
Perlis	Perlis
Negeri Sembilan	Negeri Sembilan
Labuan	Labuan (federaal territorium)
Lṳ̀ng	Chinese draak
Iòng-iù-gàu	Petroleumlamp
Cần Thơ	Cần Thơ (stad)
Gĭng-cŭk	Vietnamezen
Ciĕng-bò̤	Koninkrijk Champa
Diòng-gáu-sê̤ṳ	Missionaris
Uōng-dâi Cièng-tiàng	Grote verwachtingen
Niōng-bēng	Plafond (bouw)
Rasŏn	Rasŏn
Guăng Ṳ̄	Guan Yu
Ŭ-gŭi	Schildpadden
Tá̤	Lade
Gê̤ṳng-huò-dōng	Republikeinse Partij
Bō̤-dâi Huòng-dá̤	Bảo Đại
Siê-iù	Sojasaus
Ŭ-lṳ̀ng-dà	Oolongthee
Huōi-lṳ̀ng-guō	Pitaja
Gê̤ṳng-sāng-dōng	Communistische partij
Chái Ĭng-ùng	Tsai Ing-wen
Băh-cṳ̄ng-nè̤ng	Blanken
Ŏ̤-mì-tò̤-hŭk	Amitabha
Ngiè-làng	Yilan (xiàn)
Ciŭ Giĕk-lùng	Jay Chou
Orhan Pamuk	Orhan Pamuk
Carpineto Romano	Carpineto Romano
Ngū-dâi Sĕk-guók	Vijf Dynastieën en Tien Koninkrijken
Cō̤	Jujube
Tā̤-ṳ̆k	Lichamelijke opvoeding
Sĭng-báe̤k	Nieuw Taipei
Dài-dṳ̆ng	Taichung
Làu Bê	Liu Bei
Huă-lièng	Hualien (xiàn)
Gĭng-muòng	Kinmen
Dài-dĕ̤ng	Taitung (xiàn)
Sĭng-dé̤ṳk (chê)	Hsinchu
Gă-ngiê (chê)	Chiayi
Giĕ-lè̤ng	Keelung
Săi	Sai
Dièu-siēng Gŏ̤-cŭng	Gojong van Joseon
Gáuk-gáuk	Bot (anatomie)
Amuro Namie	Namie Amuro
Diêng-tù	Batterij (elektrisch)
Gê̤ṳ-gê̤ṳ	Kruk (hulpmiddel)
Nakashima Mika	Mika Nakashima
Hù-lì-mà	Siberische wezel
Gŏ̤-ák-guŏ	Hogedrukpan
Chagang Dô̤	Chagang-do
Óng-chái	Waterspinazie
Ké̤ṳk-siăh	Bedelen
Sŏng-ngù	Koninkrijk Wu
Băh-cŭk	Bai (volk)
Â-dáu	Middag (tijd)
Huòng Tái-gĭk	Hong Taiji
Guŏng-sê̤ṳ Huòng-dá̤	Guangxu
Alan Dawa Dolma	Alan Dawa Dolma
Sông-dê Huòng-dá̤	Shunzhi
Nū-ī-hăk-cà̤	Nurhaci
Iòng-muòi	Yang mei
Sŏng Guòng	Sun Quan
Cò̤ Pī	Cao Pi
Lī Dĕng-hŭi	Lee Teng-hui
Ṳ̆ng-céng Huòng-dá̤	Yongzheng
Dùng-dê Huòng-dá̤	Tongzhi
Dŭng-huòng	Dunhuang
Să-mŏk	Erg (landvorm)
Hiŏng-iòng-guă	Chayote
Uòng Ăng-sĭk	Wang Anshi
Săng-ā	Sanya
Dài-uăng Mìng-ciō-guók	Republiek Formosa
Sṳ̆k-háng	Koninkrijk Shu
Cò̤-ngôi	Koninkrijk Wei
Hiŏng-gŭ	Shiitake
Mŭk-ngī	Judasoor
Sā̤-tŏng	Baden (activiteit)
Gă-kéng Huòng-dá̤	Jiaqing
Páuk Hièng-īng	Pak Hon-yong
Dièu-siēng Sié-cū	Sejo van Joseon
Dô̤-guŏng Huòng-dá̤	Daoguang
Hièng-hŭng Huòng-dá̤	Xianfeng
Hùng Séu-ciòng	Hong Xiuquan
Gĭng-kiŏk	Jing-opera
Báik-guá	Trigram (I Tjing)
Sṳ̆-mā Hé	Sima Yi
Hŭng-sṳ̆k	Conventie
Ièu-cŭk	Yao (volk)
Bĭng-sĭng	Bing Xin
Biék	Weekschildpadden
Dièu-siēng Tái-cū	Taejo van Joseon
Báik-nguŏk-cáik	Midherfstfestival
Guŏng-Dṳ̆ng Huòng-dá̤	Quang Trung (keizer)
Ngà̤ Táuk-sĭng	Watchman Nee
Liŏh-chiông-gĭ	Videoband
Dâng-chái	Mytilidae
Gā-cō̤	Vlooien
Mā-tái Hók Ĭng	Evangelie volgens Matteüs
Sĕk-cê-gá	Kruis (christendom)
Ī-hók-sū Cṳ̆	Brief van Paulus aan de Efeziërs
Sìng	Sing
Mā-cū (Sìng)	Tianhou
Uŏk-nàng Gê̤ṳng-sāng-dōng	Communistische Partij van Vietnam
Kū-guă	Sopropo
Mìng-miâng Huòng-dá̤	Minh Mạng
Dṳ̆ng-huà Mìng-guók Guók-gŭng	Strijdkrachten van de Republiek China
Ì-cŭk	Yi (volk)
Gāu-nguŏk-gāu	Chongyangfestival
Dâing Lâ̤-gŭng	Teresa Teng
Lṳ̄ Séu-lièng	Annette Lu
Sê̤ṳ-dáik Huòng-dá̤	Tự Đức
Cṳ̀-ciŏng	Vloertegel
Ngù Săng-gié	Wu Sangui
Gŏ̤ Dé-sêng	Gao Zhisheng
Huăng-giāng	Buitenlander
Tiăng-dŏng	Woonkamer
Ók-dāu	Strijkijzer
Liŏh-dà	Groene thee
Liŏh-dâu	Mungboon
Dièu-siēng-cŭk	Koreanen
Mò̤-bék	Kwast (gereedschap)
Páuk Hông-ciŏ	Pak Pong-ju
Hŭk-dáng Dâi-hŏk	Fudan-universiteit
Hòng-ciŭ Să̤-hù	Westelijke Meer
Gă-săk-giāng	Miniklasse
Gái-chái	Sareptamosterd
Siông-hāi Gău-tŭng Dâi-hŏk	Jiaotong-universiteit van Shanghai
Bù-sìng	Echte vliegen
Ciū-ciòng	Jiuquan
Hŭ-huò-hô̤-dĕk	Hohhot
Ngù Chĭng-nguòng	Go Seigen
Hà-iù	Vissaus
Băh-ngiê	Termieten
Páu-diông	Rotje
Hṳ̆ng-dòng	Borststuk
Mā-cū (Dō̤)	Matsu-archipel
Să̤-cŏng	Pak (kleding)
Ìng-cṳ̄	Mensenzoon
Hiroshima-gâing	Hiroshima (prefectuur)
Chiēng-cāi	Vinger
Hwanghae Nàng-dô̤	Hwanghae-namdo
Hók-tīng	Fuding
Gióng-iòng	Jianyang (Fujian)
Dáng-mìng	Danjia
Guōng-guă	Waspompoen
Káh-gă	Hakka (volk)
Nàng-gĭng Dâi-hŏk	Universiteit van Nanking
Chék-nguŏk-buáng	Geestenfeest
Hù-siŭ	Misgurnus anguillicaudatus
Cò̤ Sĭk	Cao Zhi
Ciŭ Ùng-uòng	Zhou Wenwang
Huò-sĭng	Heshen
Bō̤-sĕng Dâi-dá̤	Baoshengdadi
Diêu Dò̤	Zhao Tuo
Mìng-nàng-nè̤ng	Hoklo
Buò-gì	Chinese schermpalm
Dièu-siēng Buáng-dō̤ lĭk-sṳ̄	Geschiedenis van Korea
Huá-huá	Kuifmaina
Mī-hūng	Mihoen
Háng-cê Ùng-huá-kuŏng	Sinosfeer
Hók-gióng tū-làu	Tulou
Chĭng-mìng	Qingmingfestival
Nê-hù	Erhu
Pū-tŭng-uâ	Standaardmandarijn
Siă-cŭk	She (volk)
Mē̤ng-giāng	Motmuggen
Mĭk-pŭng	Bijen en hommels
Okinawa-gâing	Okinawa (prefectuur)
Diòng-lŏ̤h	Changle
Nàng-ā	Zuid-Azië
Gŭng-sĭ	Vennootschap
Tŏng-diè-dáing	Badhuis
Tì-kŭ	Spaanse makreel
Ŭ-cṳ̄ng-nè̤ng	Zwarten
Hâ-uă	Eva (persoon)
Chèng-chṳ̄	Woelmuizen
Kiŏng-cŭk	Qiang
Wiki Bô-lâung-diòng	Wikimedia Incubator
Nà̤-gŭ	Bhikkhuni
Bĭng-dê̤ṳ	Waterijs
Wikipedia:Sū-iū ngṳ̄-ngiòng bēng-buōng gì Wikipedia	Lijst van Wikipedia's
Ngṳ̆k-huòng-dâi-dá̤	Jadekeizer
Ngù-sāi-gŭi	Mestkevers
Chiók	Drinken
À̤-liák	Pantoffel
Lī-dièu	Lý-dynastie
Cé̤ṳk	Rijstepap
Dĕ̤ng-cáik	Winterfeest
Ì-cô̤-hūng	Wasmiddel
Pàng-hù Gùng-dō̤	Pescadores
Muōi-sì	Chinese waterkastanje
Hāi-nàng-ngṳ̄	Hainanhua
Mìng-gĕ̤ng	Min Jiang (Fujian)
Dùng-ăng	Tong'an (Fujian)
Lṳ̀ng-hāi	Longhai
Siŏh-săi	Shishi
Mìng-âu	Minhou
Siêu-ū	Shaowu
Ôi	Maag
Hāi-gēu	Zeeberen
Sibu	Sibu (stad)
Lū-bék	Chinese buulbuul
Ciŭ Ū-uòng	Zhou Wuwang
Cṳ̆-dó̤h	Bureau (meubilair)
Chèng-lòi	Viviparidae
Chiă-ngò̤	Meretrix lusoria
Sô̤i	Zitten
Mā-lái-iè	Bananenspin
Â-muòng Dâi-hŏk	Universiteit Xiamen
Dô̤-sê̤ṳ	Daoshi
Mìng-dáng	Morgen (de volgende dag)
Dṳ̀-huák	Delen
Hù-lù	Fleskalebas
Lè̤ng-ê̤ṳ Tái-hâiu	Longyu
Gióng-ĕu	Jian'ou
分類:Dáik-guók	Categorie:Duitsland
分類:É-dâi-lé	Categorie:Italië
分類:Mī-guók	Categorie:Verenigde Staten
分類:Ngò̤-lò̤-sṳ̆	Categorie:Rusland
分類:Dṳ̆ng-guók	Categorie:China
分類:Nĭk-buōng	Categorie:Japan
分類:Ó̤-ciŭ	Categorie:Australië
Iĕk-cūi-ké	Geiser (apparaat)
分類:Éng-nà̤	Categorie:Indonesië
分類:Hàng-guók	Categorie:Zuid-Korea
分類:Tái-guók	Categorie:Thailand
分類:Uŏk-nàng	Categorie:Vietnam
分類:Buô-ṳ̄ dông-ŭk	Categorie:Zoogdier
分類:Bà-hèng dông-ŭk	Categorie:Reptiel
分類:Cēu	Categorie:Vogel
分類:Cĭng-kṳ̄ng	Categorie:Schimmel
分類:Sĭk-ŭk	Categorie:Plant
分類:Ŭk-lī	Categorie:Natuurkunde
分類:Huá-hŏk	Categorie:Scheikunde
分類:Lĭk-sṳ̄	Categorie:Geschiedenis
分類:Dê-lī	Categorie:Geografie
分類:Siâ-huôi	Categorie:Mens en maatschappij
分類:Mī-sŭk	Categorie:Beeldende kunst
分類:Cŭng-gáu	Categorie:Religie
分類:Tā̤-ṳ̆k	Categorie:Sport
分類:Kuŏ-hŏk	Categorie:Wetenschap
分類:Gióng-dé̤ṳk-ŭk	Categorie:Bouwwerk
Gū Lò̤-mā	Oude Rome
Chŭng-lièng	Chuntie
Cūi-kì	Naaktslakken
分類:Sĕng-tái	Categorie:Ecologie
分類:Disambig	Categorie:Wikipedia:Doorverwijspagina
分類:Diék-hŏk	Categorie:Filosofie
分類:Sĭng-lī	Categorie:Psychologie
分類:Hŭk-gáu	Categorie:Boeddhisme
分類:Gĭ-dók-gáu	Categorie:Christendom
分類:Ĭ-sṳ̆-làng-gáu	Categorie:Islam
分類:Iù-tái-gáu	Categorie:Jodendom
Mā-cū	Matsu
Gùng	Rok (kleding)
Báik Sáng Ĭk Mìng	De acht families komen Min binnen
Uòng Nāi-siòng	Wong Nai Siong
Ciòng-ciŭ-uâ	Quanzhouhua
Cháe̤	Sponskomkommer
Tuyên Quang	Tuyên Quang (provincie)
Iraq gâe̤ng Levant Ĭ-sṳ̆-làng-guók	Islamitische Staat (in Irak en de Levant)
Pàng-kì	Sesarmidae
Dâu-mò̤-chái	Taugé
Chiòng (dông-cáuk)	Hurken
Ì-ngṳ̄	Yi (taal)
Cièng-cāi	Dodengeld
Lìng Gáuk-mìng	Lin Juemin
Â-muòng-uâ	Xiamenhua
Tău-dò̤-nó̤h	Diefstal
Ciĕ-muài	Sesam
Abu Bakr al-Baghdadi	Abu Bakr al-Baghdadi
Kăi-nguòng-sê	Kaiyuantempel van Fuzhou
分類:Ùng-huá	Categorie:Cultuur
分類:Dê-cék	Categorie:Geologie
Dìng-dièu	Tran-dynastie
Wikipedia:Dŏng-nièng gĭng-dáng	Wikipedia:Dag uit de geschiedenis
模板:Tái-iòng-hiê	Sjabloon:Navigatie zonnestelsel
Ciē-sáik	Paars
Gâng	Zweten
Sìng (bòng-hâ̤)	Scylla serrata
Ák	Eenden
Duâi-tàu-chái	Knolraap
Huăng-siông	Mango (soort)
分類:Dáik-guók ìng-ŭk	Categorie:Duits persoon
分類:Mī-guók ìng-ŭk	Categorie:Amerikaans persoon
分類:Iēng-uòng	Categorie:Acteur
分類:Ĭng-guók ìng-ŭk	Categorie:Brits persoon
分類:Huák-guók ìng-ŭk	Categorie:Frans persoon
模板:Chess diagram	Sjabloon:Diagram schaken
模板:Tl	Sjabloon:Tl
分類:Guók-gă	Categorie:Land
Wikipedia:Hèng-céng Ìng-uòng	Wikipedia:Moderator
分類:Dṳ̆ng-guók mìng-cŭk	Categorie:Volk in China
分類:Ìng-ŭk	Categorie:Persoon
分類:Cék-ngiĕk	Categorie:Beroep
Wikipedia:Gĭ-ké-nè̤ng	Wikipedia:Bots
分類:Sì-găng	Categorie:Tijd
分類:Gĕ̤ng-tiàng	Categorie:Engineering
分類:Cài-lâiu	Categorie:Materiaal
分類:Ĭ-hŏk	Categorie:Geneeskunde
分類:Céng-dê	Categorie:Politiek
分類:Gáu-ṳ̆k	Categorie:Onderwijs
Ăi-gĭk	Egypte (land)
模板:Bot	Sjabloon:Bot
Gă-nā-dâi	Canada
分類:Iù-hié	Categorie:Spel
分類:Ĕu-ciŭ guók-gă	Categorie:Land in Europa
分類:Ĕu-ciŭ	Categorie:Europa
模板:Documentation	Sjabloon:Sjabdoc
Huà-lìng-sê	Hualintempel van Fuzhou
分類:Ê̤ṳng-hô	Categorie:Wikipedia:Babel
模板:Softredirect	Sjabloon:Softredirect
Wikipedia:維基數據	Wikipedia:Wikidata
模板:Chēng	Sjabloon:Nuweg
分類:Ngṳ̄-ngiòng	Categorie:Taal
分類:Lĭk-huák	Categorie:Kalender
分類:Wikipedia	Categorie:Encyclopedie Wikipedia
Wikipedia:Mò̤ hô-cáik sĭng-mìng	Wikipedia:Vrijwaringsclausule
分類:未索引其頁面	Categorie:Wikipedia:Niet te indexeren pagina's
模板:!-	Sjabloon:!-
模板:Smallcaps	Sjabloon:Sc
模板:Nowrap	Sjabloon:Nowrap
Wikipedia:Ék-chiék Wikipedia dŭ găi-dŏng ô gì ùng	Wikipedia:Archief/Wikipedia:Artikelen die elke Wikipedia zou moeten hebben
分類:Hĭ-ciŭ	Categorie:Afrika
模板:Wikisource	Sjabloon:Wikisource
模板:Babel	Sjabloon:Babel
模板:Commons	Sjabloon:Commons
模板:Reflist	Sjabloon:References
Wikipedia:列明來源	Wikipedia:Bronvermelding
模板:Stub	Sjabloon:Beginnetje
模板:User eo-1	Sjabloon:Gebruiker eo-1
模板:User eo-3	Sjabloon:Gebruiker eo-3
模板:User de	Sjabloon:Gebruiker de
模板:User de-1	Sjabloon:Gebruiker de-1
模板:User es	Sjabloon:Gebruiker es
模板:User de-3	Sjabloon:Gebruiker de-3
模板:User en-3	Sjabloon:Gebruiker en-3
模板:User en-1	Sjabloon:Gebruiker en-1
模板:User en-2	Sjabloon:Gebruiker en-2
模板:User eo-2	Sjabloon:Gebruiker eo-2
模板:User en-4	Sjabloon:Gebruiker en-4
模板:User en	Sjabloon:Gebruiker en
模板:User de-2	Sjabloon:Gebruiker de-2
模板:User es-1	Sjabloon:Gebruiker es-1
模板:User fr-1	Sjabloon:Gebruiker fr-1
模板:User it-3	Sjabloon:Gebruiker it-3
模板:User fr-2	Sjabloon:Gebruiker fr-2
模板:User ja	Sjabloon:Gebruiker ja
模板:User ja-1	Sjabloon:Gebruiker ja-1
模板:User it-1	Sjabloon:Gebruiker it-1
模板:User fr	Sjabloon:Gebruiker fr
分類:Ā-ciŭ	Categorie:Azië
分類:Nàng Mī-ciŭ	Categorie:Zuid-Amerika
分類:Mā-lài-să̤-ā	Categorie:Maleisië
模板:Mod	Sjabloon:Modulo
模板:User it	Sjabloon:Gebruiker it
模板:User es-2	Sjabloon:Gebruiker es-2
模板:Huăng-ngìng	Sjabloon:Hola
分類:Dièu-lâiu	Categorie:Condiment
分類:User fr-1	Categorie:Wikipedia:Gebruiker fr-1
模板:Image label	Sjabloon:Afbeelding label
模板:Steady	Sjabloon:Stabiel
模板:Guók-gă	Sjabloon:Infobox land
模板:Cite journal	Sjabloon:Citeer journal
模板:Infobox 公司	Sjabloon:Infobox bedrijf
模板:Wikibooks	Sjabloon:Wikibooks
模板:Hō̤ gì ùng-ciŏng	Sjabloon:Etalage
分類:User en-4	Categorie:Wikipedia:Gebruiker en-4
分類:User en	Categorie:Wikipedia:Gebruiker en
分類:User zh	Categorie:Wikipedia:Gebruiker zh
分類:User zh-M	Categorie:Wikipedia:Gebruiker zh-M
分類:User en-2	Categorie:Wikipedia:Gebruiker en-2
模板:Infobox	Sjabloon:Infobox generiek
模板:User eo	Sjabloon:Gebruiker eo
模板:User zh	Sjabloon:Gebruiker zh
分類:Gáuk-guók gì lĭk-sṳ̄	Categorie:Geschiedenis naar land
Wikipedia:Dŏng-nièng gĭng-dáng/09 nguŏk 23 hô̤	Sjabloon:Geschiedenis 23 september
Wikipedia:Dŏng-nièng gĭng-dáng/09 nguŏk 22 hô̤	Sjabloon:Geschiedenis 22 september
模板:Legend	Sjabloon:Legenda
Wikipedia:Dŏng-nièng gĭng-dáng/09 nguŏk 17 hô̤	Sjabloon:Geschiedenis 17 september
Wikipedia:Dŏng-nièng gĭng-dáng/10 nguŏk 15 hô̤	Sjabloon:Geschiedenis 15 oktober
模板:Cite web	Sjabloon:Citeer web
Wikipedia:Dŏng-nièng gĭng-dáng/09 nguŏk 28 hô̤	Sjabloon:Geschiedenis 28 september
Wikipedia:Dŏng-nièng gĭng-dáng/10 nguŏk 22 hô̤	Sjabloon:Geschiedenis 22 oktober
Wikipedia:Dŏng-nièng gĭng-dáng/11 nguŏk 2 hô̤	Sjabloon:Geschiedenis 2 november
Wikipedia:Dŏng-nièng gĭng-dáng/11 nguŏk 9 hô̤	Sjabloon:Geschiedenis 9 november
Wikipedia:Dŏng-nièng gĭng-dáng/10 nguŏk 1 hô̤	Sjabloon:Geschiedenis 1 oktober
Wikipedia:Dŏng-nièng gĭng-dáng/10 nguŏk 5 hô̤	Sjabloon:Geschiedenis 5 oktober
Wikipedia:Dŏng-nièng gĭng-dáng/10 nguŏk 8 hô̤	Sjabloon:Geschiedenis 8 oktober
分類:Īng-sĭk	Categorie:Voeding
模板:MongolUnicode	Sjabloon:MongolUnicode
Wikipedia:Dŏng-nièng gĭng-dáng/10 nguŏk 6 hô̤	Sjabloon:Geschiedenis 6 oktober
Wikipedia:Dŏng-nièng gĭng-dáng/10 nguŏk 17 hô̤	Sjabloon:Geschiedenis 17 oktober
Wikipedia:Dŏng-nièng gĭng-dáng/10 nguŏk 2 hô̤	Sjabloon:Geschiedenis 2 oktober
Wikipedia:Dŏng-nièng gĭng-dáng/09 nguŏk 16 hô̤	Sjabloon:Geschiedenis 16 september
Wikipedia:Dŏng-nièng gĭng-dáng/09 nguŏk 19 hô̤	Sjabloon:Geschiedenis 19 september
Wikipedia:Dŏng-nièng gĭng-dáng/10 nguŏk 25 hô̤	Sjabloon:Geschiedenis 25 oktober
Wikipedia:Dŏng-nièng gĭng-dáng/11 nguŏk 10 hô̤	Sjabloon:Geschiedenis 10 november
Wikipedia:Dŏng-nièng gĭng-dáng/10 nguŏk 21 hô̤	Sjabloon:Geschiedenis 21 oktober
Wikipedia:Dŏng-nièng gĭng-dáng/09 nguŏk 15 hô̤	Sjabloon:Geschiedenis 15 september
Wikipedia:Dŏng-nièng gĭng-dáng/09 nguŏk 4 hô̤	Sjabloon:Geschiedenis 4 september
Wikipedia:Dŏng-nièng gĭng-dáng/09 nguŏk 8 hô̤	Sjabloon:Geschiedenis 8 september
Wikipedia:Dŏng-nièng gĭng-dáng/10 nguŏk 4 hô̤	Sjabloon:Geschiedenis 4 oktober
Wikipedia:Dŏng-nièng gĭng-dáng/09 nguŏk 1 hô̤	Sjabloon:Geschiedenis 1 september
Wikipedia:Dŏng-nièng gĭng-dáng/09 nguŏk 6 hô̤	Sjabloon:Geschiedenis 6 september
Wikipedia:Dŏng-nièng gĭng-dáng/09 nguŏk 25 hô̤	Sjabloon:Geschiedenis 25 september
Wikipedia:Dŏng-nièng gĭng-dáng/09 nguŏk 10 hô̤	Sjabloon:Geschiedenis 10 september
Wikipedia:Dŏng-nièng gĭng-dáng/09 nguŏk 26 hô̤	Sjabloon:Geschiedenis 26 september
Wikipedia:Dŏng-nièng gĭng-dáng/09 nguŏk 20 hô̤	Sjabloon:Geschiedenis 20 september
Wikipedia:Dŏng-nièng gĭng-dáng/11 nguŏk 4 hô̤	Sjabloon:Geschiedenis 4 november
Wikipedia:Dŏng-nièng gĭng-dáng/09 nguŏk 30 hô̤	Sjabloon:Geschiedenis 30 september
Wikipedia:Dŏng-nièng gĭng-dáng/10 nguŏk 7 hô̤	Sjabloon:Geschiedenis 7 oktober
Wikipedia:Dŏng-nièng gĭng-dáng/10 nguŏk 19 hô̤	Sjabloon:Geschiedenis 19 oktober
Wikipedia:Dŏng-nièng gĭng-dáng/09 nguŏk 27 hô̤	Sjabloon:Geschiedenis 27 september
Wikipedia:Dŏng-nièng gĭng-dáng/09 nguŏk 11 hô̤	Sjabloon:Geschiedenis 11 september
Wikipedia:Dŏng-nièng gĭng-dáng/11 nguŏk 8 hô̤	Sjabloon:Geschiedenis 8 november
Wikipedia:Dŏng-nièng gĭng-dáng/11 nguŏk 1 hô̤	Sjabloon:Geschiedenis 1 november
Wikipedia:Dŏng-nièng gĭng-dáng/11 nguŏk 7 hô̤	Sjabloon:Geschiedenis 7 november
Wikipedia:Dŏng-nièng gĭng-dáng/10 nguŏk 11 hô̤	Sjabloon:Geschiedenis 11 oktober
Wikipedia:Dŏng-nièng gĭng-dáng/11 nguŏk 3 hô̤	Sjabloon:Geschiedenis 3 november
Wikipedia:Dŏng-nièng gĭng-dáng/10 nguŏk 20 hô̤	Sjabloon:Geschiedenis 20 oktober
Wikipedia:Dŏng-nièng gĭng-dáng/10 nguŏk 16 hô̤	Sjabloon:Geschiedenis 16 oktober
Wikipedia:Dŏng-nièng gĭng-dáng/10 nguŏk 14 hô̤	Sjabloon:Geschiedenis 14 oktober
Wikipedia:Dŏng-nièng gĭng-dáng/10 nguŏk 18 hô̤	Sjabloon:Geschiedenis 18 oktober
Wikipedia:Dŏng-nièng gĭng-dáng/10 nguŏk 24 hô̤	Sjabloon:Geschiedenis 24 oktober
Wikipedia:Dŏng-nièng gĭng-dáng/10 nguŏk 3 hô̤	Sjabloon:Geschiedenis 3 oktober
Wikipedia:Dŏng-nièng gĭng-dáng/09 nguŏk 7 hô̤	Sjabloon:Geschiedenis 7 september
分類:Săng	Categorie:Berg
模板:IPA	Sjabloon:IPA
分類:Céng-dê-gă	Categorie:Politicus
分類:Mī-ciŭ	Categorie:Amerika
分類:Gáuk-guók gì ìng-ŭk	Categorie:Persoon naar nationaliteit
模板:Wiki-huá	Sjabloon:Wikify
分類:Gŭng-sê̤ṳ	Categorie:Krijgswezen
模板:Increase	Sjabloon:Winst
模板:User nl	Sjabloon:Gebruiker nl
模板:Infobox 網站	Sjabloon:Infobox website
Wikipedia:Dŏng-nièng gĭng-dáng/10 nguŏk 12 hô̤	Sjabloon:Geschiedenis 12 oktober
模板:User no-2	Sjabloon:Gebruiker no-2
模板:Image label end	Sjabloon:Afbeelding label eind
模板:Documentation subpage	Sjabloon:Sjabdoc direct
Wikipedia:Dŏng-nièng gĭng-dáng/11 nguŏk 5 hô̤	Sjabloon:Geschiedenis 5 november
Wikipedia:Dŏng-nièng gĭng-dáng/10 nguŏk 13 hô̤	Sjabloon:Geschiedenis 13 oktober
Wikipedia:Dŏng-nièng gĭng-dáng/09 nguŏk 3 hô̤	Sjabloon:Geschiedenis 3 september
Wikipedia:Dŏng-nièng gĭng-dáng/09 nguŏk 24 hô̤	Sjabloon:Geschiedenis 24 september
模板:Purge	Sjabloon:Purge
分類:Cìng-gāng	Categorie:Gemoedstoestand
模板:Dṳ̆ng-huà Ìng-mìng Gê̤ṳng-huò-guók Hèng-céng-kṳ̆	Sjabloon:Navigatie bestuurlijke indeling China
模板:Userpage	Sjabloon:Gebruikerspagina
模板:User	Sjabloon:Gebruikerlinks
Wikipedia:Dŏng-nièng gĭng-dáng/09 nguŏk 12 hô̤	Sjabloon:Geschiedenis 12 september
Wikipedia:Dŏng-nièng gĭng-dáng/09 nguŏk 2 hô̤	Sjabloon:Geschiedenis 2 september
Wikipedia:Dŏng-nièng gĭng-dáng/11 nguŏk 6 hô̤	Sjabloon:Geschiedenis 6 november
Wikipedia:Dŏng-nièng gĭng-dáng/09 nguŏk 18 hô̤	Sjabloon:Geschiedenis 18 september
Wikipedia:Dŏng-nièng gĭng-dáng/10 nguŏk 10 hô̤	Sjabloon:Geschiedenis 10 oktober
Wikipedia:Dŏng-nièng gĭng-dáng/10 nguŏk 9 hô̤	Sjabloon:Geschiedenis 9 oktober
Wikipedia:Dŏng-nièng gĭng-dáng/10 nguŏk 23 hô̤	Sjabloon:Geschiedenis 23 oktober
模板:Image label small	Sjabloon:Afbeelding label klein
模板:User fr-3	Sjabloon:Gebruiker fr-3
模板:Gô-dā̤ gì guók-gă	Sjabloon:Infobox historisch land
分類:User ja-M	Categorie:Wikipedia:Gebruiker ja-M
模板:Gì-ngiê	Sjabloon:Dp
分類:Dièu-siēng lĭk-sṳ̄	Categorie:Geschiedenis van Korea
模板:User no-3	Sjabloon:Gebruiker no-3
模板:User ksh	Sjabloon:Gebruiker ksh
模板:AUS	Sjabloon:AU
模板:User yue-1	Sjabloon:Gebruiker yue-1
分類:Sĕng-ŭk	Categorie:Organisme
Wikipedia:Dŏng-nièng gĭng-dáng/9 nguŏk	Wikipedia:Dag uit de geschiedenis/september
Wikipedia:Dŏng-nièng gĭng-dáng/09 nguŏk 14 hô̤	Sjabloon:Geschiedenis 14 september
Wikipedia:Dŏng-nièng gĭng-dáng/09 nguŏk 9 hô̤	Sjabloon:Geschiedenis 9 september
Wikipedia:Dŏng-nièng gĭng-dáng/09 nguŏk 13 hô̤	Sjabloon:Geschiedenis 13 september
Wikipedia:Dŏng-nièng gĭng-dáng/10 nguŏk	Wikipedia:Dag uit de geschiedenis/oktober
分類:User vi-3	Categorie:Wikipedia:Gebruiker vi-3
模板:User la-1	Sjabloon:Gebruiker la-1
分類:User fr	Categorie:Wikipedia:Gebruiker fr
分類:User ja	Categorie:Wikipedia:Gebruiker ja
分類:User la	Categorie:Wikipedia:Gebruiker la
分類:User fr-3	Categorie:Wikipedia:Gebruiker fr-3
分類:User it-3	Categorie:Wikipedia:Gebruiker it-3
分類:User ja-3	Categorie:Wikipedia:Gebruiker ja-3
分類:User fr-2	Categorie:Wikipedia:Gebruiker fr-2
分類:User it-2	Categorie:Wikipedia:Gebruiker it-2
分類:User ja-2	Categorie:Wikipedia:Gebruiker ja-2
分類:User la-2	Categorie:Wikipedia:Gebruiker la-2
分類:User ko-M	Categorie:Wikipedia:Gebruiker ko-M
分類:User fr-M	Categorie:Wikipedia:Gebruiker fr-M
分類:User it-M	Categorie:Wikipedia:Gebruiker it-M
分類:User nl-M	Categorie:Wikipedia:Gebruiker nl-M
模板:User yue	Sjabloon:Gebruiker yue
分類:Ùng-cê	Categorie:Schriftsysteem
分類:Dô̤-gáu	Categorie:Taoïsme
分類:Dō̤	Categorie:Eiland
分類:User de	Categorie:Wikipedia:Gebruiker de
分類:User de-2	Categorie:Wikipedia:Gebruiker de-2
分類:User de-3	Categorie:Wikipedia:Gebruiker de-3
分類:User de-M	Categorie:Wikipedia:Gebruiker de-M
分類:User en-3	Categorie:Wikipedia:Gebruiker en-3
分類:User en-M	Categorie:Wikipedia:Gebruiker en-M
分類:User es	Categorie:Wikipedia:Gebruiker es
分類:User es-1	Categorie:Wikipedia:Gebruiker es-1
分類:User es-2	Categorie:Wikipedia:Gebruiker es-2
分類:User es-3	Categorie:Wikipedia:Gebruiker es-3
分類:User es-M	Categorie:Wikipedia:Gebruiker es-M
分類:Chió	Categorie:Huisvesting
分類:User it	Categorie:Wikipedia:Gebruiker it
分類:User it-1	Categorie:Wikipedia:Gebruiker it-1
分類:User ja-1	Categorie:Wikipedia:Gebruiker ja-1
分類:User ko	Categorie:Wikipedia:Gebruiker ko
分類:Mī-guók gì ciŭ	Categorie:Staat van de Verenigde Staten
分類:User ko-1	Categorie:Wikipedia:Gebruiker ko-1
分類:User ko-2	Categorie:Wikipedia:Gebruiker ko-2
分類:User ko-3	Categorie:Wikipedia:Gebruiker ko-3
分類:User ksh	Categorie:Wikipedia:Gebruiker ksh
分類:User ksh-M	Categorie:Wikipedia:Gebruiker ksh-M
分類:User la-1	Categorie:Wikipedia:Gebruiker la-1
Wikipedia:Dŏng-nièng gĭng-dáng/09 nguŏk 29 hô̤	Sjabloon:Geschiedenis 29 september
分類:User la-3	Categorie:Wikipedia:Gebruiker la-3
Wikipedia:Dŏng-nièng gĭng-dáng/09 nguŏk 5 hô̤	Sjabloon:Geschiedenis 5 september
模板:Information	Sjabloon:Information
分類:Huâng-cô̤i	Categorie:Criminaliteit
Sáik-mō̤	Dierluizen
分類:Séng-sék	Categorie:Informatiewetenschap
分類:Hāi	Categorie:Zee
Hŭng-siéng	Ventilator
分類:Guōng-dĕ̤ng	Categorie:Guangdong
分類:Hók-gióng	Categorie:Fujian
分類:Ciék-ciĕ dông-ŭk	Categorie:Geleedpotige
分類:Hĭ-ciŭ guók-gă	Categorie:Land in Afrika
分類:Gáuk-guók gì gáu-ṳ̆k	Categorie:Onderwijs naar land
Wikipedia:Dŏng-nièng gĭng-dáng/11 nguŏk	Wikipedia:Dag uit de geschiedenis/november
模板:User ja-2	Sjabloon:Gebruiker ja-2
模板:User ja-3	Sjabloon:Gebruiker ja-3
分類:User vi	Categorie:Wikipedia:Gebruiker vi
分類:User vi-1	Categorie:Wikipedia:Gebruiker vi-1
分類:User vi-2	Categorie:Wikipedia:Gebruiker vi-2
分類:User vi-M	Categorie:Wikipedia:Gebruiker vi-M
分類:Ciék-gŏng	Categorie:Zhejiang
分類:Ĭng-ngŏk-gă	Categorie:Musicus
模板:Lang	Sjabloon:Lang
Wikipedia:Dŏng-nièng gĭng-dáng/09 nguŏk 21 hô̤	Sjabloon:Geschiedenis 21 september
Bì-bà (ngŏk-ké)	Pipa (muziekinstrument)
分類:Ò̤	Categorie:Rivier
模板:User la-2	Sjabloon:Gebruiker la-2
模板:User no-1	Sjabloon:Gebruiker no-1
模板:User zh-1	Sjabloon:Gebruiker zh-1
模板:User zh-2	Sjabloon:Gebruiker zh-2
模板:User zh-3	Sjabloon:Gebruiker zh-3
分類:Dâi-hàng Mìng-guók ìng-ŭk	Categorie:Zuid-Koreaans persoon
分類:Sôi-diēng ìng-ŭk	Categorie:Zweeds persoon
分類:Nĭk-buōng ìng-ŭk	Categorie:Japans persoon
分類:Dài-uăng ìng-ŭk	Categorie:Taiwanees persoon
分類:User nl	Categorie:Wikipedia:Gebruiker nl
分類:User zh-1	Categorie:Wikipedia:Gebruiker zh-1
分類:User zh-3	Categorie:Wikipedia:Gebruiker zh-3
分類:User zh-2	Categorie:Wikipedia:Gebruiker zh-2
分類:Cāi	Categorie:Papier
分類:Ông-ò̤	Categorie:Kanaal
分類:Uŏk-nàng ìng-ŭk	Categorie:Vietnamees persoon
分類:Ngò̤-lò̤-sṳ̆ ìng-ŭk	Categorie:Russisch persoon
分類:Hiŏng-gē̤ng ìng-ŭk	Categorie:Hongkongs persoon
分類:Ciĕk-káik ìng-ŭk	Categorie:Tsjechisch persoon
分類:Tái-guók ìng-ŭk	Categorie:Thais persoon
Uŏk-ngṳ̄	Kantonees
分類:Sáng	Categorie:Achternaam
分類:Dièu-siēng Mìng-ciō-ciō-ngiê Ìng-mìng Gê̤ṳng-huò-guók	Categorie:Noord-Korea
分類:Dṳ̆ng-guók ìng-ŭk	Categorie:Chinees persoon
分類:Dièu-siēng	Categorie:Korea
分類:Dài-uăng	Categorie:Taiwan
分類:Dièu-siēng Mìng-ciō-ciō-ngiê Ìng-mìng Gê̤ṳng-huò-guók ìng-ŭk	Categorie:Noord-Koreaans persoon
分類:Dâi-iòng-ciŭ guók-gă	Categorie:Land in Oceanië
分類:Báe̤k Mī-ciŭ guók-gă	Categorie:Land in Noord-Amerika
分類:Ngṳ̀	Categorie:Vis
分類:Cūi-guō	Categorie:Fruit
分類:Niōng-tā̤ dông-ŭk	Categorie:Weekdier
分類:Só-cê	Categorie:Getalsysteem
分類:Gióng-dé̤ṳk cài-lâiu	Categorie:Bouwmateriaal
分類:Dông-ŭk	Categorie:Dierenrijk
分類:Ìng-guòng	Categorie:Mensenrechten
分類:Ū-ké	Categorie:Wapen
分類:Nàng Mī-ciŭ guók-gă	Categorie:Land in Zuid-Amerika
分類:Gă-sĭ	Categorie:Meubilair
分類:Ké-chiông	Categorie:Meteorologie
分類:Dṳ̆ng Mī-ciŭ	Categorie:Midden-Amerika
分類:Hiŏng-gē̤ng	Categorie:Hongkong
分類:Ĭ-siòng	Categorie:Kleding
分類:Cáik-nĭk	Categorie:Festival
分類:Kuàng-ciék dông-ŭk	Categorie:Ringworm
分類:Bâng	Categorie:Ziekte
分類:Kiŏng-diòng dông-ŭk	Categorie:Neteldier
分類:Gùng-dō̤	Categorie:Eilandengroep
分類:Káh-dièu-nó̤h	Categorie:Speelgoed
分類:Dṳ̆ng-guók huòng-dá̤	Categorie:Keizer van China
分類:Huòng-dá̤	Categorie:Keizer
分類:Báe̤k Mī-ciŭ	Categorie:Noord-Amerika
分類:Gŏ̤-chiū	Categorie:Zanger
分類:Hù	Categorie:Meer
分類:Só-hŏk-gă	Categorie:Wiskundige
模板:Infobox ngṳ̄-ngiòng	Sjabloon:Infobox taal
分類:Dâi-iòng-ciŭ	Categorie:Oceanië
分類:Tiĕng-căi	Categorie:Natuurramp
分類:Gô-dā̤ gì guók-gă	Categorie:Historisch land
Vĩnh Long	Vĩnh Long (provincie)
分類:Sié-gái	Categorie:Wereld
分類:Dṳ̆ng-huà Ìng-mìng Gê̤ṳng-huò-guók	Categorie:Volksrepubliek China
Cāi-puŏi	Golfkarton
分類:Giông-kŏng	Categorie:Gezondheid
Hâ-cé	Langste dag
分類:Sĕng-lī	Categorie:Fysiologie
Trojany	Trojany (Mazovië)
模板:Infobox color	Sjabloon:Infobox kleur
分類:Ā-ciŭ guók-gă	Categorie:Land in Azië
模板:User la	Sjabloon:Gebruiker la
分類:Huák-lŭk	Categorie:Wet
分類:Káh-gă	Categorie:Hakka
分類:Dṳ̆ng Mī-ciŭ guók-gă	Categorie:Land in Centraal-Amerika
分類:Bēng-guòng	Categorie:Auteursrecht
分類:Hók-ciŭ	Categorie:Fuzhou
分類:Ôi-sĕng	Categorie:Hygiëne
分類:Dṳ̆ng-huà Mìng-guók	Categorie:Republiek China
分類:User cdo	Categorie:Wikipedia:Gebruiker cdo
分類:User cdo-M	Categorie:Wikipedia:Gebruiker cdo-M
模板:Image label begin	Sjabloon:Afbeelding label begin
模板:Dṳ̆ng-huà Mìng-guók Hèng-céng-kṳ̆	Sjabloon:Navigatie deelgebieden Taiwan
Ĭ-mā	Grootmoeder
分類:Sĕng-uăk	Categorie:Dagelijks leven
模板:User vi	Sjabloon:Gebruiker vi
分類:User en-1	Categorie:Wikipedia:Gebruiker en-1
分類:User de-1	Categorie:Wikipedia:Gebruiker de-1
分類:Gă-sĭ-huă	Categorie:Gereedschap
分類:Mìng-cŭk	Categorie:Etniciteit
Lìng-cūi-nā̤	Linshui Furen
Wikipedia:失效鏈接	Wikipedia:Onbereikbare externe links
Liù-giù	Riukiu-eilanden
Ngù-nèng	Koemelk
模板:Hók-gióng	Sjabloon:Navigatie provincie Fujian
Chái-tàu	Tuinradijs
Sì	Ci
特殊:最近其改變	Speciaal:RecenteWijzigingen
Ciá	Saccharum
Cáu-gŭng	Keukengod
