非洲	Afrika
日本	Japan
南美洲	Zuid-Amerika
Nò-vî	Noorwegen
Sû-kak-làn	Schotland
Vî-ngì-sṳ̂	Wales
Pet Oi-ngì-làn	Noord-Ierland
Hiûng-ngà-li	Hongarije
Sî-pân-ngà	Spanje
Mî-koet	Verenigde Staten
Pí-li-sṳ̀	België
Lù-sêm-pó	Luxemburg (land)
Yî-chhiu	Heelal
Thi-khiù	Aarde (planeet)
Sâng-miang	Leven
Ngìn-lui	Mens
George Washington	George Washington
Fûn-làn	Finland
Shuì-tién	Zweden
Tan-ma̍k	Denemarken
Pô-làn	Polen
Li̍p-thâu-vón	Litouwen
Yi-thai-li	Italië
Shuì-sṳ	Zwitserland
O-thi-li	Oostenrijk
Hî-lia̍p	Griekenland
Thú-ngí-khì	Turkije
Phù-thò-ngà	Portugal
歐洲	Europa (werelddeel)
亞洲	Azië
北美洲	Noord-Amerika
南極洲	Antarctica
Vì-kî Pak-khô	Wikipedia
Hò-làn	Nederland
Néu-yok-sṳ	New York City
Fà-sṳ̀n-tun Kô-lùn-pí-â Thi̍t-khî	Washington D.C.
Khiu-kîm-sân	San Francisco
Pak-lìm	Berlijn
Lo̍k-chhám-kî	Los Angeles
Thien-nó	Computer
Mióng-chi-mióng-lu	Internet
Barack Obama	Barack Obama
Vû-lâ-kûi	Uruguay
Lùn-tûn	Londen
Phìn-kó	Appel (plant)
Pâ-lì-sṳ	Parijs
Â-pak-lâ-hón Lìm-khén	Abraham Lincoln
Google	Google Inc.
Me̍t-sî-kô	Mexico (land)
Thai-sî-yòng	Atlantische Oceaan
Thai-phìn-yòng	Grote Oceaan
Kâ-li-fuk-nì-â	Californië
Pô-sṳ-tun	Boston
Fó-sên	Mars (planeet)
Âi-set-ngò-pí-â	Ethiopië
Sṳ̂-é	Leeuw (dier)
Fap-koet	Frankrijk
Sṳ-kie-ngî	Esperanto
Kiéu-è	Hond
Yîn-koet	Verenigd Koninkrijk
Meu-é	Kat (dier)
中華人民共和國	Volksrepubliek China
Fap-ngî	Frans
Ǹg-è	Vissen (dieren)
Pâ-sî	Brazilië
François Hollande	François Hollande
Ngò-lò-sṳ̂	Rusland
Kîn-ǹg	Walvisachtigen
Chang-fông-hìn	Vierkant (meetkunde)
Tô-lùn-tô	Toronto
Â-lâ-pâ-mâ	Alabama
Québec-sén	Quebec (provincie)
Boeing 747	Boeing 747
Jimmy Wales	Jimmy Wales
Tet-koet	Duitsland
Pha̍k-ngò-lò-sṳ̂	Wit-Rusland
Tet-ngî	Duits
Pên-tó	IJsland
Song-ti	God (monotheïsme)
Oi-sâ-nì-â	Estland
David Cameron	David Cameron
Thú-sên	Saturnus (planeet)
Ku-thin-yi̍t Fî-kî	Vliegtuig
1	1 (getal)
2	2 (getal)
3	3 (getal)
4	4 (getal)
5	5 (getal)
George W. Bush	George W. Bush
Lâ-thot-vì-â	Letland
Vû-khiet-làn	Oekraïne
Tshia̍p-khiet	Tsjechië
Sṳ̂-lo̍k-vì-nì-â	Slovenië
Lò-mâ-nì-â	Roemenië
Pó-kâ-li-â	Bulgarije
Lò-mâ	Rome (stad)
Mâ-khì-tun	Macedonië (land)
Â-ngì-pâ-nì-â	Albanië
Khiet-lò-âi-sî-â	Kroatië
Pô-sṳ-nì-â lâu Het-set-kô-vì-ná	Bosnië en Herzegovina
Â-set-pai-kiông	Azerbeidzjan
Set-phû-lu-sṳ̂	Cyprus
Kak-lû-kit-â	Georgië
Hâ-sat-khiet-sṳ̂-thán	Kazachstan
Mí-li-thai	Malta (land)
Mô-na̍p-kô	Monaco
Mùng-thi̍t-nui-kô-lò	Montenegro
Sṳn Mâ-li-nok	San Marino
Kú-pâ	Cuba (land)
Eiffel Thiet-thap	Eiffeltoren
Yin-thu-nì-sî-â	Indonesië
Wolfgang Amadeus Mozart	Wolfgang Amadeus Mozart
Pi-tô-fûn	Ludwig van Beethoven
Thú-ngí-khì-ngî	Turks
Nàm-fî	Zuid-Afrika
Vû-tsṳ̂-phe̍t-khiet-sṳ̂-thán	Oezbekistan
Pô-tsṳ-nàm	Poznań (stad)
Fà-sâ	Warschau
Súi	Water
Thien-sṳ	Televisie
Chṳ-li	Chili
Yâ-sû	Jezus (traditioneel-christelijk)
Súi-sên	Mercurius (planeet)
Li̍t-sṳ́	Geschiedenis
Phìn-kó Kûng-sṳ̂	Apple Inc.
Kîm-sên	Venus (planeet)
Ngî-ngièn	Taal
Muk-sên	Jupiter (planeet)
Thiên-vòng-sên	Uranus (planeet)
Pu-lie̍t-thap-nì	Bretagne (schiereiland)
Hói-vòng-sên	Neptunus (planeet)
Thiên-vùn-ho̍k	Astronomie
Sîn-kâ-po	Singapore
Khô-ho̍k	Wetenschap
Montréal	Montreal (Canada)
Lie̍t-kî-tûn-sṳ-tên	Liechtenstein
Kiam-khiâu	Cambridge (Verenigd Koninkrijk)
Thi-ngi-chhṳ Sṳ-kie Thai-chan	Tweede Wereldoorlog
Cologne	Keulen (stad)
Kak-tên-nì-â	Gdynia
Sṳ̍p-chhiet-chhiâng	Szczecin
Sṳ-ho̍k	Wiskunde
Lâ-tên-ngî	Latijn
Pâ-lìm	Bahrein
Â-mî-nì-â	Armenië
Set-ngì-vì-â	Servië
Ngie̍t-khiù	Maan
Àu-thai-li-â	Australië (land)
Vu̍t-lî-ho̍k	Natuurkunde
Â-kîn-thìn	Argentinië
Pi-lû	Peru
Sâng-vu̍t-ho̍k	Biologie
Tsêu-siên Mìn-tsú Tsú-ngi Ngìn-mìn Khiung-fò-koet	Noord-Korea
Kán-pu-chhài	Cambodja
Khiúng-liùng	Dinosauriërs
Yî-sṳ̂-làn-kau	Islam
Lech Wałęsa	Lech Wałęsa
Lin-é	Wiel (voortbeweging)
Lyon	Lyon
Êu-chû Lièn-mèn	Europese Unie
Rhône-Alpes	Rhône-Alpes
Chhiòn-khiù Chṳ̂-sín Mióng	Wereldwijd web
Ńg-ngìn	Vrouw
Khiûng-tsiâu	Banaan (vrucht)
Fâ	Bloem (plant)
Mâ-lî-â-na̍p-hói	Marianentrog
Chû-mu̍k-lòng-mâ-fûng	Mount Everest
Sàng-sṳ	Stad
Nâ-pho-lùn yit-sṳ	Napoleon Bonaparte
Ngit-tèu	Zon
Pâ-sṳ-tet	Louis Pasteur
大洋洲	Oceanië
Thai-yòng Hì	Zonnestelsel
Pô-lò-tit-hói	Oostzee
Ngâ-chhṳ	Tand
Khîn	Waterstof (element)
Hoi (氦)	Helium
Angela Merkel	Angela Merkel
Lî	Lithium (element)
Phì	Beryllium
Si	Boek (document)
Ngit	Dag
Ngièn	Jaar
Sṳ-ki	Eeuw
Lò-tsṳ (Pô-làn)	Łódź (stad)
Khà-thok-vì-chṳ	Katowice
Ngie̍t-sû-fû	Rzeszów
Phìn	Boor (element)
Thàn	Koolstof
Tham	Stikstof (element)
Yòng	Zuurstof (element)
Hàng-sên	Planeet
Yîm-ngo̍k	Muziek
Rennes	Rennes
Mo̍k-sṳ̂-khô	Moskou
Fuk	Fluor (element)
Yi-thai-li-ngî	Italiaans (taal)
Nái	Neon (element)
Sṳn Pí-tet-páu	Sint-Petersburg
Na̍p	Natrium
北	Noord (windstreek)
Mî	Magnesium
Lî (鋁)	Aluminium
Néu Sî-làn	Nieuw-Zeeland
南	Zuid
Yin-thu	India
Si̍t	Silicium
Fap	Francium
Lìn	Fosfor
Thiet	IJzer (element)
Tûng-kâ	Tonga (land)
西	West
Liù-vòng	Zwavel
東	Oost (windstreek)
Liu̍k	Chloor (element)
Pâ-pu-â Néu-kí-nui-â	Papoea-Nieuw-Guinea
Vî-lièn Sâ-sṳ-pí-â	William Shakespeare
Â (氬)	Argon
Kap	Kalium
Koi	Calcium
Yèn	Lood (element)
Mùng-kú-koet	Mongolië
Khong (鈧)	Scandium
Thai	Titanium
Genghis Khan	Dzjengis Khan
Fàm	Vanadium
Mien-yîn	Maine
Kok	Chroom (element)
Mâ	Paard (dier)
Thûng-vu̍t	Dierenrijk
Sû-li-nàm	Suriname
Màng	Mangaan
Pâ-lâ-kûi	Paraguay
Koi-â-nâ	Guyana
Ngi-su̍t	Kunst
Lòi	Renium
Kô-lùn-pí-â	Colombia
Kû	Kobalt
Vû	Wolfraam
Ngiap (鎳)	Nikkel
Fu̍t-kau	Boeddhisme
Pô-li-vì-â	Bolivia
Tshṳ̀-nì-tha̍t lâu Tô-pâ-kô	Trinidad en Tobago
Chhṳ̍t-vu̍t	Planten
Sîn	Zink (element)
Néu Hàn-pu-ha	New Hampshire
Pí-â-vùi-sṳ̂-thok-khiet	Białystok
Ngà-mâi-kâ	Jamaica
Mà-sat-chû-set	Massachusetts
Drenthe-sén	Drenthe
Overijssel-sén	Overijssel
Kûa-thi-mâ-là	Guatemala
Gelderland-sén	Gelderland
Pâ-hâ-mâ	Bahama's
Không-nái-tí-khiet-chû	Connecticut
Kiê-é	Kip (vogel)
Ha-vî-yî	Hawaï
Fùng-tû-lâ-sṳ̂	Honduras
Tô-mí-nì-kâ	Dominica
Tô-mí-nì-kâ Khiung-fò-koet	Dominicaanse Republiek
Kâ-chû (Thung-vu̍t)	Varken (tam)
Hói-thi	Haïti
Sat-ngì-ngá-tô	El Salvador
Yî-lóng	Iran
Yî-là-khiet	Irak
Â-lâ-sṳ̂-kâ	Alaska
Kô-sṳ̂-tha̍t Lì-kâ	Costa Rica
Yî-set-lie̍t	Israël
Pâ-nâ-mâ	Panama (land)
Ya̍p-mùn	Jemen
Phiang-thu̍k	Virus (biologie)
Pô-làn-ngî	Pools
Yok-tan	Jordanië
Nì-kâ-lâ-kûa	Nicaragua
Fu-lò-lî-tha̍t	Florida (staat)
Kit-ngí-kit-sṳ̂-thán	Kirgizië
Â-li-sông-ná	Arizona (staat)
Khô-vî-thi̍t	Koeweit
Liàu-koet	Laos
Lì-pâ-nun	Libanon
O-le̍t-kông	Oregon
Gi-tuk-gaau zung geh sin	God (christendom)
Mâ-ngì-thoi-fû	Maldiven
Yù-thâ	Utah
Mâ-lòi-sî-â	Maleisië
Mién-thien	Myanmar
Nì-pok	Nepal
Â-man	Oman
Pâ-kî-sṳ̂-thán	Pakistan
Khà-tha̍t	Qatar
Mióng-khiù	Tennis
Sâ-vû-thi Â-lâ-pak	Saoedi-Arabië
Sṳ̂-lî-làn-khà	Sri Lanka
Si-li-â	Syrië
Kâ	Gallium
Thap-kit-khiet-sṳ̂-thán	Tadzjikistan
中華民國	Taiwan
YouTube	YouTube
Châ	Germanium
Thai-koet	Thailand
Sṳ̂n	Arseen
Thú-khû-man-sṳ̂-thán	Turkmenistan
Abakan	Abakan (stad)
Sî	Seleen
Yî	Iridium (element)
Â-lâ-pak Lièn-ha̍p Thai-kûng-koet	Verenigde Arabische Emiraten
Tshiù (溴)	Broom (element)
Pha̍k (鉑)	Platina
Ye̍t-nàm	Vietnam
Thai-hòn Mìn-koet	Zuid-Korea
Khiet	Krypton (element)
Â-fu-hon	Afghanistan
J. R. R. Tolkien	J.R.R. Tolkien
Lù	Rubidium
Kîm	Goud
Men-kâ-lâ-koet	Bangladesh
Ufa	Oefa
Ôn-kô-lâ	Angola
Vùn-lòi	Brunei
Kúng	Kwik
Fî-li̍t-pîn	Filipijnen
Thò	Thallium
Ngie-sat-khiet Ngiù-tun	Isaac Newton
Albert Einstein	Albert Einstein
Sṳ̂	Strontium
Yet	Yttrium
Pit	Bismut
Vòng-set	Geel (kleur)
Tsan-pí-â	Zambia
Sîn-pâ-pu-vî	Zimbabwe
北京	Peking
Tuva Khiung-fò-koet	Toeva
Pok-tshṳ-ngá-na̍p	Botswana
Pho (釙)	Polonium
Bayern	Beieren
Baden-Württemberg	Baden-Württemberg
Ngo (砈)	Astaat
Lòi-sò-thok	Lesotho
Mâ-tha̍t-kâ-sṳ̂-kâ	Madagaskar
Mâ-là-vî	Malawi
Stuttgart	Stuttgart
Màu-li-thap-nì-â	Mauritanië
Pô-làn-ngìn	Polen (volk)
Mo̍k-sông-pí-khiet	Mozambique
Na̍p-mí-pí-â	Namibië
Nai-khi̍p-li-â	Nigeria
Ko	Zirkonium
Nì	Niobium
Yû-li-vû-sṳ̂ Khái-sat	Julius Caesar
Sṳ̂-vî-sṳ-làn	Swaziland
Muk	Molybdeen
Thap	Technetium
Hamburg	Hamburg
Thoi-chhia	Stofwisseling
Miên-yi̍t Hì-thúng	Immuunsysteem
Lièn-ha̍p-koet	Verenigde Naties
Sîm-chhong	Hart
Thèu-nó	Hersenen
Phì-fû	Huid
Ló	Rhodium
Làm-set	Blauw (kleur)
Pâ	Palladium (element)
Ngiùn	Zilver
Kak	Cadmium
Yîn	Indium
Siak	Tin (element)
Yu	Uranium
Thi (銻)	Antimoon
Ti	Telluur
Pu	Plutonium
Tièn	Jodium (element)
Nai	Neptunium
Set	Cesium
Phù	Protactinium
Pi	Barium
Thú	Thorium
Kap (鉿)	Hafnium
Than (鉭)	Tantaal
Luì	Radium
Tûng	Radon (element)
Alsace	Elzas
Auvergne	Auvergne
Ôn-tet-là-pâng	Andhra Pradesh
Me̍t-hiet-kîn	Michigan
Burgundy	Bourgondië (regio)
Aquitaine	Aquitanië
Schleswig-Holstein	Sleeswijk-Holstein
Hâ Saxony	Nedersaksen
Pet Rhine-Westphalia	Noordrijn-Westfalen
Saxony	Saksen (deelstaat)
Yî-li-nò	Illinois (staat)
Thuringia	Thüringen (deelstaat)
Saxony-Anhalt	Saksen-Anhalt
Pet Tha̍t-khô-thâ	North Dakota
Brandenburg	Brandenburg (deelstaat)
Bremen-chû	Vrije Hanzestad Bremen
Nàm Tha̍t-khô-thâ	South Dakota
Mùng-thai-nâ	Montana (staat)
Fài-ngò-mìn	Wyoming
Yâ-lu-sat-lâng	Jeruzalem
Oi-tha̍t-hòt	Idaho
Fà-sṳn-tun	Washington (staat)
Lù (鑪)	Rutherfordium
Nui-fà-tha̍t	Nevada (staat)
Hàn (𨧀)	Dubnium
Hí (𨭎)	Seaborgium
Yin-thu-yòng	Indische Oceaan
Khô-sò-vok	Kosovo
Kâ-le̍t-pí-hói	Caraïbische Zee
Pô (𨨏)	Bohrium
Het (𨭆)	Hassium
Phan Kî-vùn	Ban Ki-moon
Ma̍k (䥑)	Meitnerium
Khô-lò-là-tô	Colorado (staat)
Tha̍t	Darmstadtium
Siau-pâng	Frédéric Chopin
Lùn	Röntgenium
Kô (鎶)	Copernicium
分類:Chú-yeu fûn-lui	Categorie:Alles
Chi-kâ-kô	Chicago
Arnhem	Arnhem
Tûng-kui	Winter
Sî-pân-ngà-ngî	Spaans
Fî-là-thiet-fî	Philadelphia (Pennsylvania)
Tî-tû	Spinnen (dieren)
Kîm-tshièn	Geld
Vì-kit-nì-â	Virginia (staat)
Sî Vì-kit-nì-â	West Virginia
Tshiâng-tséu	Capsicum annuum
Néu-yok-chû	New York (staat)
Sṳ (鈰)	Cerium
Phú	Praseodymium
Lò-tet-tó	Rhode Island (staat)
Ńg	Neodymium
Khûn-chhùng	Insecten
Mâ-lî-làn	Maryland
Thi̍t-lâ-ngá	Delaware
Yû (銪)	Europium
Ngò-hài-ngò	Ohio (staat)
Vì-kit-ngì	Vergilius
Machiavelli	Niccolò Machiavelli
Pîn-sé-fap-nì-â	Pennsylvania
Uetersen	Uetersen
O-kú-sṳ̂-tû	Imperator Caesar Augustus
Néu Chhe̍t-sî-chû	New Jersey
Fûn-làn-ngî	Fins
Yin-thi-ôn-na̍p	Indiana
Vì-sṳ̂-pha-siên	Vespasianus
Thù-là-chṳ̂n	Trajanus
Hâ-tet-liòng	Hadrianus
Khièu-tshṳ-â	Georgia (staat)
Mâ-khù-sṳ̂ O-lie̍t-lî-vû-sṳ̂	Marcus Aurelius
Zagreb	Zagreb
Tet-khiet-sat-sṳ̂	Texas (staat)
Thai-mí-ngì-na̍p-tet-pâng	Tamil Nadu
Pet Khà-lò-lòi-na̍p	North Carolina
Nàm Khà-lò-lòi-na̍p	South Carolina
Loire-sén	Loire (rivier)
Pâ-set-lò-nâ	Barcelona (Spanje)
Vòng-lî	Ananas
Me̍t-sî-sî-pí	Mississippi (staat)
Thièn-na̍p-sî	Tennessee
Néu Me̍t-sî-kô	New Mexico
Mìn-nì-sû-tha̍t	Minnesota
Vî-sṳ̂-không-sîn	Wisconsin
Oi-hò-fà	Iowa (staat)
Nui-pu-lâ-sṳ̂-kâ	Nebraska
Khâm-sat-sṳ̂	Kansas (staat)
Yin-thi-ngî	Hindi
Me̍t-sû-lî	Missouri (staat)
Lu-yi-sṳ̂-ôn-ná	Louisiana (staat)
Khén-thap-kî	Kentucky
Â-khén-set	Arkansas (staat)
Neil Armstrong	Neil Armstrong
O-khiet-lâ-hò-mâ	Oklahoma
Pet-hói	Noordzee
Mo̍k-sṳ̂-khô-chû	Oblast Moskou
Kiel	Kiel (Duitsland)
Schwerin	Schwerin
Potsdam	Potsdam
Hanover	Hannover (stad)
Düsseldorf	Düsseldorf
Mainz	Mainz
Wiesbaden	Wiesbaden
Saarbrücken	Saarbrücken
Mu-nì-het	München
Erfurt	Erfurt
Dresden	Dresden
Kaliningrad-chû	Oblast Kaliningrad
Murmansk-chû	Oblast Moermansk
Kak-than-sṳ̂-khiet	Gdańsk
Fap-làn-khiet-fuk	Frankfurt am Main
Fut-lò-tshṳ-ngá-fû	Wrocław
Làn	Lanthaan
Ki (鉕)	Promethium
Sân	Samarium
Â-chhè Thi̍t-phe̍t Hàng-chṳn-khî	Atjeh
Nga̍t (釓)	Gadolinium
Thi̍t (鋱)	Terbium
Tit (鏑)	Dysprosium
Sṳn-kîn	Bijbel (christendom)
Fó	Holmium
Ngí (鉺)	Erbium
Tiû	Thulium
Yi	Ytterbium
Liu	Lutetium
Hò-nui-sṳ	Hanoi
Chṳ̂n Yâ-sû Kau-fi	Ware Jezuskerk
Yîn-ngî	Engels
Màn-kuk	Bangkok
Kit-lùng-po	Kuala Lumpur
Pâng-kâ Vú-lî-thung-sén	Banka-Billiton
Thòi-pet-sṳ	Taipei (stad)
Mî (鋂)	Americium
Arkhangelsk-chû	Oblast Archangelsk
Khiu̍k	Curium
Thùng-hói-sṳ	Đồng Hới
Concepción	Concepción (Chili)
Pet (鉳)	Berkelium
Khà (鉲)	Californium
Mìn-kú-lû-sén	Bengkulu (provincie)
Oi	Einsteinium
Fi	Fermium
Mùn	Mendelevium
Na	Nobelium
Ontario-sén	Ontario
Lò	Lawrencium
Karelia Khiung-fò-koet	Karelië (deelrepubliek)
Końskowola	Końskowola
2002-ngièn	2002
2008-ngièn	2008
Charles de Gaulle	Charles de Gaulle
Cham-pî-sén	Jambi (provincie)
Komi Khiung-fò-koet	Komi (deelrepubliek)
Nâm-póng-sén	Lampung
Pet Sû-mùn-tap-lia̍p-sén	Noord-Sumatra
Syktyvkar	Syktyvkar
Québec-sṳ	Quebec (stad)
Nenets Chhṳ-chhṳ-khî	Nenetsië
Liàu-nui-sén	Riau
Leningrad-chû	Oblast Leningrad
Pskov-chû	Oblast Pskov
Liàu-nui Khiùn-tó-sén	Riouwarchipel
Nizhny Novgorod-chû	Oblast Nizjni Novgorod
Nàm Sû-mùn-tap-lia̍p-sén	Zuid-Sumatra
Lò-mâ Ti-koet	Romeinse Keizerrijk
Mì-ngiôn Kûng-sṳ̂	Microsoft
Tver-chû	Oblast Tver
Khù-lû-fû	Kurów (powiat Puławski)
Fa-ho̍k	Scheikunde
Smolensk-chû	Oblast Smolensk
Yaroslavl-chû	Oblast Jaroslavl
Kostroma-chû	Oblast Kostroma
Ivanovo-chû	Oblast Ivanovo
Arnold Schwarzenegger	Arnold Schwarzenegger
Chiuk-khiù	Voetbal
Ryazan-chû	Oblast Rjazan
IPhone	IPhone
Sî Sû-mùn-tap-lia̍p-sén	West-Sumatra
Tula-chû	Oblast Toela
IPad	IPad
Mâ-tet-lî	Madrid (stad)
Bryansk-chû	Oblast Brjansk
Michael Jackson	Michael Jackson
Kaluga-chû	Oblast Kaloega
Loire-Atlantique-sén	Loire-Atlantique
Ain-sén	Ain (departement)
Allier-sén	Allier (departement)
Khâm-phì-là	Canberra
Sông Alpes-sén	Hautes-Alpes
Oryol-chû	Oblast Orjol
Sit-nì	Sydney
Alpes-de-Haute-Provence-sén	Alpes-de-Haute-Provence
Liu̍k-set	Groen (kleur)
Alpes-Maritimes-sén	Alpes-Maritimes
Hâ-tet-sùn-hò	Hudson (rivier)
Me̍t-ngì-pún	Melbourne
Fùng-set	Rood (kleur)
Ardèche-sén	Ardèche (departement)
Jena	Jena (Duitsland)
Kursk-chû	Oblast Koersk
Ariège-sén	Ariège (departement)
Aude-sén	Aude (departement)
Aveyron-sén	Aveyron (departement)
Sîn Nàm Vî-ngì-sṳ̂-chû	Nieuw-Zuid-Wales
Bouches-du-Rhône-sén	Bouches-du-Rhône
Àu-thai-li-â Sú-tû Liâng-thi	Australian Capital Territory
Cantal-sén	Cantal
Belgorod-chû	Oblast Belgorod
Côte-d'Or-sén	Côte-d'Or
Côtes-d'Armor-sén	Côtes-d'Armor
Drôme-sén	Drôme (departement)
Finistère-sén	Finistère
Voronezh-chû	Oblast Voronezj
Sû-mùn-tap-lia̍p	Sumatra
Lipetsk-chû	Oblast Lipetsk
Van-tan-sén	Bantam (provincie)
Chûng Cháu-ôa-sén	Midden-Java
Fùi-sên	Komeet
Rostov-chû	Oblast Rostov
Tûng Cháu-ôa-sén	Oost-Java
Ngâ-kâ-tha̍t Sú-tû Thi̍t-khî	Jakarta
Sî Cháu-ôa-sén	West-Java
Adygea Khiung-fò-koet	Adygea
Ngit-ngiâ Thi-fông Thi̍t-khî	Jogjakarta
Gera	Gera (stad)
Maykop	Majkop
Cháu-ôa-tó	Java (eiland)
Kâ-lî-man-tân-chû	Kalimantan
Séu Sùn-thâ Khiùn-tó	Kleine Soenda-eilanden
Sû-lâ-vî-sî-tó	Celebes
Mô-lu̍k-kâ Khiùn-tó	Molukken
Chûng Kâ-lî-man-tân-sén	Midden-Kalimantan
Tûng Kâ-lî-man-tân-sén	Oost-Kalimantan
Nàm Kâ-lî-man-tân-sén	Zuid-Kalimantan
Kâ-li-sî-â	Galicië (Spanje)
Sî Kâ-lî-man-tân-sén	West-Kalimantan
Thai-ho̍k	Universiteit
Pretoria	Pretoria
Chok-khiù	Tafeltennis
Â-sṳ̂-thù-lî-â-sṳ̂	Asturië (regio)
Wikipedia:Sandbox	Wikipedia:Zandbak
Astrakhan-chû	Oblast Astrachan
Kham-thap-pu-lî-â	Cantabrië
Kalmykia Khiung-fò-koet	Kalmukkië
Weimar	Weimar (Thüringen)
Osasco	Osasco (Brazilië)
Â-là-kung	Aragón (regio)
Kak-là-sṳ̂-kô	Glasgow
Thùng-hói Kî-chhòng	Luchthaven Đồng Hới
Vú-lîn-ngièn Fûng-kín Miàng-sṳn-khî	Wulingyuan
分類:Thòi-vân li̍t-sṳ́	Categorie:Geschiedenis van Taiwan
Curitiba	Curitiba (gemeente)
Chloë Grace Moretz	Chloë Grace Moretz
Khûng-chṳ́	Confucius
Corbin Bleu	Corbin Bleu
分類:Sṳ-ho̍k	Categorie:Wiskunde
分類:Ngìn-kûng ngî-ngièn	Categorie:Kunsttaal
Pâ-lî-sén	Bali (eiland)
Mî-kîm	Amerikaanse dollar
Thi-chûng-hói	Middellandse Zee
Hông-chû-sṳ	Hangzhou
Kî-tuk-kau	Christendom
Tûng Nú-sâ Tên-kâ-là-sén	Oost-Nusa Tenggara
Sî Nú-sâ Tên-kâ-là-sén	West-Nusa Tenggara
Chûng Sû-lâ-vî-sî-sén	Midden-Celebes
Kô-lùn-tá-lo̍k-sén	Gorontalo (provincie)
Pet Sû-lâ-vî-sî-sén	Noord-Celebes
Tûng-nàm Sû-lâ-vî-sî-sén	Zuidoost-Celebes
Nàm Sû-lâ-vî-sî-sén	Zuid-Celebes
Sî Sû-lâ-vî-sî-sén	West-Celebes
Vò-é	Rijst
Mâ-lû-kú-sén	Maluku (provincie)
Pet Mâ-lû-kú-sén	Noord-Molukken
Pâ-pu-â-sén	Papoea (provincie)
Sî Pâ-pu-â-sén	West-Papoea
Dagestan Khiung-fò-koet	Dagestan
Sú-tû	Hoofdstad
Monzón	Monzón
Phù-thò-ngà-ngî	Portugees
Ngie̍t	Maand
Mustafa Kemal Atatürk	Mustafa Kemal Atatürk
Makhachkala	Machatsjkala
Chechnya Khiung-fò-koet	Tsjetsjenië
Grozny	Grozny
Almazán	Almazán (gemeente)
Ingushetia Khiung-fò-koet	Ingoesjetië
Magas	Magas
Pet Ossetia–Alania Khiung-fò-koet	Noord-Ossetië
Kabardino-Balkaria Khiung-fò-koet	Kabardië-Balkarië
Tson-sa̍k	Diamant
Bill Gates	Bill Gates
Ngi̍t-ngî	Japans
Pak-khô-chhiòn-sû	Encyclopedie
頭頁	Hoofdpagina
Karachay-Cherkessia Khiung-fò-koet	Karatsjaj-Tsjerkessië
Saratov	Saratov
Saratov-chû	Oblast Saratov
Orenburg-chû	Oblast Orenburg
Mordovia Khiung-fò-koet	Mordovië
Saransk	Saransk
Yâ-khiù	Honkbal
Làm-khiù	Basketbal
Kirov-chû	Oblast Kirov
Udmurtia Khiung-fò-koet	Oedmoertië
Sî-pak-li-â	Siberië
Mari El Khiung-fò-koet	Mari El
Yoshkar-Ola	Josjkar-Ola
Stellenbosch	Stellenbosch (stad)
Sverdlovsk-chû	Oblast Sverdlovsk
Cape Town	Kaapstad
Chuvash Khiung-fò-koet	Tsjoevasjië
Durban	Durban (Zuid-Afrika)
Cheboksary	Tsjeboksary
Tat-tat-sṳ̂-thán Khiung-fò-koet	Tatarije
Penza-chû	Oblast Penza
Là-fî-ngì	Rafaël (kunstenaar)
Pí-tet Lû-pún-sṳ̂	Peter Paul Rubens
Ulyanovsk-chû	Oblast Oeljanovsk
Gung-gung-hi-tsaa	Autobus
Kâ-thai-lò-nì-â	Catalonië
Bashkortostan Khiung-fò-koet	Basjkirostan
Chelyabinsk-chû	Oblast Tsjeljabinsk
Pâ-lùn-sî-â Chhṳ-chhṳ-khî	Valencia (autonome gemeenschap)
Khà-sṳ̂-tì-li-â lâu Lòi-ngong	Castilië en León
Kurgan-chû	Oblast Koergan
Mô Chhe̍t-tûng	Mao Zedong
Tyumen-chû	Oblast Tjoemen
Omsk-chû	Oblast Omsk
Thai-mí-ngì-ngî	Tamil
Chet-ho̍k	Filosofie
分類:Candidates for speedy deletion	Categorie:Wikipedia:Nuweg
Altai Khiung-fò-koet	Altaj (deelrepubliek)
Kòng-khìm	Piano (instrument)
Gorno-Altaysk	Gorno-Altajsk
Kemerovo-chû	Oblast Kemerovo
Hebe Camargo	Hebe Camargo
Chṳ̂-pún chú-ngi	Kapitalisme
Koet-kâ	Land (geografie)
Mìn-chhu̍k	Natie
Khanty-Mansi Chhṳ-chhṳ-khî	Chanto-Mansië
Yamalo-Nenets Chhṳ-chhṳ-khî	Jamalië
Montpellier	Montpellier
分類:Thiên-vùn-ho̍k	Categorie:Astronomie
Khakassia Khiung-fò-koet	Chakassië
Irkutsk-chû	Oblast Irkoetsk
Sakha Khiung-fò-koet	Jakoetië
Khiet-lò-âi-sî-â-ngî	Kroatisch
Hon-pó	Hamburger
Buryatia Khiung-fò-koet	Boerjatië
Vû-làn Vû-tet	Oelan-Oede
Amur-chû	Oblast Amoer
Ngi-sṳ̍p Sṳ-ki	20e eeuw
Gotha	Gotha (stad)
Dijon	Dijon
Kâ-thai-lò-nì-â-ngî	Catalaans (taal)
Nordhausen	Nordhausen (stad)
Kit-lò-na̍p-sén	Gerona (stad)
Eisenach	Eisenach
Se-pâu Sâng-vu̍t-ho̍k	Celbiologie
Sṳ-kie Ngiùn-hòng Si̍p-thòn	Wereldbank
A-la-pak Liên-mên	Arabische Liga
Mìn-tsú Tsú-ngi	Democratie
Chhîn-chhèu (秦朝)	Qin-dynastie
Pet Thai-sî-yòng Kûng-yok Chû-chṳt	Noord-Atlantische Verdragsorganisatie
Chhìn Sṳ Fòng	Qin Shi Huangdi
Hon-chhèu	Han-dynastie
Hon Vú-ti Liù Chha̍t	Han Wudi
Sâng-vu̍t	Organisme
Kiûn-chú-chṳ	Monarchie
Khiung-fò-koet	Republiek
Yí-mô-khiù	Badminton
Ngièn-chhèu	Yuan-dynastie
Nazi Tet-koet	Nazi-Duitsland
Yù-thai-ngìn	Joden
Chang Fò	Zheng He
Chìn-chhèu	Jin-dynastie (265-420)
Ngí	Oor
Phi	Neus
Ngién	Oog (anatomie)
Mûn-é	Steekmuggen
Mièn-yòng	Schaap (dier)
Lo̍k-thò	Kamelen
Phú-nen thung-vu̍t	Zoogdieren
Siong	Olifanten
Ngie-kûng	Mieren
Phûng-é	Bijen
Hò-làn-ngî	Nederlands
Fà-thi̍t Thit-sṳ-nì Kûng-sṳ̂	The Walt Disney Company
Thot-yong Fu̍t-thông Fu̍t-son	Desoxyribonucleïnezuur
Khiô	Aubergine (plant)
Siet	Sneeuw
Â-pâ	Vaderschap
Fûn	Minuut (tijd)
Yù-thai Chhṳ-chhṳ-chû	Joodse Autonome Oblast
Ngò-lò-sṳ̂-ngî	Russisch
Tûng-nàm-â Koet-kâ Lièn-mèn	ASEAN
Sakhalin-chû	Oblast Sachalin
Mien-pâu	Brood
Sṳ-kie Mo-yi Chû-chṳt	Wereldhandelsorganisatie
漢語	Chinese talen
Se-pâu	Cel (biologie)
Hiet-yi̍t	Bloed
Hi	Long (orgaan)
Lò-mâ-nì-â-ngî	Roemeens
Pó-kâ-li-â-ngî	Bulgaars
Magadan-chû	Oblast Magadan
Chhṳ-yèn Khô-ho̍k	Natuurwetenschap
Het-chhe̍t Mìn	Akira Kurosawa
Franklin D. Roosevelt	Franklin Delano Roosevelt
Thi-khiù Khô-ho̍k	Aardwetenschappen
Sa̍k-thèu	Gesteente
Yùn	Wolk
Kí-hò-ho̍k	Meetkunde
Tet-lu-kú-ngî	Telugu (taal)
Thai-hì-chhèn	Atmosfeer (astronomie)
Kak-lû-kit-â-ngî	Georgisch
Kîn-chi-ho̍k	Economie
Pîn-kóng	Pangkal Pinang
漢字	Hanzi
Sî-lî-ngì Sṳ-mû	Cyrillisch alfabet
Lâ-tên sṳ-mû	Latijns alfabet
Vùn-ho̍k	Literatuur
分類:Fap-koet	Categorie:Frankrijk
分類:Yîm-ngo̍k	Categorie:Muziek
分類:Vùn-ho̍k	Categorie:Literatuur
Fù-lì	Vossen
La̍p-pá	Trompet
Â-li̍t-sân-thai sâm-sṳ	Alexander de Grote
Kiûn-sṳ-thán-tên Yit-sṳ	Constantijn de Grote
Set-lû-sṳ thai-ti	Cyrus II de Grote
Vùn-mìn	Beschaving
Kau-yuk	Onderwijs
Kâ-thìn	Familie (verwanten)
Nàm-ngìn	Man (geslacht)
Fûn-yîn	Huwelijk
Kâ-pî	Koffie
Ngiù-nen	Melk (drank)
Sûn Chûng-sân	Sun Yat-sen
Â-yuk-vòng	Asoka
香港	Hongkong
Thai-yîn Ti-koet	Britse Rijk
Sú-ngì	Seoel
Kâm-nái-thit Koet-chi Kî-chhòng	John F. Kennedy International Airport
上海	Shanghai
Lùn-tûn Hî-sṳ̂-lu Kî-chhòng	Luchthaven Londen Heathrow
Lùn-tûn Kak-vet Kî-chhòng	Luchthaven Londen Gatwick
Set-vì-li-â	Sevilla (stad)
Chhîn-chhèu	Qing-dynastie
Â-ngì-pâ-nì-â-ngî	Albanees
Pâ-sṳ̂-khiet-ngî	Baskisch
Â-lâ-kung-ngî	Aragonees
Yîn-koet Hòng-khûng	British Airways
Â-mî-nì-â-ngî	Armeens
Vû-khiet-làn-ngî	Oekraïens
Pâ-lùn-sî-â	Valencia (stad)
Shuì-tién-ngî	Zweeds
Tan-ma̍k-ngî	Deens
Nò-vî-ngî	Noors
Kô-thi̍t-fu̍t-lòi-tet Vî-liâm Lòi-pu-nì-tsṳ	Gottfried Wilhelm Leibniz
Tshia̍p-khiet-ngî	Tsjechisch
Sṳ̂-lo̍k-phat-khiet-ngî	Slowaaks
Sṳ̂-lo̍k-vì-nì-â-ngî	Sloveens
Hiûng-ngà-li-ngî	Hongaars
Oi-sâ-nì-â-ngî	Estisch
Là-thot-vì-â-ngî	Lets
Li̍p-thâu-vón-ngî	Litouws
Pha̍k-ngò-lò-sṳ̂-ngî	Wit-Russisch
Kui-mí-thi̍t-lî Mùn-tet-lie̍t-fû	Dmitri Mendelejev
Ngièn-chṳ́	Atoom
Lâ-set-fuk	Ernest Rutherford
Hî-lia̍p-ngî	Grieks
Oi-ngì-làn-ngî	Iers
Pô-sṳ̂-ngî	Perzisch
Chûng-kau	Religie
Chêu-sién-ngî	Koreaans
Chhóng-sṳ-ki	Genesis (boek)
Kóng-tûng-fa	Standaardkantonees
Chhut-âi-khi̍p-ki	Exodus (boek)
Ye̍t-nàm-ngî	Vietnamees
Pó-lò	Paulus (apostel)
Kô-mièn-ngî	Khmer (taal)
Thai-ngî	Thai (taal)
Mâ-lòi-ngî	Maleis
Yin-nì-ngî	Indonesisch
Mùng-kú-ngî	Mongools
Hâ-sat-khiet-ngî	Kazachs
Vû-tsṳ̂-phe̍t-khiet-ngî	Oezbeeks
Thú-khù-màn-ngî	Turkmeens
Yù-thai-kau	Jodendom
Hî-pak-lói-ngî	Hebreeuws
Â-set-pai-kiông-ngî	Azerbeidzjaans
Mâ-khì-tun-ngî	Macedonisch (Slavisch)
Set-ngì-vì-â-ngî	Servisch
Set-ngì-vì-â Khiet-lò-thi-â-ngî	Servo-Kroatisch
Pô-sṳ-nì-â-ngî	Bosnisch
Kâ-lî-sî-â-ngî	Galicisch
Vî-ngì-sṳ̂-ngî	Welsh (taal)
Sû-kak-làn Koi-ngì-ngî	Schots-Gaelisch
Siak-khiet-kau	Sikhisme
John Maynard Keynes	John Maynard Keynes
Lufthansa Hòng-khûng	Lufthansa
Ló-chṳ́	Laozi
Kôn-chhóng	Lever
Shìn	Nier (biologie)
Sṳ̀n-kîn Ne-thúng	Zenuwstelsel
Sîm-lî-ho̍k	Psychologie
Sṳt-kâ-mèu-nì	Gautama Boeddha
Mâ-tên Lu-tet	Maarten Luther
Yî-kâ	Confucianisme
Thiên-chú-kau	Rooms-katholieke Kerk
Tho-kau	Taoïsme
Chit-siói	Ruggenmerg
Sa̍t	Tong (anatomie)
Yî-tshóng	Alvleesklier
Hèu-thèu	Strottenhoofd
Fuk-khiet-làn khiùn-tó	Falklandeilanden
Vàng-kak-mo̍k	Middenrif
Lân-mî	Wormvormig aanhangsel
Elizabeth Ngi-sṳ	Elizabeth II van het Verenigd Koninkrijk
Thòng-chhèu	Tang-dynastie
John F. Kennedy	John F. Kennedy
Mìn-chhèu	Ming-dynastie
Dwight D. Eisenhower	Dwight D. Eisenhower
Ronald Reagan	Ronald Reagan
Sat-là-kô-sat	Zaragoza (stad)
Kîm Tsang-ngit	Kim Jong-il
Ngièn-su Chû-khì-péu	Periodiek systeem
Chû-su̍k	Echte zwijnen
Mariano Rajoy	Mariano Rajoy Brey
Se-khiûn	Bacteriën
Phù-thò	Druif
Phûng-thòng	Honing
Thông	Tafelsuiker
Vòng-theu	Sojaboon
Kûng-chhàng-ho̍k	Engineering
Vùn-fa	Cultuur
Fan-vun	Sanskriet
Sùn-fàn Hì-thúng	Hart en vaatstelsel
Sôn	Zuur (scheikunde)
Yî-ho̍k	Geneeskunde
Néu-Yok Sṳ-kie Mo-yi Chûng-sîm	World Trade Center (New York)
Hâ Màn-hâ-tun	Lower Manhattan
Yàm	Keukenzout
分類:Pâ-sî	Categorie:Brazilië
Màn-hâ-tun	Manhattan (New York)
Ngièn-su	Chemisch element
Kâ-suk-thu	Versnelling (natuurkunde)
Li̍t	Kracht
Kú	Trommel
Tsṳt-liông	Massa (natuurkunde)
Thien-yáng	Film (cinematografie)
Kîm-su̍k	Metaal
Nùng-ngia̍p	Landbouw
Sâng-yîm	Geluid
Sṳ̀-kiên	Tijd
Mien-chit	Oppervlakte
Kûng-kîn	Kilogram
Kûng-tshak	Meter
Miéu	Seconde
Pâu-siuk	Mais
Kûng-sṳ̂n	Liter
Fà-ngì-kiê	Wall Street
Tûng-nàm-â	Zuidoost-Azië
Tshùng-khin	Chongqing
Thiên-tsîn	Tianjin
Vú-hon-sṳ	Wuhan
Kú Hî-lia̍p	Oude Griekenland
Thomas Jefferson	Thomas Jefferson
Vùi-sṳ̂-khà	Huesca (stad)
Tychy	Tychy
El Masnou	El Masnou
Pu-lie̍t-thap-nì-ngî	Bretons (taal)
Brittany	Bretagne (regio)
Lóng	Doofheid
Chhi̍t-phiang	Ziekte
Khien-không	Gezondheid
Sok-lî-â	Soria (stad)
Màn-tó-ngî	Manx-Gaelisch
Chhiâng-môi-su	Penicilline
Nantes	Nantes
Pot-thâm-fó	Tuberculose
Mà-chiông	Mahjong
模板:Location map Taiwan	Sjabloon:Positiekaart Taiwan
Detroit	Detroit (Michigan)
Van-lî Tshòng-sàng	Chinese Muur
Gard-sén	Gard (departement)
Gers-sén	Gers (departement)
Sông Garonne-sén	Haute-Garonne
Sṳ̀n-sṳn Lò-mâ Ti-koet	Heilige Roomse Rijk
Ille-et-Vilaine-sén	Ille-et-Vilaine
Isère-sén	Isère (departement)
Chûng-kau Kói-kiet	Reformatie
Sông Loire-sén	Haute-Loire
Lot-sén	Lot (departement)
Lozère-sén	Lozère
Maine-et-Loire-sén	Maine-et-Loire
Nì-pu-kap-nì-sat ngi-sṳ	Nebukadnezar II
Mayenne-sén	Mayenne (departement)
Morbihan-sén	Morbihan
Nièvre-sén	Nièvre (departement)
Nord-sén	Noorderdepartement
Calais Hói-hia̍p-sén	Pas-de-Calais
Puy-de-Dôme-sén	Puy-de-Dôme
Sông Pyrénées-sén	Hautes-Pyrénées
Pyrénées-Orientales-sén	Pyrénées-Orientales
Hâ Rhin-sén	Bas-Rhin
Sông Rhin-sén	Haut-Rhin
Saône-et-Loire-sén	Saône-et-Loire
Sarthe-sén	Sarthe (departement)
Sông Savoie-sén	Haute-Savoie
Tarn-sén	Tarn (departement)
Tarn-et-Garonne-sén	Tarn-et-Garonne
Var-sén	Var (departement)
Vaucluse-sén	Vaucluse (departement)
Vendée-sén	Vendée (departement)
Yonne-sén	Yonne (departement)
Yî-pí-li-â Pan-tó	Iberisch Schiereiland
Lai-kî	Lychee
Yâ-è	Kokospalm
Sa̍k-liù	Granaatappel
Chong-fa	Zhuang (taal)
Sông-sok-pu-ngî	Oppersorbisch
Na̍p-ngá-thi̍t-ngî	Nahuatl
Mí-nàm-kâ-pó-ngî	Minangkabaus
Mirandés-ngî	Mirandees
Harvard Thai-ho̍k	Harvard-universiteit
Néu-yok Chṳn-khèn Kâu-yi-só	New York Stock Exchange
Lie̍t-yî-tha̍t-sén	Lerida (provincie)
Â-lâ-pak-ngî	Arabisch
Kiú-chiu	Kyushu
Si-koet	Shikoku (eiland)
O-khiet-ngî	Occitaans
Nàm-fî Hò-làn-ngî	Afrikaans
Lí Mìn-pok	Lee Myung-bak
Lû Vú-hién	Roh Moo-hyun
Kâ Mà-chiok	Huismus
Kô-thiet	Metro van Hongkong
澳門	Macau
Suhl	Suhl
Mühlhausen	Mühlhausen (Thüringen)
Sâ-thièn-khî	Sha Tin District
Fù Kím-Thàu	Hu Jintao
Si̍p Khiûn-phìn	Xi Jinping
Chhòng-kiáng-lu̍k	Giraffe (dier)
Phì-âi-mùng-thi̍t-ngî	Piëmontees
Thap-là-kô-na̍p	Tarragona (stad)
Provence-Alpes-Côte d'Azur	Provence-Alpes-Côte d'Azur
Chûng-Wàn-Tshàm／Hiông-Kóng-Tshàm(MTR)	Station Central (MTR)
Chhṳ̂m-chun-sṳ	Shenzhen
Kóng-tûng	Guangdong
Kóng-sî Chong-chhu̍k Chhṳ-chhṳ-khî	Guangxi
Mô-kài	In de Ban van de Ring
Castellar de n'Hug	Castellar de n'Hug
Hiông-kóng Thai-ho̍k	Universiteit van Hongkong
Badajoz	Badajoz (stad)
Lu̍k-yì-tó-yen	Kagoshima (prefectuur)
Kiok	Voet (anatomie)
Sit-thit	Hagedissen
Altenburg	Altenburg (Thüringen)
Kiên	Schouder
Midi-Pyrénées	Midi-Pyrénées
模板:Link FA	Sjabloon:Link FA
Wikipedia:Chhâm-siòng	Wikipedia:De kroeg
Fu-mùng-thi̍t	Vermont
Hiû-sṳ̂-tûn	Houston
Kóng-chiu-sṳ	Kanton (stad)
Chiông Kie-sa̍k	Chiang Kai-shek
Vûn Kâ-pó	Wen Jiabao
Nàm-kîn-sṳ	Nanking
Phiang-yèn	Ziekenhuis
Kông-sû	Jiangsu
Chet-kông-sén	Zhejiang
Thèn Séu-phìn	Deng Xiaoping
Pet-phu Calais Hói-hia̍p	Nord-Pas-de-Calais
Pays de la Loire	Pays de la Loire
Languedoc-Roussillon	Languedoc-Roussillon (regio)
Thiap-sat-lò-nì-kâ	Thessaloniki (stad)
西藏自治區	Tibetaanse Autonome Regio
Hàng-thung Thien-fa	Mobiele telefoon
Thò-niâu	Struisvogel
Manchester	Manchester
Pu-lû-khiet-lìm	Brooklyn (New York)
Fòng-heu-khî	Queens
Liùng-yìn-sṳ	Yongin
Lòng	Wolf
Mâ-lòi Pan-tó	Malakka (schiereiland)
Sîn-yok Sṳn-kîn	Nieuwe Testament
Fan-lóng-thap-cham-sṳ	Phan Rang-Tháp Chàm
9	9 (getal)
Zung-gok Thaai-liuk	Vasteland van China
Het-liùng-kông	Heilongjiang
Mâ Yîn-kiú	Ma Ying-jeou
Piên-fò-sṳ	Biên Hòa (stad)
Hiông-kóng-tó	Hongkong (eiland)
Ngà-tsông-sṳ	Nha Trang
Podolsk	Podolsk
Pô-tô Lì-kok Thu̍k-li̍p-tóng	Partido Independentista Puertorriqueño
Lì-è	Ezel (dier)
Si-chhôn-sén	Sichuan
Khiu-yok Sṳn-kîn	Oude Testament
Sṳn-tan-chiet	Kerstmis
Lò-màn Ngî-chhu̍k	Romaanse talen
Sâm-kok-hìn	Driehoek (meetkunde)
Steve Jobs	Steve Jobs
Yin-Êu Ngî-ne	Indo-Europese talen
Breinigerberg	Breinigerberg
Lo-fú	Tijger
Fù-ôn Khà-lo̍k-sṳ̂ Yit-sṳ	Juan Carlos I van Spanje
Súi-ngièn-sṳ	Suwon
Sâm-sên Si̍p-thòn	Samsung Group
Louis Couturat	Louis Couturat
Thai-thièn Kóng-vet-sṳ	Daejeon
Kîn-ki-tho	Gyeonggi-do
Sṳ̂-khâm-tit-nâ-vì-â	Scandinavië
Fu̍k-fa̍t-chiet	Pasen
Thien-nó Khô-ho̍k	Informatica
Koet-chi Yîm-phiêu	Internationaal Fonetisch Alfabet
Hò-pet	Hebei
Phú-lìm-sṳ̂-tun Thai-ho̍k	Princeton-universiteit
Fôn-hìn-muk	Ooievaarachtigen
Chhṳ̀n Súi-pién	Chen Shui-bian
Chṳ-fi-hîn Sú-kî	Smartphone
Sa̍k-yù	Aardolie
Hài-è	Schoen
Ngiùn-hòng	Bank (financiële instelling)
Ngièn-lun Chhṳ-yù	Vrijheid van meningsuiting
Oi-ngì-làn	Ierland (eiland)
Cheshire	Cheshire (graafschap)
Cumbria	Cumbria
Lancashire	Lancashire (graafschap)
Northumberland	Northumberland
Tyne and Wear	Tyne and Wear
County Durham	Durham (graafschap)
Pet Yorkshire	North Yorkshire
Lincolnshire	Lincolnshire (graafschap)
Nottinghamshire	Nottinghamshire
Derbyshire	Derbyshire
Merseyside	Merseyside
Leicestershire	Leicestershire
Rutland	Rutland (graafschap)
Lû-sùn	Lu Xun (schrijver)
Northamptonshire	Northamptonshire
Devon	Devon
Oxfordshire	Oxfordshire
Wiltshire	Wiltshire (graafschap)
Hampshire	Hampshire
Buckinghamshire	Buckinghamshire
Surrey	Surrey (graafschap)
West Sussex	West Sussex
East Sussex	East Sussex
Kent	Kent (graafschap)
Thai Lùn-tûn	Groot-Londen
7	7 (getal)
8	8 (getal)
Lu̍k-é	Hertachtigen
Pên	IJs (water)
Chú ke Khì-tó-vùn	Onzevader
Ngìn-lui-ho̍k	Antropologie
Fùng-hói	Rode Zee
Oi-tên-páu	Edinburgh
Pha̍k-set	Wit
Marseille	Marseille
Thai-chhûng-thèu	Ui (plant)
6	6 (getal)
Kôn-fông ngî-ngièn	Officiële taal
Kháu-kú-ho̍k	Archeologie
George H. W. Bush	George H.W. Bush
Pâ-ngì-kòn pan-tó	Balkan (schiereiland)
Dmitry Medvedev	Dmitri Medvedev
Entrena	Entrena
Sîn-kau	Protestantisme
Selena	Selena Quintanilla
Mî-koet Thai-khûng Chúng-shu	National Aeronautics and Space Administration
Thai Put-lie̍t-tiên-tó	Groot-Brittannië
Pâ-le̍t-sṳ̂-thán	Palestina (regio)
10	10 (getal)
Lila Downs	Lila Downs
Lia̍p-pau	Jachtluipaard
Liverpool	Liverpool
Bremen	Bremen (stad)
Sîn Nò-vî-ngî	Nynorsk
Meu-thèu-tiâu	Uilen (orde)
Sṳ̀	Uur
Fap-lò-ngî	Faeröers
Kîm-eu-sṳ	Cà Mau (stad)
Meu-khô	Katachtigen
Koet-chi Thai-khûng Chhàm	Internationaal ruimtestation ISS
Tà-la-sṳ	Đà Lạt
Tat-tat-ngî	Tataars
Tshûng-liông	Gewicht
Tsûng-su	Dadelpalm
Fan-tshiet-sṳ	Phan Thiết
Sî Fut-lî-sî-ngî	Friese talen
Séu Vòng-chṳ́	De kleine prins
Phiàng-fông kûng-tshak	Vierkante meter
Fó-yam-chhùng	Glimwormen
Li̍p-fông kûng-tshak	Kubieke meter
Fàn-chiet-thûng-vu̍t-mùn	Ringwormen
Chhú-khô	Muridae
Lû-sêm-nì-â-ngî	Roetheens (modern)
Ede (Hò-làn)	Ede (gemeente)
Fú-kîn	Orka (dier)
Sâ-thi̍t-fut-lî-sî-ngî	Saterfries
Liû-khiù-koet	Koninkrijk Riukiu
Pet-fut-lî-sî-â-ngî	Noord-Fries
Â-mê-ha̍p-lâ-ngî	Amhaars
蝠婆	Vleermuizen
Tarnobrzeg	Tarnobrzeg
Vòng Ti	Huang Di
Tiau-ǹg-thòi Lie̍t-yí	Senkaku-eilanden
Khiung-fò-tóng (Mî-koet)	Republikeinse Partij (Verenigde Staten)
Â-sṳ̂-thù-lî-â-sṳ̂-ngî	Asturisch
中國	China
O-thi-li Pâ-vî-li-â-ngî	Beiers
Mìn-chú-tóng (Mî-koet)	Democratische Partij (Verenigde Staten)
Tsuk-pet-sṳ	Zhubei
Sàng-tû-sṳ	Chengdu
Âi-sṳ̂-thi̍t-lùi-mâ-thu-lâ-ngî	Extremeens
Séu-su mìn-chhu̍k	Minderheid
Pô-lòi-kú	Pleiku
Â-ha̍p-sṳ̂-vòng	Achaz
Chûng-chû-sṳ	Chungju
Yî-liàu Ví-sâng	Gezondheidszorg
Yòng-suk-yen	Yangshuo
Khiet-là-khô-fû	Krakau
臺灣省	Taiwan (provincie)
Pet-kîn Sú-tû Koet-chi Kî-chhòng	Internationale Luchthaven van Peking
Sîn-kâ-po Hòng-khûng Kûng-sṳ̂	Singapore Airlines
Thien-nó Thôn-chhèn Só-mèu	Computertomografie
Vî-nî-sṳ̂-ngî	Venetiaans
Koet-li̍p Thòi-vân Thai-ho̍k	Nationale universiteit van Taiwan
Vì-phú-sêm-ngî	Wepsisch
Fu̍t-lò-ngî	Võro
Pân-mâ	Zebra (dier)
Valery Leontiev	Valeri Leontjev
Khô-sî-kâ-ngî	Corsicaans
Buryat-ngî	Boerjatisch
Sùn-tho-chûng	Methodisme
Suk-vú-ngî	Cebuano
Tha̍t-lò-phî-thû Ngî-hì	Dravidische talen
Ló-kiê-sṳ	Lào Cai (stad)
客家語	Hakka (taal)
Pet-nèn-sṳ	Bắc Ninh (stad)
Liòng-sân-sṳ	Lạng Sơn (stad)
Hiuk-tsin-sṳ	Sóc Trăng (stad)
Liùng-chhôn-sṳ	Long Xuyên (An Giang)
Mî-tshiu-sṳ	Mỹ Tho (Tiền Giang)
Fut-liù-li-ngî	Friulisch
Pâng-mî-tsuk	Buôn Ma Thuột
Kàm-ngî	Ganyu
Pok-vu̍t-kón	Museum
Yin-thu Yî-lóng Ngî-chhu̍k	Indo-Iraanse talen
Thai-yùng-meu	Reuzenpanda
Kalmyk-ngî	Kalmuks
Mân-ngî	Mantsjoe (taal)
Kû-li̍p ngî-ngièn	Isolaat (taalkunde)
Kit-là-kî-ngî	Gilaki (taal)
Khà-sû-pí-ngî	Kasjoebisch
Karachay-Balkar-ngî	Karatsjaj-Balkarisch
Lùn-pâ-tí-ngî	Lombardisch
Sú	Hand
Thu fú	Du Fu
O-lî-â-ngî	Odia
Ngìn-khiéu	Bevolking
Nò-man-thi-ngî	Normandisch
Nèn-phìn-sṳ	Ninh Bình (stad)
Pet-sat-mí-ngî	Noord-Samisch
O-set-thôi-ngî	Ossetisch
Sî-sî-lî-ngî	Siciliaans (taal)
Sat-tên-nî-â-ngî	Sardijns
Nì-ngá-ngì-ngî	Nepalbhasa
Valparaíso	Valparaíso (stad)
Kóng-ngi-sṳ	Quảng Ngãi (stad)
Hò-tshin-sṳ	Hà Tĩnh (stad)
Yên-yèn	Acteur
Thap-kâ-lo̍k-ngî	Tagalog
Thùng	Brons
Vlaams-ngî	Vlaams
Fà-liùng-ngî	Waals
Sú-ngî	Gebarentaal
Międzyrzec Podlaski	Międzyrzec Podlaski
Phiêu-chún Chhông-ngî	Tibetaans
Ngá-shuì-ngá-shuì-ngî	Waray-Waray
N̂g-ngî	Wuyu
Woodrow Wilson	Woodrow Wilson
Fu̍t-sân-sṳ	Foshan
Ngiù-chîn Thai-ho̍k	Universiteit van Oxford
Sṳ̍p-thiàu Kie-min	Tien geboden
Yok-hon-nì-sṳ̂-páu	Johannesburg
Kî-tuk Kau-fi	Kerk (instituut)
Pau-é	Luipaard
Sîn-kiông	Sinkiang
Muk-kôa	Papaja
Pu-lî-sṳ̂-pân	Brisbane
Â-mî-ngî	Amis
Vî-liâm Lùn-khìm	Wilhelm Röntgen
Chû-chhèu	Zhou-dynastie
Ido-ngî	Ido (kunsttaal)
Brad Pitt	Brad Pitt
Pa̍k-kiûng	Witte Huis (Washington D.C.)
Tha̍t-mâ-thai-ngî	Dalmatisch
Tat-tat-chhu̍k	Tataren
Kô-liáng-sṳ	Cao Lãnh (stad)
Thai-fán-sṳ	Osaka
Kiam-khiâu Thai-ho̍k	Universiteit van Cambridge
Kûng-khín	Hectare
Sé-lî	Doop (sacrament)
Pông-hâ	Astma
Chuk	Bamboe
Fù Tsṳ-mìn	Hồ Chí Minh
Thièn-piên-fú	Điện Biên Phủ
Khûn-sṳ-làn-chû	Queensland
Ha-liùng-sṳ	Hạ Long
Kûi-yìn-sṳ	Quy Nhơn
Mìn-nì-â-pô-li-sṳ̂	Minneapolis
Li̍t-ka-sṳ	Rạch Giá
Li-kú-lî-â-ngî	Ligurisch (Romaanse taal)
Phô-lò-chû	Borneo
Khà-phién-phién-kâm-ngî	Kapampangan
Vù-fâ-kó	Vijgenboom
Sun-fa-sṳ	Huế
Tshòng-thu	Lengte (meetkunde)
Sṳ̂-chhù-chṳ̂-lu	Zijderoute
Hói-yòng-sṳ	Hải Dương (stad)
Mô-li-ngî	Maori (taal)
Mên-tûng-ngî	Mindong
Mên-pet-ngî	Minbei
Tô-se-pâu sâng-vu̍t	Meercellig organisme
Hîn-ôn-sṳ	Hưng Yên (stad)
Mên-nàm-ngî	Minnanyu
Tshiên-ngièn	Millennium
Ho̍k-miàng	Binominale nomenclatuur
Vì-tô-li-â-chû	Victoria (Australië)
Chong-chhu̍k	Zhuang (volk)
Sông-hói-fa	Shanghainees
Pet-kông	Bắc Giang (stad)
Aung San Suu Kyi翁山蘇姬	Aung San Suu Kyi
Tshèu-chû-fa	Chaozhouhua
Yok-hon-fuk-yîm	Evangelie volgens Johannes
William Vòng-chṳ́	William, hertog van Cambridge
Chhṳ̀n Kóng-sâng	Jackie Chan
12	12 (getal)
Vok-là-phú-khiet-ngî	Volapük
Toshiro Mifune	Toshiro Mifune
Kám-lám-su	Olijf
Só-lò-mùn-vòng	Salomo
O-khiet-làn	Auckland
Chhṳ̍t-sien	Lijn (meetkunde)
11	11 (getal)
13	13 (getal)
Sûn-chṳ́	Sunzi
Sṳn-lìn	Heilige Geest
Lû-pu-lìm	Lublin
Thì-thèu	Pinda
100	100 (getal)
Tshit-thèu	Knie (anatomie)
Tô-piên-hìn	Veelhoek
Nàm Chûng-koet Hói	Zuid-Chinese Zee
Campora San Giovanni	Campora San Giovanni
Pien-set-liùng	Kameleons
Bloemfontein	Bloemfontein
Ngiam-set-thí	Chromosoom
O-khiet-làn Vùn-fap Ho̍k-káu	Auckland Grammar School
Ngióng-kông	Rangoon (stad)
Ma̍k-tông-lò Kûng-sṳ̂	McDonald's
1000000	Miljoen
Meu-miàng-sṳ	Maoming
Liú-chiu-sṳ	Liuzhou
Pet-pan-khiù	Noordelijk halfrond
Ló-chhú	Mus (geslacht)
Thí-tsit	Inhoud (volume)
Het-tsṳ̂	Hertz (eenheid)
Pak-pân-khiet	Burbank (Los Angeles County, Californië)
Sien-lia̍p-thí	Mitochondrion
Yî-sên	Arts
Ki-sa̍k-chhṳn	Stonehenge
Chúng-thí Kîn-chi-ho̍k	Macro-economie
Ágreda	Ágreda
Lu-kâ-fuk-yîm	Evangelie volgens Lucas
Sîn Kí-nui-â	Nieuw-Guinea
Sṳ́-thù-hàng-chhon	Handelingen van de apostelen
Mô-hái	Krabben
PH	PH
Khì-tó	Gebed
Ôn-fui-sén	Anhui
Chûng-chhîn Pet-tho	Chungcheongbuk-do
Chûng-chhîn Nàm-tho	Chungcheongnam-do
Kông-ngièn-tho (Hôn-koet)	Gangwon-do
Nui Mùng-kú	Binnen-Mongolië
Kîm Ngit-sṳ̀n	Kim Il-sung
Pí-tet-kô-sṳ̍p	Bydgoszcz
Nottingham	Nottingham
Thai-ví-vòng	Koning David
Li-vi-ki	Leviticus
Sṳ̂-thán-fuk Thai-ho̍k	Stanford-universiteit
Fuk-kian	Fujian (China)
Kûng-khiet	Gram (eenheid)
Mùng-kú-tshu̍k	Mongolen
Khí-sṳ-liu̍k	Openbaring van Johannes
Kong-lîn-sṳ	Gangneung
Kiê-liùng-sṳ	Gyeryong
Kô-yòng-sṳ	Goyang
Kûng-chû-sṳ	Gongju
Kó-chhôn-sṳ	Gwacheon
Kông-mìn-sṳ	Gwangmyeong
Kiú-lî-sṳ	Guri
Kiûn-phú-sṳ	Gunpo
Kîm-phú-sṳ	Gimpo
Nàm-yòng-chû-sṳ	Namyangju
Lun-sân-sṳ	Nonsan
Thông-chîn-sṳ (Hôn-koet)	Dangjin
Tûng-theu-chhôn-sṳ	Dongducheon
Tûng-hói-sṳ (Hôn-koet)	Donghae
Pó-nèn-sṳ	Boryeong
Fu-chhôn-sṳ	Bucheon
Sâm-chit-sṳ	Samcheok
Shuì-sân-sṳ	Seosan
Sàng-nàm-sṳ	Seongnam
Suk-chhó-sṳ	Sokcho
Sṳ́-hîn-sṳ	Siheung
Ngà-sân-sṳ	Asan
Ôn-sân-sṳ	Ansan (Zuid-Korea)
Ôn-sàng-sṳ (Hôn-koet)	Anseong
Ôn-yông-sṳ	Anyang (Zuid-Korea)
Yòng-chû-sṳ	Yangju
Vû-sân-sṳ	Osan
Ngièn-chû-sṳ	Wonju
Ngi-vòng-sṳ	Uiwang
Ngi-chṳn-fú-sṳ	Uijeongbu
Li-chhôn-sṳ (Hôn-koet)	Icheon
Thî-chhôn-sṳ	Jecheon
Thiên-ôn-sṳ	Cheonan
Chhîn-chû-sṳ	Cheongju
Chhûn-chhôn-sṳ	Chuncheon
Thai-pha̍k-sṳ	Taebaek
Po-chû-sṳ	Paju
Phìn-tshe̍t-sṳ	Pyeongtaek
Phàu-chhôn-sṳ	Pocheon
Hò-nàm-sṳ	Hanam
Fà-sàng-sṳ	Hwaseong
Buckingham Kiûng	Buckingham Palace
Hói-nàm	Hainan
Ngiên-kiu	Wetenschappelijk onderzoek
Kâm-suk	Gansu
Pha̍k Se-pâu	Witte bloedcel
York	York (Verenigd Koninkrijk)
Tsiú	Elleboog
Sṳ̂n-min-ki	Deuteronomium
Sû-chû-sṳ	Suzhou (Jiangsu)
Vûn-chû-sṳ	Wenzhou
Windsor Sàng-páu	Windsor Castle
Hòn-chhu̍k	Han-Chinezen
Nèn-pô-sṳ	Ningbo
Tet-koet-ngìn	Duitsers
Ko-men	Allergie
Fù-khì	Bloedzuigers
Kîm-yùng	Financiën
1000	1000 (getal)
Mìn-su-ki	Numeri
Liu̍k Khiet-vùn	Kevin Rudd
Ngo̍k-ǹg	Krokodillen
Yùn-nàm	Yunnan
Vû-â	Corvus (geslacht)
Plymouth	Plymouth (Verenigd Koninkrijk)
Sân-tûng	Shandong
Pí	Arm (ledemaat)
Derby-sṳ	Derby (Verenigd Koninkrijk)
Thàn-khîn Fa-ha̍p-vu̍t	Koolwaterstof
Hò-nàm	Henan (China)
Montehermoso	Montehermoso
Liâu-nèn	Liaoning
El Cid	Rodrigo Díaz de Vivar
Jim Morrison	Jim Morrison
Kóng-khiéu	Haven
Thòi-vân Thò-yèn Koet-chi Kî-chhòng	Internationale luchthaven Taiwan Taoyuan
Kit-lìm	Jilin (provincie)
Fù-nàm	Hunan
Chhiâng-hói	Qinghai
Vì-ngâ-ngì-tshu̍k	Oeigoeren
Rhône-sén	Rhône (departement)
Koet-kâ Kûng-yèn	Nationaal park
Pâ-lì Charles-de-Gaulle Koet-chi Kî-chhòng	Aéroport de Paris-Charles de Gaulle
Chṳ̂-sán	Activa
O-le̍t-liòng	Aurelianus
Fù-pet	Hubei
Sân-sî	Shanxi
Hòng-khûng Kûng-sṳ̂	Luchtvaartmaatschappij
Hò-khiéu-vân	Estuarium
Chûng-set	Bruin
Kui-chû	Guizhou
Berkelland	Berkelland
Chûng-khi Sṳ̀n-kîn Ne-thúng	Centraal zenuwstelsel
Yî-fut-só	Efeze
Ôn-tha̍t-màn Hói	Andamanse Zee
Yok-sû-â-ki	Jozua (boek)
Sî-pet Yîn-kak-làn	North West England
Shám-sî-sén	Shaanxi
Tûng-pet Yîn-kak-làn	North East England
Tûng Midlands	East Midlands
Tûng Yîn-kak-làn	East of England
Tûng-nàm Yîn-kak-làn	South East England
Sî-nàm Yîn-kak-làn	South West England
模板:Commonscat	Sjabloon:Commonscat
Sî Midlands	West Midlands (regio)
Yorkshire lâu Humber	Yorkshire and the Humber
Kòn Se-pâu	Stamcel
Lò-mâ-sû	Brief van Paulus aan de Romeinen
Mâ-liuk-kap Hói-hia̍p	Straat Malakka
Yù-thai Vòng-koet	Koninkrijk Juda
Fî-yí Mî-koet Het-ngìn	Afro-Amerikanen
Mà-sat-chû-set Lî-kûng Ho̍k-yen	Massachusetts Institute of Technology
Pô-sṳ-tun Thai-ho̍k	Universiteit van Boston
Yâ-lû Thai-ho̍k	Yale-universiteit
Lû-khái-ngî	Rukai (taal)
Nàm-pet-chêu	Zuidelijke en Noordelijke Dynastieën
Liû-Sùng	Liu Song-dynastie
Fûn-lî	Bruiloft
Pan Chúng-thúng-chṳ	Semipresidentieel systeem
Fù-yì-khiùn	Buyeo
Lî-chû-sṳ	Yeoju
Fî-li̍p-pí-sû	Brief van Paulus aan de Filippenzen
Thiên-koet Pat-fuk	Acht Zaligheden (religie)
Mî-koet Lièn-pâng Chún-phi Ne-thúng	Federal Reserve
Kúai-é	Kikkers
Hâ Sî-lî-sî-â-sén	Woiwodschap Neder-Silezië
Khù-â-vì - Pô-mî-là-nì-â-sén	Woiwodschap Koejavië-Pommeren
Lû-pu-lìm-sén	Woiwodschap Lublin
Lû-pu-sṳ̂-khà-sén	Woiwodschap Lubusz
Lò-tsṳ-sén	Woiwodschap Łódź
Séu Pô-làn-sén	Woiwodschap Klein-Polen
Mâ-tsó-fû-sá-sén	Woiwodschap Mazovië
O-pô-lòi-sén	Woiwodschap Opole
Khak-ngì-pâ-yèn-sân-sén	Woiwodschap Subkarpaten
Pô-tet-là-chhia-sén	Woiwodschap Podlachië
Pô-mî-là-nì-â-sén	Woiwodschap Pommeren
Sî-lî-sî-â-sén	Woiwodschap Silezië
Sṳn-sṳ̍p-sṳ-sén	Woiwodschap Święty Krzyż
Sî Pô-mî-là-nì-â-sén	Woiwodschap West-Pommeren
Pâ-lùn-sî-â-sén	Valencia (provincie)
Sat-là-kô-sat-sén	Zaragoza (provincie)
Vùi-sṳ̂-khà-sén	Huesca (provincie)
Baak-gaa-seng	Baijiaxing
Sok-lî-â-sén	Soria (provincie)
Hien-thoi Khì-chhâ	Hyundai Motor Company
Kîm Tsang-ên	Kim Jong-un
Pu-nùng-ngî	Bunun (taal)
Kông-sî	Jiangxi
Wernher von Braun	Wernher von Braun
Nèn-ha	Ningxia
Lí Hién-liùng	Lee Hsien Loong
Kîm-fà-sṳ	Jinhua
Thòi-chû-sṳ	Taizhou (Zhejiang)
Phòng-châ-phú-ngî	Punjabi
Phú-sṳ̍p-thok-ngî	Pasjtoe
Yâ-chû	Wild zwijn
Chû-hói-sṳ	Zhuhai
Sân-thèu-sṳ	Shantou
Shâu-kûan-sṳ	Shaoguan
Kông-mùn-sṳ	Jiangmen
Chhám-kông-sṳ	Zhanjiang
Shàu-khin-sṳ	Zhaoqing
Fi-chiu-sṳ	Huizhou
Mòi-chiu-sṳ	Meizhou
San-mî-sṳ	Shanwei
Hò-ngièn-sṳ	Heyuan
Yòng-kông-sṳ	Yangjiang
Chhîn-yén-sṳ	Qingyuan
Tûng-kôn-sṳ	Dongguan
Chûng-sân-sṳ	Zhongshan (stadsprefectuur)
Chhèu-chiu-sṳ	Chaozhou
Mâ-liuk-kap-sṳ	Malakka (stad)
Khiâu-chhṳ-sṳ	George Town (Maleisië)
IPhone 5	IPhone 5
Mèu-li̍t-yen	Miaoli (xiàn)
Sṳn-chhôn-lî	Eucharistie
Fuk-chiu-sṳ	Fuzhou (Fujian)
Nàm-phìn-sṳ	Nanping
Phû-thièn-sṳ	Putian
Sâm-mìn-sṳ	Sanming
Tshièn-chiu-sṳ	Quanzhou
Hà-mûn-sṳ	Xiamen
Chông-chiu-sṳ	Zhangzhou
Liùng-ngâm-sṳ	Longyan
Nèn-tet-sṳ	Ningde
Sî-pak-li-â Fú	Siberische tijger
Buren	Buren (gemeente)
Sîn-chuk-yen	Hsinchu (xiàn)
Yáng-chhiong Chín-thôn-ho̍k	Radiologie
Rumia	Rumia
Kluczbork	Kluczbork
La̍p-tsuk	Kaars
Hiet-chiong	Bloedplasma
Southampton	Southampton (Verenigd Koninkrijk)
Lu-tet-ki	Ruth (boek)
Hâ-sat-khiet-chhu̍k	Kazachen
Yòng-mî	Echte libellen
Kô-lìm-tô-chhièn-sû	Eerste brief van Paulus aan de Korintiërs
Sî-pân-ngà Ti-koet	Spaanse Rijk
Pha̍k-yùn-khî (Kóng-chiu-sṳ)	Baiyun
Sṳ-sṳ̂-ki	Rechters
Po-lîn-chhòi	Spinazie
Pâ-set-lò-nâ-sén	Barcelona (provincie)
Nàm-thèu-yen	Nantou (xiàn)
Liuk-piên-hìn	Regelmatige zeshoek
Thòi-pet 101	Taipei 101
Lùn-tûn Thap-khiâu	Tower Bridge
Luì-kûng	Donder
Siù-li Yún-kòn-sien-chhùng	Caenorhabditis elegans
O-pô-lòi	Opole (stad)
Sopot	Sopot (Polen)
Â-sṳ̂-thù-lî-â-sṳ̂-sén Chhṳ̍t-hot-sṳ	Lijst van gemeenten in Asturië
Kám-lám-yù	Olijfolie
Chim-sin-fi	Baptisme
Lie̍t-yî-tha̍t-sén Chhṳ̍t-hot-sṳ	Lijst van gemeenten in provincie Lerida
Set-vì-li-â-sén	Sevilla (provincie)
Thap-là-kô-na̍p-sén	Tarragona (provincie)
Provence-sén	Provence (Frankrijk)
Kî-hài Kûng-chhàng	Werktuigbouwkunde
Apeldoorn	Apeldoorn (gemeente)
Lìm-pó-ngî	Limburgs
Khái-ngì-chhái	Kielce
Bytom	Bytom
Ôn-sit-ngit	Sjabbat
Khìm-sṳ̂-thok-khok-ngá	Częstochowa
Zabrze	Zabrze
Ôn-sit-ngit-fi	Zevendedagsadventisten
Jean Michel Jarre	Jean-Michel Jarre
Thai Pô-làn Thi-khî Kô-yî-fû	Gorzów Wielkopolski (stad)
Là-tô-mê	Radom (Polen)
Lo̍k-chham-ki-yen	Los Angeles County
Słupsk	Słupsk
Sosnowiec	Sosnowiec
Gliwice	Gliwice
Yo̍k-sṳ̂	Apotheker
Hi-kôn Yì-chhṳ̍t	Transplantatie
Pâ-lùn-sî-â-sén Chhṳ̍t-hot-sṳ	Lijst van gemeenten in provincie Valencia
Bielsko-Biała	Bielsko-Biała
Rybnik	Rybnik
Tân-fu̍t Se-pâu	Monocyt
Mâ-khó-fuk-yîm	Evangelie volgens Marcus
Ruda Śląska	Ruda Śląska
Yok-thán-vòng	Jotam van Juda
Thò-yèn-yen	Taoyuan (xiàn)
Nò-mí	Kleefrijst
Kîn-tû-fú	Kioto (prefectuur)
Kau-su	Professor
Thai-fán-fú	Osaka (prefectuur)
Fuk-kông-yen	Fukuoka (prefectuur)
Oi-yèn-yen	Ehime
Kô-lìm-tô-heu-sû	Tweede brief van Paulus aan de Korintiërs
Khien-mî	Bodybuilding
Chhùng-hièn	Lumbricina
Port Elizabeth	Port Elizabeth
Kimberley (Nàm-fî)	Kimberley (Noord-Kaap)
Yok-sâ-fap-vòng	Josafat
Thòi-vân Hói-hia̍p	Straat van Taiwan
Sî Khôi-phú-sén	West-Kaap
Yamaguchi-yen	Yamaguchi (prefectuur)
Khiâu-chhṳ Sâm-sṳ	George III van het Verenigd Koninkrijk
Chûng-koet Thi-fông	Chugoku
Mî-koet Thu̍k-li̍p Siên-ngièn	Amerikaanse Onafhankelijkheidsverklaring
Sâm-tshûng-yen	Mie (prefectuur)
Yù-mu̍k mìn-chhu̍k	Nomade
Hiông-pak-su	Ceder
Hî-pak-lòi-sû	Brief aan de Hebreeën
Kâ-lâ-thai-sû	Brief van Paulus aan de Galaten
Màn-é	Palingachtigen
Sông-chhèu	Shang-dynastie
Thai-thúi	Dij
Pîn-khù-yen	Hyogo (prefectuur)
Kiûng-khì-yen	Miyazaki (prefectuur)
Yùng-pún-yen	Kumamoto (prefectuur)
Fò-phìn-sṳ	Hòa Bình (Hòa Bình)
Stamford Raffles	Thomas Stamford Raffles
Sha̍m-é	Zangcicaden
Tûng Khôi-phú-sén	Oost-Kaap
Fap-koet Hòng-khûng	Air France
Kô-lò-sî-sû	Brief van Paulus aan de Kolossenzen
Ngâ-kok-sû	Brief van Jakobus
Yok-hon-yit-sû	Eerste brief van Johannes
Fî-li-mùn-sû	Brief van Paulus aan Filemon
Thiap-sat-lò-nì-kâ-heu-sû	Tweede brief van Paulus aan de Tessalonicenzen
Thiap-sat-lò-nì-kâ-chhièn-sû	Eerste brief van Paulus aan de Tessalonicenzen
Pí-tet-chhièn-sû	Eerste brief van Petrus
Thì-mô-thai-chhièn-sû	Eerste brief van Paulus aan Timoteüs
Lí Kông-yeu	Lee Kuan Yew
Chṳ̂-kâ-kô Thai-ho̍k	Universiteit van Chicago
Tsṳ̂-fo-yen	Shiga (prefectuur)
Mu-nì-het Kî-chhòng	Flughafen München Franz Josef Strauß
Yok-hon-ngi-sû	Tweede brief van Johannes
Thì-mô-thai-heu-sû	Tweede brief van Paulus aan Timoteüs
Thì-tô-sû	Brief van Paulus aan Titus
Yî-sṳ̂-lâ-ki	Ezra (boek)
Nì-hî-mí-ki	Nehemia (boek)
Pietersburg	Pietersburg
Séu Pha̍k-Lù	Kleine zilverreiger
Chhòn-ngiam-phiang	Infectieziekte
Kôn-yàm	Leverontsteking
Chhûn-chiet	Chinees nieuwjaar
Shinzō Abe	Shinzo Abe
Mpumalanga-sén	Mpumalanga
Pet Khôi-phú-sén	Noord-Kaap
Tó-kîn-yen	Shimane (prefectuur)
Kông-sân-yen	Okayama (prefectuur)
Gauteng-sén	Gauteng
Thung-fûng	Jicht
Chông-fa-yen	Changhua (xiàn)
Thai-fûn-yen	Oita (prefectuur)
Tiâu-tshí-yen	Tottori (prefectuur)
Nùng-la̍k	Chinese kalender
Kô-tî-yen	Kochi (prefectuur)
Pha̍k-hèu	Difterie
Exeter	Exeter (Verenigd Koninkrijk)
Saint Lawrence-hò	Saint Lawrence (rivier)
Limpopo-sén	Limpopo (provincie)
Kô-tén Kau-yuk	Hoger onderwijs
Sân-tá-kîn	Sandakan
Â-pí	Kota Kinabalu
Phok Kiún-fi	Park Geun-hye
Lévis	Lévis
Thòi-nàm-sṳ	Tainan (stad)
Laval (Québec)	Laval (Canada)
Charlemagne, Québec	Charlemagne (Canada)
Mâ-lòi Pô-lî-nì-sî-â Ngî-chhu̍k	Malayo-Polynesische talen
Fên-yòng-sṳ	Hengyang
Mân-chiu-tshu̍k	Mantsjoes
Zambrów	Zambrów
Doetinchem	Doetinchem (gemeente)
Zamość	Zamość
Malbork	Malbork
Groesbeek	Groesbeek
Mì-fûn	Differentiaalrekening
Ngo̍k-yòng-sṳ	Yueyang
BP	BP (oliemaatschappij)
Sú-thiàu	Friet
Yùn-lìm-yen	Yunlin
Kiok-tsṳ́	Teen
Vî-liâm Â-li̍t-sân-thai (Hò-làn)	Willem-Alexander der Nederlanden
Krasnystaw	Krasnystaw
Sî-kung-khî	Sai Kung District
Mâ-nâ-sî-vòng	Manasse van Juda
Kî-kîm-fi	Stichting
A-hîn Kôn-yàm	Hepatitis A
Yù-tsiâm-vong-khî	Yau Tsim Mong District
Fûng-sái	Kaki (plant)
Tshṳ̍t-tshòng	Endeldarm
Chhṳ-yù Pâng-sén	Vrijstaat (provincie)
Tsó-fo-yen	Saga (prefectuur)
Tet-tó-yen	Tokushima (prefectuur)
Sî-pân-ngà-ngìn	Spanjaarden
Fu̍t-chhṳ̂ Khiung-chṳn Sṳ̀n-siong	MRI-scanner
Hiông-tshon-yen	Kagawa (prefectuur)
Reading, Berkshire	Reading (Engeland)
Kâ-chû Lî-kûng Ho̍k-yen	California Institute of Technology
Vì-ngì-tshṳ-páu Thai-ho̍k	Julius Maximilians-Universiteit
Êu-kí-lî-tet Kí-hò	Euclidische meetkunde
Si̍t-kuk	Silicon Valley
Barneveld	Barneveld (gemeente)
Khiu Tha̍t-sîn	Thaksin Shinawatra
Thòi-sân-sṳ	Taishan (stad)
Kîm-kôa	Pompoen
Thai Sùn-thâ Khiùn-tó	Grote Soenda-eilanden
Elburg	Elburg (gemeente)
Doesburg	Doesburg
Sî-pet-sén	Noordwest (provincie)
Sien-thon	Lijnstuk
Kâ-ngi-yen	Chiayi (xiàn)
Vûn-tai	Gematigd klimaat
Thai-khi̍t-khièn	Tai chi
Kiok-khwá	Enkel
Hò-làn Tâi-thi Sat-khiet-sùn-ngî	Nedersaksisch
Pân-kiêu-é	Zomertortel
Tshòng-khì-yen	Nagasaki (prefectuur)
Hà-chhèu	Xia-dynastie
Chû-vì Sṳ̀n-kîn Ne-thúng	Perifeer zenuwstelsel
Lùn-tûn Thai-ho̍k	Universiteit van Londen
Kip-sú	Reeks (wiskunde)
Nelspruit	Nelspruit
Sâ-là-ye̍t-chû	Sarawak (staat)
Â-chû Thai-phìn-yòng Kîn-tsi Ha̍p-tsok Fi-ngi	APEC
Kôan-chiet-yàm	Artritis
Geldermalsen	Geldermalsen (gemeente)
Montauban	Montauban
Chhòng-sâ-sṳ	Changsha
Thai Put-lie̍t-tiên lâu Oi-ngì-làn Lièn-ha̍p Vòng-koet	Verenigd Koninkrijk van Groot-Brittannië en Ierland
Kiok-kiên	Hiel
Kûng-fûn	Centimeter
Lièn-ha̍p Hòng-khûng	United Airlines
Yen-thèu	Farynx
Hò-mí	Millimeter
Mì-mí	Micrometer (eenheid)
Khi̍t-han (Sú-ho̍k)	Limiet
Theu-fú	Tofoe
Phù-sat	Bodhisattva
Chóng-ló Kau-fi	Presbyterianisme
Hien-thoi Veloster	Hyundai Veloster
Nai-mí	Nanometer
Berlanga de Duero	Berlanga de Duero
Pâ-chûng-sṳ	Bazhong
Sâ-pâ-chû	Sabah
Nàm-nèn-sṳ	Nanning
Ngâ-li-ôn-ngìn	Ariërs
Yù-sṳn-mî-thi Koet-kâ Kûng-yèn	Yosemite National Park
Chhiâng-set	Cyaan
Ho̍k-yen	Faculteit (onderwijs)
Kô-hiùng-sṳ	Kaohsiung
Pet-mî Chhṳ-yù Mo-yi Hia̍p-ngi	Noord-Amerikaanse Vrijhandelsovereenkomst
Sû-kak-làn-ngìn	Schotten (volk)
Rustenburg	Rustenburg (Zuid-Afrika)
Yen-tsong-fui	Concert (uitvoering)
Yù-fu̍t-chû	Johor
Ngò-lò-sṳ̂ Lièn-pâng Chhṳ̍t-hot-sṳ	Federale steden van Rusland
Fì-tshu̍k	Hui (volk)
Sha̍k-sṳ	Master (graad)
Preston, Lancashire	Preston (Verenigd Koninkrijk)
Sî-tí-kâ-vòng	Sedekia
Sâm-koet	Drie Koninkrijken (China)
Chhûn-chhiû Sṳ̀-khì	Periode van Lente en Herfst
Chan-koet Sṳ̀-khì	Periode van de Strijdende Staten
Mâ-liuk-kap-chû	Malakka (staat)
Pietermaritzburg	Pietermaritzburg
Sú-vón	Pols (anatomie)
Kit-làn-tan-chû	Kelantan
Tshông-tshu̍k	Tibetanen
Pîn-sàng-chû	Penang (staat)
Blackburn	Blackburn (Lancashire)
Chûng-sin Pha̍k-hiet-khiû	Neutrofiele granulocyt
Pâng-kâ-tó	Banka (Banka-Billiton)
Phìn-chhông-khiùn	Pyeongchang
Thai-koet Koet-chi Hòng-khûng Kûng-sṳ̂	Thai Airways International
Thai Ngi̍t-pún Ti-koet	Japans Keizerrijk
Hiûng-nù	Xiongnu
Phit-li̍t-chû	Perak
Lùn-tûn Ti-koet Ho̍k-yen	Imperial College London
Tsen-sàng-sṳ	Zengcheng
Kui-lìm-sṳ	Guilin
Siet-làn-ngô-chû	Selangor
Tui-kok-sien	Diagonaal
Fi-li-phi Liuk-sṳ	Felipe VI van Spanje
Kûng-tún	Ton (massa)
Phàng-hên-chû	Pahang (staat)
中國象棋	Chinees schaken
Pit-sṳn-hak	Pizza Hut
Yim-suk Siáu-tsṳ́	Sonic the Hedgehog (personage)
Ngo̍k-vûn-khiet-tshu̍k	Evenken
Kiu-ên	Verlossing
Nàm-kîn Thai-thù-sat	Bloedbad van Nanking
Phì-mí	Picometer
Chûng-koet 2010-ngièn Sông-hói Sṳ-kie Pok-lám-fi	Expo 2010
Ngiù-ngiuk	Rundvlees
Carlisle, Cumbria	Carlisle (Verenigd Koninkrijk)
Sandomierz	Sandomierz
Ngit-tèu-kông	Zonlicht
Khwon-kûan-tsiet	Heup
Fûn-kî-hon-khiûn	Mycobacterium
Chàu-yòng-sṳ	Shaoyang
Phìn-tûng-yen	Pingtung (xiàn)
Chông-fa-sṳ	Changhua
Hién-mì-kiang	Microscoop
Chông-kâ-kie-sṳ	Zhangjiajie
Chṳ Sṳ̀n-kûng	Koxinga
Chu-chû-sṳ	Zhuzhou
Kûng-tshun	Decimeter
McGill Thai-ho̍k	McGill-universiteit
Sâm-fòng Ńg-ti	Traditionele Chinese opvatting over de oudste Chinese geschiedenis
Sanok	Sanok
Mâ-tshâ	Strijdwagen
Milton Keynes	Milton Keynes
Ên-tién	Genade (christelijk geloof)
Hî-lìn-tên-khî	Hillingdon (district)
Chṳ̂-hîn-sṳ	Zixing
Chṳ̂-yòng-sṳ	Ziyang
Sṳ̀n-chhùng	Imago (biologie)
Chang Thien-chṳ́ Fat-sa Kie-son-kî Thôn-chhèn Só-mèu	Positronemissietomografie
Przemyśl	Przemyśl
Chhiòn-khiû Sàng-sṳ	Wereldstad
Pî-mí	Femtometer
Burnley	Burnley (Lancashire)
Tûng Lùn-tûn, Tûng Khôi-phú-sén	Oos-Londen
Biała Podlaska	Biała Podlaska
Pet-hói-sṳ	Beihai
Mafikeng	Mafikeng
Mí-sâ-yên Khiùn-tó	Visayas
Lò-pô-ôn-vòng	Rechabeam
Slough	Slough
Thì-mô-thai	Timoteüs
Chho̍k-sṳ̂-lia̍p	Centromeer
Tûng-hò, Néu-yok-sṳ	East River
Chhêu-fông-hìn	Hyperkubus
Sêm-mî-làn-chû	Negeri Sembilan
Brzeg	Brzeg
Fidel Valdez Ramos	Fidel Ramos
Łomża	Łomża
Siong-thâm-sṳ	Xiangtan
Thûng-tshu̍k	Dong (volk)
Pak-fo Kûng-sṳ̂	Warenhuis (winkel)
Thòi-vân Ngièn-tshu-mìn	Taiwanese aboriginals
騷靈現象	Klopgeest
Tha̍t-vat-ngì-tshu̍k	Daur
Na̍p-sî-tshu̍k	Naxi (volk)
Kô-hiùng-yen	Kaohsiung (xiàn)
Kuî-é	Schildpadden
Pak-sâ-sat	Belsazar
Tshièn-pí	Onderarm
Yî-set-lie̍t Vòng-koet	Koninkrijk Israël
Sîn-sân-sṳ	Johor Bahru
Khiu-kîm-sân Vân	Baai van San Francisco
Li Mâ-teu	Matteo Ricci
Tshài Yîn-vùn	Tsai Ing-wen
Chełm	Chełm
Pha̍k-ngìn	Blanken
Â-ha̍p-vòng	Achab
Suwałki	Suwałki
Ngì-làn-yen	Yilan (xiàn)
Sî-làn-ngî	Zeeuws
Epe	Epe (gemeente)
Maidenhead	Maidenhead
Chû Khiet-lùn	Jay Chou
Winburg	Winburg
Kiú-liùng	Kowloon
Nâ-pô-nì-tha̍t	Nabonidus
Ngie-mí-li-ôn Lò-mâ-nok-ngî	Emiliano-Romagnolo
Sîn-pet-sṳ	Nieuw Taipei
Hî-sî-kâ-vòng	Hizkia
Thòi-chûng-sṳ	Taichung
IPhone 4S	IPhone 4S
Jędrzejów	Jędrzejów
Fâ-lièn-yen	Hualien (xiàn)
Kîm-mùn-yen	Kinmen
Thòi-tûng-yen	Taitung (xiàn)
Sîn-chuk-sṳ	Hsinchu
Kâ-ngi-sṳ	Chiayi
Kî-lùng-sṳ	Keelung
Busko-Zdrój	Busko-Zdrój (plaats)
Àu-thai-li-â Ngièn	Australische dollar
Kroonstad	Kroonstad (Zuid-Afrika)
Hon-ho̍k	Sinologie
Yî-pó-sṳ	Ipoh
Ná-pô-pha-lâ-sâ-ngì	Nabopolassar
Â-pí-ngâ-vòng	Abia van Juda
Sûn N̂g	Koninkrijk Wu
Pha̍k-chhu̍k	Bai (volk)
Pińczów	Pińczów
Aalten	Aalten (gemeente)
Xuxa	Xuxa
Ap-chû	Ap Chau
Hajnówka	Hajnówka
Lubartów	Lubartów
Montréal-tó	Île de Montréal
IPhone 3GS	IPhone 3GS
IPhone 4	IPhone 4
IPhone 3G	IPhone 3G
Alan Dawa Dolma	Alan Dawa Dolma
Tûng-Chû	Oostelijke Zhou-dynastie
Mâ-lòi-sî-â Hòng-khûng	Malaysia Airlines
Lì-tshu̍k	Li (volk)
Chûng-sî-khî (Hiông-kóng)	Central and Western District
Mí-nâ-hien-vòng	Menachem
Â-ha̍p-chhia-vòng (Yî-set-lie̍t)	Achazja van Israël
Â-ha̍p-chhia-vòng (Yù-thai)	Achazja van Juda
Yok-làn-vòng (Yù-thai)	Joram van Juda
Â-sat-li-ngâ	Uzzia
Peter Nalitch	Pjotr Nalitsj
Yâ-lò-pô-ôn yit-sṳ	Jerobeam I
Am-li-vòng	Omri
Nâ-tap-vòng	Nadab
Pâ-sâ-vòng	Basa
Yâ-fu-vòng	Jehu van Israël
Yok-sî-â-vòng	Josia
Yok-â-sṳ̂-vòng (Yù-thai)	Joas van Juda
Sîm-li-vòng	Zimri
Yâ-lò-pô-ôn ngi-sṳ	Jerobeam II
Yî-vi-mí-lò-tha̍t	Amel-marduk
Â-mâ-chhia-vòng	Amasja
Yî-sṳ̂-pô-sat-vòng	Isboset
Â-sat-vòng	Asa van Juda
Â-mùn-vòng	Amon van Juda
Chong Koet-yùng（Chong Fat-chûng）	Leslie Cheung
Lí Tên-Fî	Lee Teng-hui
Yî-lâ-vòng	Ela
Yok-ngâ-kin-vòng	Jojakim
Hò-se-â-vòng	Hosea (koning)
Yok-ngâ-kîn-vòng	Jojachin
Biłgoraj	Biłgoraj
Puławy	Puławy
Chuk Hon	Koninkrijk Shu
Chhâu Ngùi	Koninkrijk Wei
Staszów	Staszów
Mò-tóng-sit	Onafhankelijken
Iwakuni-sṳ	Iwakuni
Kâu-thûng kûng-khí	Vervoermiddel
Phok Hièn-yún	Pak Hon-yong
Sat-kâ-li-ngâ-vòng	Zecharja
Yok-ha̍p-sṳ̂-vòng	Joachaz van Israël
Fùng Siù-chhiòn	Hong Xiuquan
Yok-â-sṳ̂-vòng (Yî-set-lie̍t)	Joas van Israël
Yok-làn-vòng (Yî-set-lie̍t)	Joram van Israël
Pí-kâ-vòng	Pekach
Sâ-liùng-vòng	Sallum
Pí-kâ-hot-vòng	Pekachja
Khiu Sṳ̀n-thûng	Shing-Tung Yau
Fùng Puk-kím Kiê	Goudfazant
Grajewo	Grajewo (stad)
Sat-lâ-tshu̍k	Salar (volk)
Yok-ha̍p-sṳ-vòng	Joachaz
Łapy	Łapy
Sin-ngióng	Bruid
瑤族	Yao (volk)
Hagi-sṳ	Hagi
Wong Hi-zi	Wang Xizhi
Chûng-chhiû-chiet	Midherfstfestival
Nài-lî-kak-li-sâ-ngì	Neriglissar
Fùng-theu	Adukiboon
Łuków	Łuków
Łęczna	Łęczna
Świdnik	Świdnik
Nagato-sṳ	Nagato
Mâ-thai-fuk-yîm	Evangelie volgens Matteüs
Sṳ̍p-sṳ-ka	Kruis (christendom)
Â-chû Hòng-khûng X	AirAsia X
Â-chû Hòng-khûng	AirAsia
Yî-fut-só-sû	Brief van Paulus aan de Efeziërs
Sòng-tet-sṳ	Changde
Yit-yòng-sṳ	Yiyang
Chhim-chû-sṳ	Chenzhou
Yî-lò-khén-nok-ngî	Ilocano
Súi-nèn-sṳ	Suining
Nui-kông-sṳ	Neijiang
Tha̍t-chû-sṳ	Dazhou
Ngá-ôn-sṳ	Ya'an
Fú-kûa	Sopropo
Fún-fùng-set	Roze
Nâ-sat-le̍t	Nazareth (Israël)
Yî-tshu̍k	Yi (volk)
Â-thâ-li-ngâ	Atalja
Augustów	Augustów
Windsor, Berkshire	Windsor (Verenigd Koninkrijk)
Kô Khô-kî	Hightech (industrie)
Tai Tet-sâng	Hudson Taylor
Tczew	Tczew
Hâ-nì-tshu̍k	Hani
Thòi-nàm-yen	Tainan (xiàn)
Fù-chṳ-mìn-sṳ Kî-chhòng	Internationale Luchthaven Tân Sơn Nhất
Hien-thoi Accent	Hyundai Accent
Hien-thoi Sonata	Hyundai Sonata
Vû-tsṳ-phe̍t-khiet-chhu̍k	Oezbeken
Thap-kit-khiet-tshu̍k	Tadzjieken
Wal-Mart Kûng-sṳ̂	Walmart
Yùn-tôn yun-son	Cloud computing
Ńg-sùn-chiet Yun-thung	Pinksterbeweging
Liu̍k-theu	Mungboon
Chêu-siên-chhu̍k	Koreanen
Khúa-ngì-khiet-tsṳ-tshu̍k	Kirgiezen
Burgo de Osma-Ciudad de Osma	Burgo de Osma-Ciudad de Osma
Sông-hói Ha̍p-tsok Tsû-tsṳt	Shanghai-samenwerkingsorganisatie
Reus	Reus (Catalonië)
San Esteban de Gormaz	San Esteban de Gormaz
Hien-thoi Santa Fe	Hyundai Santa Fe
Het-mien Phî-lù	Kleine lepelaar
Sṳ̀n-chheu-fi	Assemblies of God
Fâ-tû-khî	Huadu
Sâ-â-nàm	Shah Alam (stad)
Kit-lùng-po Koet-chi Kî-chhòng	Kuala Lumpur International Airport
Ngiu̍k-Sân	Yu Shan
Hōfu-sṳ	Hofu
Thai-yí-sân	Lantau
Starogard Gdański	Starogard Gdański
Het-tsat-tshu̍k	Nanai
Sîn-chhèu	Xin-dynastie
Strzelce Opolskie	Strzelce Opolskie
Hò-làn Tâi-thi Sat-khiet-sêm-ngî	Nederlands Nedersaksisch
Kâu-thûng	Wegverkeer
Vû-yìn	Echte vliegen
Tha̍t-mâ-thai	Dalmatië (regio)
Witwatersrand Thai-ho̍k	Universiteit van de Witwatersrand
Hò-tûng-sṳ	Hà Đông (quận)
Fûng-ngièn-sṳ	Fengyuan
Pán-khièu-khî	Banqiao
Fû-lùn-pi-ngì-sṳ	Hulunbuir
Ǹg-chiu-sṳ	Wuzhou
Fòng-sàng-kóng-sṳ	Fangchenggang
Khîm-chiu-sṳ	Qinzhou
Kui-kóng-sṳ	Guigang
Ngiu̍k-lìm-sṳ	Yulin (Guangxi)
Pak-set-sṳ	Baise (China)
Fo-chiu-sṳ	Hezhou
Hò-chhṳ̀-sṳ	Hechi
Lòi-pîn-sṳ	Laibin
Fuk-thièn-khî	Futian
Chhùng-chó-sṳ	Chongzuo
Thú-kâ-tshu̍k	Tujia (volk)
Dewetsdorp	Dewetsdorp
Sîn-kie	New Territories
Khôi-phìn-sṳ	Kaiping
Mo-yi	Handel (economie)
Saam-zi-gang	Sanzijing
Kędzierzyn-Koźle	Kędzierzyn-Koźle
Duiven	Duiven (gemeente)
Yo̍k-ho̍k	Farmacie
Fi-yòng-khî	Huiyang
Kóng-tó-yen	Hiroshima (prefectuur)
Tseu-tshu̍k	Tsou (volk)
IPhone (Thi-yit thoi)	IPhone (eerste generatie)
Ye̍t-nàm-ngî sṳ-mû	Quốc ngữ
Ólvega	Ólvega
Sîn Pâ-pí-lùn Vòng-koet	Nieuw-Babylonische Rijk
Fuk-tín-sṳ	Fuding
Fung-sân-sṳ	Fengshan
Thú-ngí-khì-ngî sṳ-mû	Turks alfabet
Kien-yòng-sṳ	Jianyang (Fujian)
Shūnan-sṳ	Shunan
Skarżysko-Kamienna	Skarżysko-Kamienna
Longás	Longás
Kô-tá-ha̍p-lû-sṳ	Kota Bharu
Sú-chiuk-khiéu-phiang	Hand-, voet- en mondziekte
Kông-phú	Spectrum
Mielec	Mielec
客家	Hakka (volk)
Téu-liuk-sṳ	Douliu
Wejherowo	Wejherowo
Pu-yî-chhu̍k	Buyi
Ngì-làn-sṳ	Yilan (stad)
Ńg-fù Sṳ̍p-liuk-koet	Periode van de Zestien Koninkrijken
Néu-yok Tû-fi-khî	New York (agglomeratie)
歷峯雧團	Compagnie Financière Richemont SA
Ng̀-tshon-sṳ	Wuchuan
Thap-lùn-ti-nò-ngî	Tarantino
Lo̍k-chhîn-sṳ	Yueqing
Eu-hói-khî	Ouhai
Mâ-kûng-sṳ	Magong
Sîn-yàng-sṳ	Xinying
Thai-pó-sṳ	Taibao
Mèu-li̍t-sṳ	Miaoli
2009-ngièn sṳ-kie yun-thung-fi	Wereldspelen 2009
Thòi-chûng-yen	Taichung (xiàn)
Chhṳ̀-hâi-sṳ	Cixi (stad)
Vû-hiu-hiông	Wuqiu
Thai-lû-kok Koet-kâ Kûng-yèn	Nationaal park Taroko
Phìn-fông Kûng-lî	Vierkante kilometer
Khì-sân-tsṳ́n	Cishan (Kaohsiung)
Hak-kâ Thien-sṳ-thòi	Hakka TV
Fâ-lièn-sṳ	Hualien
Shuì-ôn-sṳ	Rui'an
Fung-fa-sṳ	Fenghua
Phìn-tûng-sṳ	Pingtung
Thòi-tûng-sṳ	Taitung (stad)
Ya̍p Â-lòi	Yap Ah Loy
Thòi-pet Tshia̍p-yun	Metro van Taipei
Chhòn-yùng Hòng-khûng	EVA Air
Kôn-yîm	Guanyin
Nàm-thèu-sṳ	Nantou (stad)
Thòi-vân nàm-tó ngî-ngièn	Formosaanse talen
Lìm-pâ Se-pâu	Lymfocyt
Phài-vân-ngî	Paiwaans
Thai-ngâ-ngî	Atayal
Thò-yèn-sṳ	Taoyuan (stad)
Lû-khái-tshu̍k	Rukai (volk)
Tseu-ngî	Tsou (taal)
Pî-nàm-ngî	Pyuma
Soi-ha-ngî	Saisiyat
Hak-kâ thú-lèu	Tulou
Kô-sîn-shì	Diku
Jarosław	Jarosław
Tûng-khî (Hiông-kóng)	Eastern District
Â-chû Thien-sṳ Yû-han Kûng-sṳ̂ (Hiông-kóng)	Asia Television Limited
Ostrowiec Świętokrzyski	Ostrowiec Świętokrzyski
Tshiâ-tshu̍k	She (volk)
Sîn-kâ-po Koet-li̍p Thai-ho̍k	Nationale Universiteit van Singapore
Sên-sán	Productie
Chojnice	Chojnice
Bronckhorst	Bronckhorst
Thi-kip-sṳ	Stadsprefectuur
Mine-sṳ	Mine (Yamaguchi)
Mì-fûn-ho̍k	Differentiaal
Tûng-hiông-tshu̍k	Dongxiang
Lâ-fú-tshu̍k	Lahu
Włodawa	Włodawa
Starachowice	Starachowice
Stalowa Wola	Stalowa Wola
Chat-ho̍k Pok-sṳ	Doctor of Philosophy
Lì-tó-khî	Islands District
Ermelo	Ermelo (gemeente)
Thông-phûng	Bijen en hommels
Tshûng-shîn-yen	Okinawa (prefectuur)
Tshòng-lo̍k-sṳ	Changle
Sâm-súi-khî	Sanshui
Nàm-thin-sṳ	Nam Định (stad)
Końskie	Końskie
Luceni	Luceni
Fà-khièu	Overzeese Chinezen
Tshṳ-tshṳ-chû	Autonome prefectuur
Medway	Medway (Engeland)
Pó-ôn-khî	Bao'an
Pet-liù-sṳ	Beiliu
Nysa, Pô-làn	Nysa (Polen)
Belver de Cinca	Belver de Cinca
Culemborg	Culemborg
Kôan-tan-sṳ	Kuantan
Sokółka	Sokółka
Hikari-sṳ	Hikari
Krosno	Krosno
Kûng-lî	Kilometer
Almarza	Almarza
Aldealices	Aldealices
Aldealafuente	Aldealafuente
Alentisque	Alentisque
Adradas	Adradas
Alconaba	Alconaba
Abejar	Abejar
Aldealpozo	Aldealpozo
Alcubilla de las Peñas	Alcubilla de las Peñas
Aldealseñor	Aldealseñor
Alcubilla de Avellaneda	Alcubilla de Avellaneda
Covaleda	Covaleda
Almazul	Almazul
Arcos de Jalón	Arcos de Jalón
Aldehuela de Periáñez	Aldehuela de Periáñez
Almenar de Soria	Almenar de Soria
Vinuesa	Vinuesa
Duruelo de la Sierra	Duruelo de la Sierra
San Leonardo de Yagüe	San Leonardo de Yagüe
Vú-Chû	Wu Zhou-dynastie
Shâu-sân-sṳ	Shaoshan
梅縣話	Meixianhua
Tai-tshu̍k	Dai (volk)
Mùn-pâ-tshu̍k	Monpa
Kudamatsu-sṳ	Kudamatsu
Kiong-tshu̍k	Qiang
Afrikaner-ngìn	Afrikaners
Sâ-thèu-kok	Sha Tau Kok
Yîn-koet-ngìn	Britten (volk)
Ngá-tshu̍k	Wa (volk)
Brummen	Brummen (gemeente)
Kûng-yîn	Hectometer
Fû-yûng-sṳ	Seremban
Jasło	Jasło
Bielsk Podlaski	Bielsk Podlaski
Beuningen	Beuningen (Gelderland)
Thú-tshu̍k	Tu (volk)
Kîn-mí	Gigameter
Sîn-lòng	Bruidegom
Pân-kap	Gespikkelde duif
Súi-tshu̍k	Shui
Nyet-láu-tshu̍k	Gelao
Li̍t-siuk-tshu̍k	Lisu
Vì-kî Pak-khô Ngî-ngièn Lie̍t-péu	Lijst van Wikipedia's
Siên-pî-chhu̍k	Xianbei
Sanyo-Onoda-sṳ	Sanyo-Onoda
Petrusburg	Petrusburg
Billingham	Billingham
Pet-khî (Hiông-kóng)	North District (Hongkong)
Sî-sûng-pán-na̍p Thài-tshu̍k Tshṳ-tshṳ-chû	Dai autonome prefectuur Xishuangbanna
Kôn-thòng-khî	Kwun Tong District
Khwûi-tshiâng-khî	Kwai Tsing
Phù-mí-tshu̍k	Pumi (volk)
Thai-pu-khî	Tai Po District
Vòng-thai-siên-khî	Wong Tai Sin District
Pâ-thìn-khiùn	Ba Đình (Hanoi)
Bracknell Sêm-lìm	Bracknell Forest
Tomaszów Lubelski	Tomaszów Lubelski
Thiên-hò-khî	Tianhe
Hrubieszów	Hrubieszów
Druten	Druten
Nàm-hiùng-sṳ	Nanxiong
Hói-nàm-fa	Hainanhua
Sun-tet-khî	Shunde
Dębica	Dębica (stad)
Fân-nyî-khî	Panyu
Québec-ngìn Tóng	Parti Québécois
Grahamstown	Grahamstad
Cape Town Thai-ho̍k	Universiteit van Kaapstad
Sasolburg	Sasolburg
Daniele Suzuki	Daniele Suzuki
Kraśnik	Kraśnik
Dęblin	Dęblin
Radzyń Podlaski	Radzyń Podlaski
Kiú-liùng-sàng-khî	Kowloon City District
Nàm-khî (Hiông-kóng)	Southern District
Vân-chái-khî	Wan Chai
Prudnik	Prudnik
Villanueva de Sigena	Villanueva de Sigena
Stockton-on-Tees	Stockton-on-Tees (Engeland)
Bultfontein	Bultfontein
Lo̍k-mâ-chû	Lok Ma Chau
Wokingham	Wokingham (stad)
Kô-lò-sî	Kolosse
Lò-fù-khî	Luohu
Yàm-thièn-khî	Yantian
Khiâm-nàm Pu-yî-tshu̍k Mèu-tshu̍k Tshṳ-tshṳ-chû	Autonome Buyei & Miao prefectuur Qiannan
Lìm-ha Fì-tshu̍k Tshṳ-tshṳ-chû	Autonome Hui Prefectuur Linxia
Liùng-kông-khî	Longgang (district)
Middelburg, Tûng Khôi-phú-sén	Middelburg (Oost-Kaap)
Graaff-Reinet	Graaff-Reinet (stad)
Orania	Orania (Zuid-Afrika)
Yì-yâu-sṳ	Yuyao
Â-pa Chhong-chhu̍k Kiông-chhu̍k Chhṳ-chhṳ-chû	Autonome Tibetaanse & Qiang Prefectuur Ngawa
Welkom	Welkom (Vrijstaat)
Vú-mîn-yen	Arrondissement Wuming
Hoedspruit	Hoedspruit
Lìm-ôn-sṳ	Lin'an
Vryheid	Vryheid
Swellendam	Swellendam (stad)
Kwun-lò-sṳ	Miluo
Nàm-hói-khî	Nanhai
Tû-kông-yén-sṳ	Dujiangyan
Sîn-fi-khî	Xinhui
Tshiùng-fa-sṳ	Conghua
Lièn-sân Chong-chhu̍k Yâu-chhu̍k Chhṳ-chhṳ-yen	Lianshan Zhuang en Yao Autonoom Arrondissement
Lo̍k-tshông-sṳ	Lechang
Lièn-chiu-sṳ	Lianzhou
Kô-yêu-sṳ	Gaoyao
Hîn-nèn-sṳ	Xingning
Ho̍k-sân-sṳ	Heshan
Yòng-chhûn-sṳ	Yangchun
Thùng-ôn-khî	Tong'an (Fujian)
Liùng-hói-sṳ	Longhai
Sa̍k-sṳ̂-sṳ	Shishi
Mên-hêu-yen	Minhou
Lìm-siong-sṳ	Linxiang
Liù-yòng-sṳ	Liuyang (stad)
Tsàu-vú-sṳ	Shaowu
Kien-tet-sṳ	Jiande
Tshîn-hói-khî	Chenghai
Yîn-tet-sṳ	Yingde
Sṳ̍p-fong-sṳ	Shifang
Vi	Maag
Liùng-hâ	Zeekreeften
Pak-van-mí	Megameter
Chhém-hâi-sṳ	Cenxi
Ngo̍k-lùn-tshùn-tshu̍k	Oroqen
Sî-Chû	Westelijke Zhou-dynastie
Sî-Hon	Westelijke Han-dynastie
Chhùng-chû-sṳ	Chongzhou
Christiana (Nàm-fî)	Christiana (Zuid-Afrika)
Thaai-phin-cang-ziu	Taipingqingjiao
Mí-nàm-kâ-pó-ngìn	Minangkabau
Tûng-Hon	Oostelijke Han-dynastie
Tân-yit kón-lî-khî	Unitary authority
Hiông-kóng Thit-sṳ-nì Lo̍k-yèn Thu-ká-khî	Hong Kong Disneyland Resort
Mòi-yen	Meixian
Mièn-chuk-sṳ	Mianzhu
Kô-chiu-sṳ	Gaozhou
Khiûng-lôi-sṳ	Qionglai
Si-fi-sṳ	Sihui
Ngièu-phìn-yen	Raoping
Àu-choi Fôn	Zadelbekooievaar
Kî-chhòng	Vliegveld
Tsen-zi-wun	Qianziwen
Yen	Arrondissement (China)
Sé-kiok-lî	Voetwassing
Lièn-nàm Yâu-chhu̍k Chhṳ-chhṳ-yen	Liannan Yao Autonoom Arrondissement
Chûng-koet Ngò-lò-sṳ̂-tshu̍k	Russische minderheid in China
Windsor lâu Maidenhead	Windsor and Maidenhead
Tsung Kâ-Hiûn	Linda Chung Ka-Yan
Kien-eu-sṳ	Jian'ou
Lìm Tan	Lin Dan
分類:Tet-koet	Categorie:Duitsland
分類:Yi-thai-li	Categorie:Italië
分類:Kâ-nâ-thai	Categorie:Canada
分類:Sî-pân-ngà	Categorie:Spanje
分類:Chûng-koet	Categorie:China
分類:Ngi̍t-pún	Categorie:Japan
分類:Àu-thai-li-â	Categorie:Australië
分類:Yin-thu	Categorie:India
分類:Yî-set-lie̍t	Categorie:Israël
分類:Nàm-fî	Categorie:Zuid-Afrika
Redcar and Cleveland	Redcar and Cleveland
分類:Yin-thu-nì-sî-â	Categorie:Indonesië
分類:Pâ-kî-sṳ̂-thán	Categorie:Pakistan
分類:Pô-làn	Categorie:Polen
分類:Sîn-kâ-po	Categorie:Singapore
分類:Hòn-koet	Categorie:Zuid-Korea
分類:Thai-koet	Categorie:Thailand
分類:Ye̍t-nàm	Categorie:Vietnam
分類:Phú-nen-lui	Categorie:Zoogdier
分類:Tiâu	Categorie:Vogel
分類:Chhṳ̍t-vu̍t	Categorie:Plant
分類:Vu̍t-lí-ho̍k	Categorie:Natuurkunde
分類:Chhṳ-yèn Khô-ho̍k	Categorie:Natuurwetenschappen
分類:Sâng-vu̍t-ho̍k	Categorie:Biologie
分類:Fa-ho̍k	Categorie:Scheikunde
分類:Li̍t-sṳ́	Categorie:Geschiedenis
分類:Thi-lî	Categorie:Geografie
分類:Sa-fi	Categorie:Mens en maatschappij
分類:Chûng-kau	Categorie:Religie
分類:Thí-yuk	Categorie:Sport
分類:Khô-ho̍k	Categorie:Wetenschap
分類:Lièn-ha̍p-koet	Categorie:Verenigde Naties
分類:Êu-chû Lièn-mèn	Categorie:Europese Unie
分類:Kien-chuk-vu̍t	Categorie:Bouwwerk
分類:Thûng-sin	Categorie:Communicatie
分類:Thi-khiù	Categorie:Aarde
Sî Berkshire	West Berkshire
Hiông-kóng Thiet-lu Yû-han Kûng-sṳ̂	MTR Corporation
Zuera	Zuera
Langa del Castillo	Langa del Castillo
Contamina	Contamina
Louis Trichardt	Louis Trichardt
Abiego	Abiego
Abanto	Abanto
Kú Lò-mâ	Oude Rome
La Fueva	La Fueva
Tsui-heu ke Sṳ́m-phan	Dag des oordeels
Song-yâu-tshûn	Sheung Yiu Tsuen
Greenwich Thai-ho̍k	Universiteit van Greenwich
Eston	Eston
Middelburg, Mpumalanga-sén	Middelburg (Mpumalanga)
Yok-hon-nì-sṳ̂-páu Thai-ho̍k	Universiteit van Johannesburg
分類:Chet-ho̍k	Categorie:Filosofie
分類:Fu̍t-kau	Categorie:Boeddhisme
分類:Kî-tuk-kau	Categorie:Christendom
分類:Yù-thai-kau	Categorie:Jodendom
Hoopstad	Hoopstad
Ên-tiâu	Arend (roofvogel)
Yî-kín-vân	Discovery Bay (Hongkong)
Wesselsbron	Wesselsbron
Hò-sṳ̂n	Milliliter
Bochotnica	Bochotnica
Trompsburg	Trompsburg
Jagersfontein	Jagersfontein
Reddersburg	Reddersburg
Zung-kok tsen-thung zit-nit	Feestdagen in de Volksrepubliek China en Taiwan
Viljoenskroon	Viljoenskroon
Jacobsdal	Jacobsdal
香港客家話	Hongkong-Hakka
Bothaville	Bothaville
Brandfort	Brandfort
Theunissen	Theunissen
分類:Hàng-sên	Categorie:Planeet
分類:Vùn-fa	Categorie:Cultuur
分類:Ngìn-vùn Khô-ho̍k	Categorie:Geesteswetenschappen
Chṳ́-set	Paars
Edenburg	Edenburg
Hennenman	Hennenman
Odendaalsrus	Odendaalsrus
Hiông (Thòi-vân)	Onderdistrict (Indonesië)
Ap-è	Eenden
Lù-tshṳ̀	Aalscholvers
分類:Yên-yèn	Categorie:Acteur
模板:Tl	Sjabloon:Tl
模板:Userbox	Sjabloon:Gebruikersbox
Lu̍k-Kiáng	Luk Keng Chan Uk
模板:Wikipedialang	Sjabloon:Hoofdpagina - andere talen
分類:Koet-kâ	Categorie:Land
Wikipedia:Kón-lî-yèn	Wikipedia:Moderator
分類:Chûng-fà Mìn-chhu̍k	Categorie:Volk in China
分類:Ngìn-vu̍t	Categorie:Persoon
分類:Mìn-chhu̍k	Categorie:Volk
Wikipedia:Hàng-tsṳn-yèn	Wikipedia:Bureaucraat
Wikipedia:Kî-hi-ngìn	Wikipedia:Bots
分類:Sṳ̀-kiên	Categorie:Tijd
分類:Chhṳ-yèn	Categorie:Natuur
分類:Kûng-chhàng	Categorie:Engineering
分類:Yî-ho̍k	Categorie:Geneeskunde
分類:Chṳn-chṳ	Categorie:Politiek
分類:Kau-yuk	Categorie:Onderwijs
分類:Kông-ho̍k	Categorie:Optica
Âi-khi̍p	Egypte (land)
分類:Chat-ho̍k-kâ	Categorie:Filosoof
模板:Bot	Sjabloon:Bot
Kâ-nâ-thai	Canada
分類:Hiûng-ngà-li	Categorie:Hongarije
分類:Hî-lia̍p	Categorie:Griekenland
分類:Lâ-thot-vì-â	Categorie:Letland
分類:Yù-hi	Categorie:Spel
Thiên-koet	Hemel
分類:Êu-chû koet-kâ	Categorie:Land in Europa
分類:Êu-chû	Categorie:Europa
模板:Documentation	Sjabloon:Sjabdoc
Wikipedia:Yung-fu	Help:Overzicht van soorten Wikipediagebruikers
Pok-sṳ	Doctor
Wikipedia:Sa-khî	Portaal:Gebruikersportaal
分類:Wikipedians by language	Categorie:Wikipedia:Babel
Khi-néu Kî-chhòng	Hub (luchthaven)
Khî-ngia̍p	Bedrijf
Ngiuk-yèn	Gehaktbal
模板:Softredirect	Sjabloon:Softredirect
模板:Delete	Sjabloon:Nuweg
分類:Ngî-ngièn	Categorie:Taal
Wikipedia:Chhóng-kien Sîn Thiàu-muk	Help:Nieuwe pagina aanmaken
分類:還無索引嘅頁面	Categorie:Wikipedia:Niet te indexeren pagina's
分類:含有損壞文件鏈接嘅頁面	Categorie:Wikipedia:Pagina's met onjuiste bestandsverwijzingen
模板:Navbox	Sjabloon:Navigatie
Pak-ha̍p-fâ	Lelie (geslacht)
模板:!-	Sjabloon:!-
模板:Tnavbar	Sjabloon:Tnavbar
模板:Unicode	Sjabloon:Unicode
模板:Smallcaps	Sjabloon:Sc
模板:Nowrap	Sjabloon:Nowrap
分類:Fî-chû	Categorie:Afrika
分類:Chhṳ-yù Pâng-sén	Categorie:Vrijstaat
分類:Tûng Khôi-phú-sén	Categorie:Oost-Kaap
分類:Gauteng-sén	Categorie:Gauteng
分類:KwaZulu-Natal-sén	Categorie:KwaZoeloe-Natal
分類:Mpumalanga-sén	Categorie:Mpumalanga
分類:Pet Khôi-phú-sén	Categorie:Noord-Kaap
分類:Sṳn-kîn	Categorie:Bijbel
分類:Limpopo-sén	Categorie:Limpopo
分類:Sî Khôi-phú-sén	Categorie:West-Kaap
分類:Sî-pet-sén	Categorie:Noordwest
分類:Si	Categorie:Boek
模板:Pâ-phe̍t	Sjabloon:Babel
模板:Reflist	Sjabloon:References
模板:Stub	Sjabloon:Beginnetje
模板:User ca-1	Sjabloon:Gebruiker ca-1
模板:User de	Sjabloon:Gebruiker de
模板:User de-1	Sjabloon:Gebruiker de-1
模板:User en-3	Sjabloon:Gebruiker en-3
模板:User en-1	Sjabloon:Gebruiker en-1
模板:User en-2	Sjabloon:Gebruiker en-2
模板:User en-4	Sjabloon:Gebruiker en-4
模板:User en	Sjabloon:Gebruiker en
模板:User de-2	Sjabloon:Gebruiker de-2
分類:Yî-chhiu	Categorie:Heelal
模板:User fr-2	Sjabloon:Gebruiker fr-2
模板:User ja-1	Sjabloon:Gebruiker ja-1
模板:User fr	Sjabloon:Gebruiker fr
模板:Location map/Info	Sjabloon:Positiekaart/info
分類:Khûn-chhùng	Categorie:Insect
分類:Â-chû	Categorie:Azië
分類:Chṳ-li	Categorie:Chili
分類:Sok-lî-â-sén	Categorie:Soria (provincie)
分類:Nàm-mî-chû	Categorie:Zuid-Amerika
分類:Khà-sṳ̂-tì-li-â lâu Lòi-ngong	Categorie:Castilië en León
分類:Mâ-lòi-sî-â	Categorie:Maleisië
分類:Sṳ̍t-phín	Categorie:Voedsel
模板:Mod	Sjabloon:Modulo
模板:User es-2	Sjabloon:Gebruiker es-2
模板:Fôn-ngiàng	Sjabloon:Hola
分類:Thiàu-mi-liau	Categorie:Condiment
分類:Chû-chṳt	Categorie:Organisatie
分類:Ngî-ngièn-ho̍k	Categorie:Taalkunde
模板:ITA	Sjabloon:IT
模板:非洲行政區劃	Sjabloon:Navigatie landen Afrika
模板:SVK	Sjabloon:SK
模板:Infobox Country	Sjabloon:Infobox land
模板:TUR	Sjabloon:TUR
分類:User en-4	Categorie:Wikipedia:Gebruiker en-4
分類:User en	Categorie:Wikipedia:Gebruiker en
分類:User zh	Categorie:Wikipedia:Gebruiker zh
分類:User zh-N	Categorie:Wikipedia:Gebruiker zh-M
分類:User en-2	Categorie:Wikipedia:Gebruiker en-2
模板:User zh	Sjabloon:Gebruiker zh
模板:Cite web	Sjabloon:Citeer web
分類:Hòng-khûng	Categorie:Luchtvaart
分類:Yím-sṳ̍t	Categorie:Voeding
模板:Fong-wui	Sjabloon:Navigatie windstreken
模板:BS3	Sjabloon:SP3
分類:Tsúng-thúng	Categorie:President
模板:IPA	Sjabloon:IPA
分類:Chṳn-chṳ Ngìn-lui	Categorie:Politicus
分類:Mî-chû	Categorie:Amerika
模板:其他	Sjabloon:Zie dp
分類:Language user templates	Categorie:Wikipedia:Sjablonen babel
模板:User language-N	Sjabloon:BabelM
Wikipedia:GNU自由文檔協議證書	Wikipedia:GNU Free Documentation License
模板:大洋洲行政區劃	Sjabloon:Navigatie landen en gebieden Oceanië
分類:Vùn-ho̍k-kâ	Categorie:Schrijver
分類:Kiûn-sṳ	Categorie:Krijgswezen
分類:Thai-ho̍k	Categorie:Universiteit
分類:Sṳ-kie Pok-lám-fi	Categorie:Wereldtentoonstelling
模板:Documentation subpage	Sjabloon:Sjabdoc direct
分類:Fu̍k-tsông	Categorie:Boeddhistisch monnik
模板:FIN	Sjabloon:FI
模板:Purge	Sjabloon:Purge
模板:DNK	Sjabloon:DK
模板:Provinces of China	Sjabloon:Navigatie bestuurlijke indeling China
模板:Userpage	Sjabloon:Gebruikerspagina
模板:DEU	Sjabloon:DE
模板:SWE	Sjabloon:SE
模板:User language-4	Sjabloon:Babel4
分類:Ye̍t-nàm kî-chhòng	Categorie:Vliegveld in Vietnam
分類:Kûng-sṳ̂	Categorie:Bedrijf
模板:User fr-3	Sjabloon:Gebruiker fr-3
模板:JPN	Sjabloon:JP
分類:Thien-nó	Categorie:Computer
模板:MKD	Sjabloon:MK
模板:LTU	Sjabloon:LT
分類:Sṳ-chhòng	Categorie:Markt
Mô-li-ngìn	Maori (volk)
模板:Disambig	Sjabloon:Dp
分類:Hàng-thung Thien-fa	Categorie:Mobiele telefoon
模板:GRC	Sjabloon:GR
模板:CZE	Sjabloon:CZ
分類:Chhòn-ngiam-phiang	Categorie:Infectieziekte
分類:Sîn-kau	Categorie:Protestantisme
模板:GBR	Sjabloon:GB
分類:Sâng-vu̍t	Categorie:Organisme
模板:SVN	Sjabloon:SI
模板:FRA	Sjabloon:FR
模板:User pt-2	Sjabloon:Gebruiker pt-2
分類:Kâ-li-sî-â	Categorie:Galicië
模板:歐洲行政區劃	Sjabloon:Navigatie landen Europa
分類:User yue	Categorie:Wikipedia:Gebruiker yue
分類:User fr	Categorie:Wikipedia:Gebruiker fr
分類:User ja	Categorie:Wikipedia:Gebruiker ja
分類:User pt	Categorie:Wikipedia:Gebruiker pt
分類:User nl-3	Categorie:Wikipedia:Gebruiker nl-3
分類:User fr-2	Categorie:Wikipedia:Gebruiker fr-2
分類:User ja-2	Categorie:Wikipedia:Gebruiker ja-2
分類:User ko-N	Categorie:Wikipedia:Gebruiker ko-M
分類:User fr-N	Categorie:Wikipedia:Gebruiker fr-M
分類:Vùn-sṳ	Categorie:Schriftsysteem
分類:Tho-kau	Categorie:Taoïsme
分類:User ca	Categorie:Wikipedia:Gebruiker ca
分類:User ca-1	Categorie:Wikipedia:Gebruiker ca-1
分類:User de	Categorie:Wikipedia:Gebruiker de
分類:User de-2	Categorie:Wikipedia:Gebruiker de-2
分類:User de-N	Categorie:Wikipedia:Gebruiker de-M
分類:User en-3	Categorie:Wikipedia:Gebruiker en-3
分類:User en-N	Categorie:Wikipedia:Gebruiker en-M
分類:User es	Categorie:Wikipedia:Gebruiker es
分類:User es-2	Categorie:Wikipedia:Gebruiker es-2
分類:User es-N	Categorie:Wikipedia:Gebruiker es-M
分類:Hiông-kóng Thi-lî	Categorie:Geografie van Hongkong
分類:Yî-set-lie̍t kiûn-vòng	Categorie:Koning van Israël
分類:Yù-thai kiûn-vòng	Categorie:Koning van Juda
分類:Kí-hò-ho̍k	Categorie:Meetkunde
模板:Ye̍t-nàm	Sjabloon:Navigatie provincies Vietnam
分類:User ja-1	Categorie:Wikipedia:Gebruiker ja-1
分類:User ko	Categorie:Wikipedia:Gebruiker ko
分類:Lièn-ha̍p-koet Pi-sû-chóng	Categorie:Secretaris-generaal van de Verenigde Naties
分類:Hói-yòng	Categorie:Zee
分類:Ido-ngî	Categorie:Ido
模板:LUX	Sjabloon:LU
分類:Thai-yòng-ne	Categorie:Zonnestelsel
分類:Chhîn-su̍k Ne-thúng	Categorie:Verwantschap
分類:Kóng-tûng-sén	Categorie:Guangdong
分類:Fuk-kian	Categorie:Fujian
分類:Koet-chi Chû-chṳt	Categorie:Internationale organisatie
分類:Fat-mìn-kâ	Categorie:Uitvinder
分類:Yím-liau	Categorie:Drank
分類:Sa-fi Khô-ho̍k	Categorie:Sociale wetenschap
分類:Mî-koet Koet-kâ Kûng-yèn	Categorie:Nationaal park van de Verenigde Staten
分類:Kô-tén Kau-yuk	Categorie:Hoger onderwijs
分類:Thi-hìn	Categorie:Landvorm
分類:Pâ-lùn-sî-â Chhṳ-chhṳ-khî	Categorie:Valencia (autonome gemeenschap)
模板:User ja-2	Sjabloon:Gebruiker ja-2
分類:Thiên-chú-kau	Categorie:Katholicisme
分類:User yue-N	Categorie:Wikipedia:Gebruiker yue-M
分類:Yîm-ngo̍k-kâ	Categorie:Musicus
模板:Lang	Sjabloon:Lang
分類:Fa-kâ	Categorie:Kunstschilder
分類:Yin-thu chûng-kau	Categorie:Religie in India
模板:CYP	Sjabloon:CY
分類:Yin-thu Thi-lî	Categorie:Geografie van India
分類:Sông-ngia̍p	Categorie:Handel
分類:Fap-koet fòng-ti	Categorie:Keizer der Fransen
模板:EST	Sjabloon:EE
模板:AUT	Sjabloon:AT
分類:Meu-khô	Categorie:Katachtige
分類:Thòi-vân Thi-lî	Categorie:Geografie van Taiwan
模板:User zh-3	Sjabloon:Gebruiker zh-3
模板:User zh-4	Sjabloon:Gebruiker zh-4
分類:Nì-pok Thi-lî	Categorie:Geografie van Nepal
分類:Thai-khûng-ngìn	Categorie:Ruimtevaarder
分類:Khî-ngia̍p-kâ	Categorie:Persoon uit het bedrijfsleven
分類:Fî-li̍t-pîn	Categorie:Filipijnen
分類:User nl	Categorie:Wikipedia:Gebruiker nl
分類:User zh-1	Categorie:Wikipedia:Gebruiker zh-1
分類:User zh-4	Categorie:Wikipedia:Gebruiker zh-4
分類:User zh-3	Categorie:Wikipedia:Gebruiker zh-3
分類:User zh-2	Categorie:Wikipedia:Gebruiker zh-2
分類:Yin-thu kiûn-chú	Categorie:Indiaas heerser
分類:Ho̍k-vi	Categorie:Academische titulatuur
分類:Kîm-yùng	Categorie:Financiering
分類:Thien-sṳ	Categorie:Televisie
分類:Chhòn-kau-sṳ	Categorie:Missionaris
分類:Hói-hia̍p	Categorie:Zeestraat
粵語	Kantonees
分類:Yin-Êu Ngî-ne	Categorie:Indo-Europese taalfamilie
分類:Kî-chhòng	Categorie:Vliegveld
分類:Fa-ho̍k ngièn-su	Categorie:Chemisch element
分類:Khô-ho̍k-kâ	Categorie:Wetenschapper
分類:Pâ-kî-sṳ̂-thán Thi-lî	Categorie:Geografie van Pakistan
分類:Kî-tuk-kau lî-ngì	Categorie:Liturgie
分類:Nì-pok	Categorie:Nepal
分類:Thòi-vân	Categorie:Taiwan
分類:Chûng-koet chhèu-thoi	Categorie:Chinese dynastie
分類:Pet-mî-chû koet-kâ	Categorie:Land in Noord-Amerika
分類:Sṳ-tshòi	Categorie:Groente
分類:Súi-kó	Categorie:Fruit
分類:Khiu-yok Sṳn-kîn	Categorie:Oude Testament
分類:Pok-vu̍t-kón	Categorie:Museum
分類:Hì-hèu	Categorie:Klimaat
分類:Â-chû Thi-lî	Categorie:Geografie van Azië
分類:Ngìn-lui-ho̍k	Categorie:Antropologie
分類:Thai-khûng Chhàm	Categorie:Ruimtestation
分類:Fap-koet Thai-ho̍k	Categorie:Franse universiteit
模板:ESP	Sjabloon:ES
分類:Thung-vu̍t	Categorie:Dierenrijk
分類:Ngî-yîm-ho̍k	Categorie:Fonetiek
分類:Hòng-khûng Kûng-sṳ̂	Categorie:Luchtvaartmaatschappij
分類:Ngìn-khièn	Categorie:Mensenrechten
分類:Ngo̍k-hi	Categorie:Muziekinstrument
分類:Ngî-ne	Categorie:Taal naar indeling
分類:Hon-sṳ	Categorie:Chinees schrift
分類:Pó-sa̍k	Categorie:Edelsteen
分類:Koet-kâ Kûng-yèn	Categorie:Nationaal park
分類:Hi-siong-ho̍k	Categorie:Meteorologie
分類:Chûng-mî-chû	Categorie:Midden-Amerika
分類:Hiông-kóng	Categorie:Hongkong
分類:Kóng-sî-sén	Categorie:Guangxi
分類:Yên-liau	Categorie:Brandstof
分類:Sông-hói	Categorie:Shanghai
分類:Sin-sit kî-su̍t	Categorie:Informatietechnologie
分類:Ngiuk-lui	Categorie:Vlees
分類:Yo̍k-ho̍k	Categorie:Farmacie
分類:Sú-tû	Categorie:Hoofdstad
分類:Nàm-Â	Categorie:Zuid-Azië
分類:Kham-thap-pu-lî-â	Categorie:Cantabrië
分類:Â-sṳ̂-thù-lî-â-sṳ̂-sén	Categorie:Asturië
分類:Kîm-su̍k	Categorie:Metaal
分類:Thòi-pet-sṳ	Categorie:Taipei
分類:Lò-màn Ngî-chhu̍k	Categorie:Romaanse taal
分類:Kâu-thûng	Categorie:Vervoer
分類:Ngiên-kiu	Categorie:Onderzoek
分類:Thông-lui	Categorie:Koolhydraat
分類:Fòng-ti	Categorie:Keizer
分類:Nàm-tó ngî-hì	Categorie:Austronesische taalfamilie
分類:Pet-mî-chû	Categorie:Noord-Amerika
分類:Kô-sú	Categorie:Zanger
分類:Si-chhòng	Categorie:Tibet
分類:Sú-ho̍k-kâ	Categorie:Wiskundige
分類:Vu̍t-lî ho̍k-kâ	Categorie:Natuurkundige
分類:Kîn-chi ho̍k-kâ	Categorie:Econoom
分類:Mìn-tsú	Categorie:Democratie
分類:Kî-tuk-kau Li̍t-sṳ́	Categorie:Geschiedenis van het christendom
分類:Àu-mûn	Categorie:Macau
分類:Hàng-sên-ne	Categorie:Planetenstelsel
分類:Hiông-kóng pan-tó	Categorie:Hongkongs eiland
分類:Thòi-vân ngî-ngièn	Categorie:Taal in Taiwan
分類:Khiù-lui Yun-thung	Categorie:Balsport
分類:Ngiùn-hòng	Categorie:Bank
Fu̍k-vu	Dienst (economie)
分類:Chûng-fà Ngìn-mìn Khiung-fò-koet	Categorie:Volksrepubliek China
分類:Kâ-thai-lò-nì-â	Categorie:Catalonië
分類:Khien-không	Categorie:Gezondheid
分類:User zh-classical-2	Categorie:Wikipedia:Gebruiker zh-wen-2
Trojany	Trojany (Mazovië)
分類:Â-chû koet-kâ	Categorie:Land in Azië
模板:Chûng-fà Mìn-chhu̍k	Sjabloon:Navigatie volkeren China
模板:MLT	Sjabloon:MT
模板:User zh-classical-2	Sjabloon:Gebruiker zh-wen-2
分類:Hak-kâ	Categorie:Hakka
分類:Kûng-yèn	Categorie:Park
分類:Thòi-vân Ngiùn-hòng	Categorie:Taiwanese bank
分類:Thòi-vân ngièn-tshu-mìn ngî-ngièn	Categorie:Formosaanse taalfamilie
分類:Nàm-Â Thi-lî	Categorie:Geografie van Zuid-Azië
分類:Si-chhòng Thi-lî	Categorie:Geografie van Tibet
分類:Nui-mùng-kú Tshṳ-tshṳ-khî	Categorie:Binnen-Mongolië
分類:Kôn-thòng-khî	Categorie:Kwun Tong (district)
分類:Lâ-tên Mî-chû	Categorie:Latijns-Amerika
分類:Chûng-fà Mìn-koet	Categorie:Republiek China
分類:Siak-khiet-kau	Categorie:Sikhisme
分類:Sa-fi Mìn-tsú Tsú-ngi	Categorie:Sociaaldemocratie
模板:BEL	Sjabloon:BE
分類:Vùi-sṳ̂-khà-sén	Categorie:Huesca (provincie)
分類:Thap-là-kô-na̍p-sén	Categorie:Tarragona (provincie)
分類:Pâ-set-lò-nâ-sén	Categorie:Barcelona (provincie)
分類:Pâ-lùn-sî-â-sén	Categorie:Valencia (provincie)
分類:Chûng-kau-ho̍k	Categorie:Godsdienstwetenschap
分類:Thò-yèn-yen	Categorie:Táoyuán
分類:Thien-fa	Categorie:Telefonie
模板:TPE	Sjabloon:TPE
分類:Ngân-set	Categorie:Kleur
分類:Â-là-kung	Categorie:Aragón
分類:User cdo	Categorie:Wikipedia:Gebruiker cdo
分類:User zh-min-dong-N	Categorie:Wikipedia:Gebruiker cdo-M
分類:Tseu-mìn	Categorie:Verlichting
分類:Phòng-châ-phú	Categorie:Punjab
模板:Chûng-fà Mìn-koet Hàng-chṳn Khî-va̍k	Sjabloon:Navigatie deelgebieden Taiwan
分類:Lie̍t-yî-tha̍t-sén	Categorie:Lerida (provincie)
甲型流感病毒H7N9亞型	H7N9
分類:User lzh	Categorie:Wikipedia:Gebruiker lzh
分類:Sat-là-kô-sat-sén	Categorie:Zaragoza (provincie)
模板:HUN	Sjabloon:HU
Â-phô	Grootmoeder
模板:Yin-thu-nì-sî-â	Sjabloon:Navigatie provincies Indonesië
模板:Kóng-sî Hàng-chṳn Khî-va̍k	Sjabloon:Navigatie autonome regio Guangxi
模板:Kóng-tûng Hàng-chṳn Khî-va̍k	Sjabloon:Navigatie provincie Guangdong
分類:User en-1	Categorie:Wikipedia:Gebruiker en-1
分類:User de-1	Categorie:Wikipedia:Gebruiker de-1
Liû-khiû Khiùn-tó	Riukiu-eilanden
模板:User ru-3	Sjabloon:Gebruiker ru-3
模板:User nl-3	Sjabloon:Gebruiker nl-3
模板:Si-chhôn Hàng-chṳn Khî-va̍k	Sjabloon:Navigatie provincie Sichuan
𠊎話	Aihua
Hon-khek	Hakka opera
模板:Style/IPA	Sjabloon:Style/IPA
模板:Style/yid	Sjabloon:Style/yid
IPhone 5S	IPhone 5s
IPhone 5C	IPhone 5c
Kiông	Gember
Sûng-kú Lô-siên	Dubbele helix
特殊:最近更改	Speciaal:RecenteWijzigingen
馬來西亞航空17號班機空難	Malaysia Airlines-vlucht 17
