Afrika	Afrika
Ġappun	Japan
Norveġja	Noorwegen
Ingilterra	Engeland
Skozja	Schotland
Irlanda ta' Fuq	Noord-Ierland
Repubblika tal-Irlanda	Ierland (land)
Ungerija	Hongarije
Spanja	Spanje
Stati Uniti	Verenigde Staten
Belġju	België
Lussemburgu	Luxemburg (land)
Art	Aarde (planeet)
Mewt	Dood
Bniedem	Mens
Tim Berners-Lee	Tim Berners-Lee
Finlandja	Finland
Żvezja	Zweden
Danimarka	Denemarken
Polonja	Polen
Litwanja	Litouwen
Italja	Italië
Żvizzera	Zwitserland
Awstrija	Oostenrijk
Greċja	Griekenland
Turkija	Turkije
Portugall	Portugal
Ewropa	Europa (werelddeel)
Asja	Azië
Wikipedija	Wikipedia
Pajjiżi l-Baxxi	Nederland
Berlin	Berlijn
Kompjuter	Computer
Barack Obama	Barack Obama
Urugwaj	Uruguay
Londra	Londen
Messiku	Mexico (land)
Oċean Atlantiku	Atlantische Oceaan
Oċean Paċifiku	Grote Oceaan
Jannar	Januari
Frar	Februari
Marzu	Maart
Marte (pjaneta)	Mars (planeet)
Kenja	Kenia
Etjopja	Ethiopië
Gana	Ghana
April	April
Mejju	Mei
Ġunju	Juni
Lulju	Juli
Awwissu	Augustus (maand)
Settembru	September
Ottubru	Oktober
Novembru	November
Diċembru	December
Iljun	Leeuw (dier)
Franza	Frankrijk
Kelb	Hond
Renju Unit	Verenigd Koninkrijk
Qattus	Kat (dier)
Ċina	Volksrepubliek China
Wikizzjunarju	Wiktionary
Brażil	Brazilië
François Hollande	François Hollande
Russja	Rusland
Wiki	Wiki
Fondazzjoni Wikimedia	Wikimedia Foundation
Jimmy Wales	Jimmy Wales
Ġermanja	Duitsland
Bjelorussja	Wit-Rusland
Il Canto degli italiani	Il Canto degli Italiani
Iżlanda	IJsland
Estonja	Estland
Saturnu (pjaneta)	Saturnus (planeet)
Latvja	Letland
Ukraina	Oekraïne
Ċekja	Tsjechië
Slovakkja	Slowakije
Slovenja	Slovenië
Vilnius	Vilnius
Moldova	Moldavië (land)
Rumanija	Roemenië
Bulgarija	Bulgarije
Ruma	Rome (stad)
Repubblika tal-Maċedonja	Macedonië (land)
Albanija	Albanië
Kroazja	Kroatië
Bożnija u Ħerżegovina	Bosnië en Herzegovina
Ażerbajġan	Azerbeidzjan
Andorra	Andorra
Ċipru	Cyprus
Ġeorġja	Georgië
Każakistan	Kazachstan
Malta	Malta (land)
Monako	Monaco
Montenegro	Montenegro
Belt tal-Vatikan	Vaticaanstad
San Marino	San Marino
Brussell	Brussel (stad)
Kuba	Cuba (land)
Beliże	Belize (land)
Torri Eiffel	Eiffeltoren
Barbados	Barbados
Volkswagen	Volkswagen
Indoneżja	Indonesië
Wolfgang Amadeus Mozart	Wolfgang Amadeus Mozart
Ludwig van Beethoven	Ludwig van Beethoven
Afrika t'Isfel	Zuid-Afrika
Alġerija	Algerije
Wikisors	Wikisource
Varsavja	Warschau
Festival tal-Eurovision	Eurovisiesongfestival
Injam	Hout
Pornografija	Pornografie
Ċili	Chili
Ġesù	Jezus (traditioneel-christelijk)
Galileo Galilei	Galileo Galilei
Merkurju (pjaneta)	Mercurius (planeet)
Storja	Geschiedenis
Venere (pjaneta)	Venus (planeet)
Imħabba	Liefde
Ġove (pjaneta)	Jupiter (planeet)
Triq ta' Sant'Anna	Melkweg (sterrenstelsel)
Uranu (pjaneta)	Uranus (planeet)
Nettunu (pjaneta)	Neptunus (planeet)
Astronomija	Astronomie
Singapor	Singapore
Xjenza	Wetenschap
Liechtenstein	Liechtenstein
Sport	Sport
Adolf Hitler	Adolf Hitler
Facebook	Facebook
L-Ewwel Gwerra Dinjija	Eerste Wereldoorlog
It-Tieni Gwerra Dinjija	Tweede Wereldoorlog
Wikotba	Wikibooks
Wikikwota	Wikiquote
Wikiversità	Wikiversity
Skopje	Skopje
Szczecin	Szczecin
Matematika	Wiskunde
Lingwa Latina	Latijn
Baħrejn	Bahrein
Armenja	Armenië
Serbja	Servië
Qamar	Maan
Awstralja	Australië (land)
Arġentina	Argentinië
Perù	Peru
Bijoloġija	Biologie
Kambodja	Cambodja
Faxxa ta' Kuiper	Kuipergordel
Koran	Koran
Dinosawru	Dinosauriërs
Iżlam	Islam
Ljubljana	Ljubljana
Unjoni Ewropea	Europese Unie
Plovdiv	Plovdiv (stad)
Mara	Vrouw
Poeżija	Poëzie
Lumija	Citroen (vrucht)
Émile Zola	Émile Zola
Napuljun I ta' Franza	Napoleon Bonaparte
Vesuvju	Vesuvius (vulkaan)
Xemx	Zon
Sena dawl	Lichtjaar
Oċeanja	Oceanië
Sistema Solari	Zonnestelsel
Idroġenu	Waterstof (element)
Wikimedia Commons	Wikimedia Commons
Lejl	Nacht
Oslo	Oslo
Katowice	Katowice
Toqba sewda	Zwart gat
Lionel Messi	Lionel Messi
Karbonju	Koolstof
Ażotu	Stikstof (element)
Ossiġenu	Zuurstof (element)
Inter Milan	FC Internazionale Milano
Pjaneta	Planeet
Kleopatra VII	Cleopatra VII
Mużika	Muziek
Moska	Moskou
Lingwa Taljana	Italiaans (taal)
Ċad	Tsjaad
New Zealand	Nieuw-Zeeland
Indja	India
Tuvalu	Tuvalu
Ħadid	IJzer (element)
Tonga	Tonga (land)
Samoa	Samoa
Gżejjer Solomon	Salomonseilanden
Vanwatu	Vanuatu
Molière	Molière (schrijver)
Papwa Gwinea l-Ġdida	Papoea-Nieuw-Guinea
William Shakespeare	William Shakespeare
Nawru	Nauru
Kiribati	Kiribati
Fiġi	Fiji
Veneżwela	Venezuela
Genghis Khan	Dzjengis Khan
Żiemel	Paard (dier)
Annimal	Dierenrijk
Surinam	Suriname
Paragwaj	Paraguay
Gujana	Guyana
Arti	Kunst
Ekwador	Ecuador
Kolombja	Colombia
Buddiżmu	Boeddhisme
Bolivja	Bolivia
Trinidad u Tobago	Trinidad en Tobago
Saint Vincent u l-Grenadini	Saint Vincent en de Grenadines
Santa Luċija	Saint Lucia
Leonardo da Vinci	Leonardo da Vinci
Saint Kitts u Nevis	Saint Kitts en Nevis
Ġamajka	Jamaica
Grenada	Grenada
Gwatemala	Guatemala
Baħamas	Bahama's
Antigwa u Barbuda	Antigua en Barbuda
Ħonduras	Honduras
Dominika	Dominica
Repubblika Dominikana	Dominicaanse Republiek
Ħaiti	Haïti
El Salvador	El Salvador
Iran	Iran
Iraq	Irak
Kosta Rika	Costa Rica
Iżrael	Israël
Panama	Panama (land)
Jemen	Jemen
Lingwa pollakka	Pools
Ġordan	Jordanië
Nikaragwa	Nicaragua
Libanu	Libanon
Maldive	Maldiven
Malażja	Maleisië
Burma	Myanmar
Pakistan	Pakistan
Qatar	Qatar
Arabja Sawdija	Saoedi-Arabië
Sri Lanka	Sri Lanka
Josif Stalin	Jozef Stalin
YouTube	YouTube
Aristotli	Aristoteles
Emirati Għarab Magħquda	Verenigde Arabische Emiraten
Vjetnam	Vietnam
Korea t'Isfel	Zuid-Korea
Afganistan	Afghanistan
Bangladexx	Bangladesh
Mali	Mali
Angola	Angola
Butan	Bhutan
Brunej	Brunei
Tanżanija	Tanzania
Repubblika Ċentru-Afrikana	Centraal-Afrikaanse Republiek
Isaac Newton	Isaac Newton
Isfar	Geel (kleur)
Mekkanika kwantistika	Kwantummechanica
Togo	Togo
Tuneżija	Tunesië
Żambja	Zambia
Żimbabwe	Zimbabwe
Sudan t'Isfel	Zuid-Soedan
Benin	Benin
Botswana	Botswana
Wikiħbarijiet	Wikinews
Burkina Faso	Burkina Faso
Burundi	Burundi
Komoros	Comoren
Repubblika tal-Kongo	Congo-Brazzaville
Repubblika Demokratika tal-Kongo	Congo-Kinshasa
Ġibuti	Djibouti (land)
Bavarja	Beieren
Ginea Ekwatorjali	Equatoriaal-Guinea
Eritrea	Eritrea
Papa Ġwanni Pawlu II	Paus Johannes Paulus II
Gabon	Gabon
Mahatma Gandhi	Mohandas Karamchand Gandhi
Gambja	Gambia (land)
Ginea	Guinee
Ginea Bissaw	Guinee-Bissau
Kosta tal-Avorju	Ivoorkust
Kamerun	Kameroen
Kap Verde	Kaapverdië
Lesoto	Lesotho
Liberja	Liberia
Libja	Libië
Madagaskar	Madagaskar
Malawi	Malawi
Mawritanja	Mauritanië
Mawrizju	Mauritius (land)
Marokk	Marokko
Możambik	Mozambique
Namibja	Namibië
Niġer	Niger (land)
Niġerja	Nigeria
Charles Darwin	Charles Darwin
Uganda	Oeganda
Rwanda	Rwanda
São Tomé u Príncipe	Sao Tomé en Principe
Senegal	Senegal
Seychelles	Seychellen
Sierra Leone	Sierra Leone
Somalja	Somalië
Sudan	Soedan
Sważiland	Swaziland
Amburgu	Hamburg
Evoluzzjoni	Evolutie (biologie)
Ġnus Magħquda	Verenigde Naties
Dante Alighieri	Dante Alighieri
Ġeografija	Aardrijkskunde
Qalb	Hart
Praga	Praag
Ikħal	Blauw (kleur)
Limburgu (Belġju)	Limburg (Belgische provincie)
Fjandri tal-Punent	West-Vlaanderen
Fjandri tal-Lvant	Oost-Vlaanderen
Antwerp (provinċja)	Antwerpen (provincie)
Brabant Fjamming	Vlaams-Brabant
Merkurju (mitoloġija)	Mercurius (mythologie)
Hector Berlioz	Hector Berlioz
Giorgio Napolitano	Giorgio Napolitano
Francesco Cossiga	Francesco Cossiga
Oċean Indjan	Indische Oceaan
Kosovo	Kosovo
Frédéric Chopin	Frédéric Chopin
Kategorija:Prinċipali	Categorie:Alles
Dortmund	Dortmund
The Beatles	The Beatles
Osama Bin Laden	Osama bin Laden
Lingwa Spanjola	Spaans
Montevideo	Montevideo (stad)
Johann Sebastian Bach	Johann Sebastian Bach
Brimba	Spinnen (dieren)
Virġilju	Vergilius
Uetersen	Uetersen
Karozza	Auto
Żagreb	Zagreb
Sqallija	Sicilië
Maurits Cornelis Escher	Maurits Cornelis Escher
Buenos Aires	Buenos Aires (stad)
Belt tal-Messiku	Mexico-Stad
Tokjo	Tokio
Barċellona	Barcelona (Spanje)
Ateni	Athene (stad)
AC Milan	AC Milan
Ħavana	Havana
Édith Piaf	Édith Piaf
Kopenħagen	Kopenhagen
Stokkolma	Stockholm
Ħelsinki	Helsinki
Dublin	Dublin
Rejkjavik	Reykjavik
Tallinn	Tallinn
Riga	Riga
Bratislava	Bratislava
Gdańsk	Gdańsk
Lussemburgu (belt)	Luxemburg (stad)
Bibbja	Bijbel (christendom)
Ho Chi Minh (belt)	Ho Chi Minhstad
Knisja Vera ta' Ġesù	Ware Jezuskerk
Dong Hoi	Đồng Hới
Concepción (Ċili)	Concepción (Chili)
Atalanta BC	Atalanta Bergamo
Bolonja	Bologna (stad)
Bologna FC 1909	Bologna FC 1909
Cagliari	Cagliari (stad)
Kiev	Kiev
Cagliari Calcio	Cagliari Calcio
Karim Benzema	Karim Benzema
Patrice Evra	Patrice Evra
Końskowola	Końskowola
2014	2014
2015	2015
2007	2007
ACF Fiorentina	ACF Fiorentina
Serp	Slangen
1 ta' Jannar	1 januari
2 ta' Jannar	2 januari
Rivoluzzjoni Industrijali	Industriële revolutie
Imperu Ruman	Romeinse Keizerrijk
Minsk	Minsk
Microsoft	Microsoft
8 ta' Diċembru	8 december
Kurów	Kurów (powiat Puławski)
Kimika	Scheikunde
19 ta' Marzu	19 maart
Papa Benedittu XVI	Paus Benedictus XVI
Papa Piju XII	Paus Pius XII
Watford FC	Watford FC
Futbol	Voetbal
L-Olokawst	Holocaust
Madrid	Madrid (stad)
Michael Jackson	Michael Jackson
5 ta' Settembru	5 september
4 ta' Settembru	4 september
Santiago (Ċili)	Santiago (Chili)
25 ta' Ottubru	15 oktober
5 ta' Novembru	5 november
22 ta' Novembru	22 november
Aħdar	Groen (kleur)
Aħmar	Rood (kleur)
Lourdes	Lourdes
Rabat (Marokk)	Rabat (Marokko)
Kometa	Komeet
Belgrad	Belgrado
Kategorija:Mudelli	Categorie:Wikipedia:Sjablonen
George Sand	George Sand
Nikosija	Nicosia (Cyprus)
Asterojde	Planetoïde
Manama	Manama (stad)
Eklissi solari	Zonsverduistering
Wikipedija:Paġna tal-provi	Wikipedia:Zandbak
Nettunu (mitoloġija)	Neptunus (mythologie)
Alġebra	Algebra
Ajruport Dong Hoi	Luchthaven Đồng Hới
Miley Cyrus	Miley Cyrus
Curitiba	Curitiba (gemeente)
Pangea	Pangea
Kategorija:1888	Categorie:1888
Pika Alpina	Altaifluithaas
Konfuċju	Confucius
Corbin Bleu	Corbin Bleu
Kategorija:Matematika	Categorie:Wiskunde
Gżejjer Faroe	Faeröer
Ġove (mitoloġija)	Jupiter (mythologie)
Sherlock Holmes	Sherlock Holmes
Rinaxximent	Renaissance
Ewro	Euro
Baħar Mediterran	Middellandse Zee
Kristjaneżmu	Christendom
Mudell:Favur	Sjabloon:Voor
Għasfur	Vogels
Belt kapitali	Hoofdstad
Monzón	Monzón
Mustafa Kemal Atatürk	Mustafa Kemal Atatürk
Mudell:Portal	Sjabloon:Link portaal
Bill Gates	Bill Gates
Struttura .NET	.NET
Enċiklopedija	Encyclopedie
Il-Paġna prinċipali	Hoofdpagina
Baskitbol	Basketbal
Francisco Goya	Francisco Goya
Albrecht Dürer	Albrecht Dürer
Frida Kahlo	Frida Kahlo
Mikelanġlu	Michelangelo Buonarroti
Miguel de Cervantes	Miguel de Cervantes
Charles Dickens	Charles Dickens
Mekka	Mekka
Che Guevara	Che Guevara
Mao Zedong	Mao Zedong
Johann Wolfgang von Goethe	Johann Wolfgang von Goethe
Filosofija	Filosofie
Jimi Hendrix	Jimi Hendrix
Kategorija:Proposti għat-tħassir minnufih	Categorie:Wikipedia:Nuweg
Hebe Camargo	Hebe Camargo
Komuniżmu	Communisme
Saħara tal-Punent	Westelijke Sahara
Pajjiż	Land (geografie)
Kartaġni	Carthago
Kategorija:Astronomija	Categorie:Astronomie
UTC−3:30	UTC-3:30
Søren Kierkegaard	Søren Kierkegaard
Bolzano	Bozen (stad)
Rivoluzzjoni Franċiża	Franse Revolutie
Saħara	Sahara
Strażburgu	Straatsburg
Lingwa Kroata	Kroatisch
UTC+1	UTC+1
Omeru	Homerus
UTC+2	UTC+2
UTC+3	UTC+3
Lena Meyer-Landrut	Lena Meyer-Landrut
Seklu XVII	17e eeuw
Ateiżmu	Atheïsme
Ekoloġija	Ecologie
FC Barcelona	FC Barcelona
Marie Curie	Marie Curie
Premju Nobel	Nobelprijs
Alan Turing	Alan Turing
Ideoloġija	Ideologie
Ada Lovelace	Ada Lovelace
Franz Schubert	Franz Schubert
Igor' Stravinskij	Igor Stravinsky
Pëtr Il'ič Čajkovskij	Pjotr Iljitsj Tsjaikovski
Giuseppe Verdi	Giuseppe Verdi
Kristofru Kolombu	Christoffel Columbus
Nagħġa	Schaap (dier)
Mammiferu	Zoogdieren
Naħla	Bijen
Speċi	Soort
Tifel	Kind (leeftijdsgroep)
Napuljun III	Napoleon III
Vladimir Putin	Vladimir Poetin
Analisi matematika	Analyse (wiskunde)
Commonwealth tan-Nazzjonijiet	Gemenebest van Naties
Organizzazzjoni Dinjija tas-Saħħa	Wereldgezondheidsorganisatie
Demm	Bloed
Pulmun	Long (orgaan)
Casablanca	Casablanca (stad)
Xjenza Naturali	Natuurwetenschap
Santu Wistin	Augustinus van Hippo
Nelson Mandela	Nelson Mandela
Martin Luther King Jr.	Martin Luther King
Ġeometrija	Meetkunde
Atmosfera	Atmosfeer (astronomie)
Kategorija:Bulgarija	Categorie:Bulgarije
Kategorija:Franza	Categorie:Frankrijk
Kategorija:Mużika	Categorie:Muziek
Elf Lejla u Lejla	Duizend-en-een-nacht
Kategorija:Letteratura	Categorie:Literatuur
Ilijade	Ilias
Alessandru Manju	Alexander de Grote
Edukazzjoni	Onderwijs
Hugo Chávez	Hugo Chávez
Raġel	Man (geslacht)
Otto von Bismarck	Otto von Bismarck
Abort	Abortus
Skjavitù	Slavernij
Logħob Olimpiku tas-sajf 2008	Olympische Zomerspelen 2008
US Sassuolo Calcio	US Sassuolo
Logħob Olimpiku tas-sajf 2016	Olympische Zomerspelen 2016
Gwerra Ċivili Amerikana	Amerikaanse Burgeroorlog
Imperu Brittaniku	Britse Rijk
Real Madrid CF	Real Madrid CF
Sivilja	Sevilla (stad)
Rivoluzzjoni Russa	Russische Revolutie
Arkimede	Archimedes
Thomas Edison	Thomas Edison
Ewklide	Euclides van Alexandrië
Bit	Bit (eenheid)
Parlament Ewropew	Europees Parlement
Kostellazzjoni	Sterrenbeeld
Karl Marx	Karl Marx
Voltaire	Voltaire
Ħinduiżmu	Hindoeïsme
Erwin Schrödinger	Erwin Schrödinger
Lingwa Maltija	Maltees
Reliġjon	Religie
René Descartes	René Descartes
Pawlu minn Tarsu	Paulus (apostel)
Immanuel Kant	Immanuel Kant
Guy de Maupassant	Guy de Maupassant
Friedrich Nietzsche	Friedrich Nietzsche
Fwied	Lever
Kilwa	Nier (biologie)
Psikoloġija	Psychologie
Gautama Buddha	Gautama Boeddha
Premier League	Premier League
Muħammed	Mohammed
Probabbiltà	Kans (statistiek)
Martin Luteru	Maarten Luther
Xigħa	Sjiisme
Knisja Kattolika	Rooms-katholieke Kerk
Chelsea FC	Chelsea FC
Arsenal FC	Arsenal FC
Sistema diġestiva	Maag-darmstelsel
Logħob Olimpiku tax-xitwa 2010	Olympische Winterspelen 2010
Reġina Eliżabetta II	Elizabeth II van het Verenigd Koninkrijk
Alfabett	Alfabet
Ronald Reagan	Ronald Reagan
Francisco Varallo	Francisco Varallo
Festival tal-Eurovision 2005	Eurovisiesongfestival 2005
Festival tal-Eurovision 2006	Eurovisiesongfestival 2006
Festival tal-Eurovision 2007	Eurovisiesongfestival 2007
Festival tal-Eurovision 2008	Eurovisiesongfestival 2008
Festival tal-Eurovision 2009	Eurovisiesongfestival 2009
Festival tal-Eurovision 2010	Eurovisiesongfestival 2010
Festival tal-Eurovision 2011	Eurovisiesongfestival 2011
Festival tal-Eurovision 2012	Eurovisiesongfestival 2012
Festival tal-Eurovision 2013	Eurovisiesongfestival 2013
Main-Spessart	Landkreis Main-Spessart
Catherine Middleton	Catherine Middleton
David Beckham	David Beckham
Ryan Giggs	Ryan Giggs
Tom Cleverley	Tom Cleverley
Ben Foster	Ben Foster (voetballer)
Ashley Young	Ashley Young
Kim Jong-il	Kim Jong-il
Kategorija:Veneżwela	Categorie:Venezuela
Belfast	Belfast
Tavla perjodika	Periodiek systeem
Tórshavn	Tórshavn
Manuel Almunia	Manuel Almunia
Attakki tal-11 ta' Settembru	Aanslagen op 11 september 2001
Chordata	Chordadieren
Kultura	Cultuur
Trattat ta' Maastricht	Verdrag betreffende de Europese Unie
Mediċina	Geneeskunde
Sarajevo	Sarajevo
Ekwazzjoni differenzjali	Differentiaalvergelijking
Kategorija:Brażil	Categorie:Brazilië
Kategorija:Rumanija	Categorie:Roemenië
Element kimiku	Chemisch element
Funzjonijiet (matematika)	Functie (wiskunde)
Kimika organika	Organische chemie
Mekkanika klassika	Klassieke mechanica
Klassifikazzjoni bijoloġika	Taxonomie in de biologie
Arti marzjali	Vechtkunst
Rota	Fiets
Relatività ristretta	Speciale relativiteitstheorie
Ħġieġ	Glas
Karta	Papier
Kilogramm	Kilogram
Cristiano Ronaldo	Cristiano Ronaldo
Metru	Meter
Pittura	Schilderkunst
Skultura	Beeldhouwkunst
Żfin	Dans
Pajjiżi tad-dinja	Lijst van landen in 2015
Preistorja	Prehistorie
Silvio Berlusconi	Silvio Berlusconi
Eric Saade	Eric Saade
4′33″	4'33"
Kolera	Cholera
Skerma	Schermen
Sfera ċelesti	Hemelbol
Malarja	Malaria
AIDS	Aids
Tuberkulożi	Tuberculose
Inna	Inna
Mona Lisa	Mona Lisa
Teorija tan-numri	Getaltheorie
Kileb	Console (bouwkunde)
Biżantini	Byzantijnse Rijk
Kruċjata	Kruistocht
Imperu Ottoman	Ottomaanse Rijk
Malgrat de Mar	Malgrat de Mar
Stephan El Shaarawy	Stephan El Shaarawy
Lampuna	Framboos
Tuta tal-għollieq	Braam (cultuurbraam)
Kurgan (belt)	Koergan (stad)
Trapani	Trapani (stad)
Wikispeċi	Wikispecies
Lingwa Għarbija	Arabisch
Jum ir-Ringrazzjament	Thanksgiving Day
Lingwa Oċċitanija	Occitaans
Lingwa tas-Sinjali Amerikana	Amerikaanse Gebarentaal
Kategorija:Provinċji tal-Italja	Provincies van Italië
Alkoħoliżmu	Alcoholisme
FC Bayern Munich	FC Bayern München
Serie A	Serie A
Queen	Queen
Provinċja ta' Agrigento	Agrigento (provincie)
Provinċja ta' Bergamo	Bergamo (provincie)
Provinċja ta' Kaltanissetta	Caltanissetta (provincie)
Provinċja ta' Lodi	Lodi (provincie)
Wikipedija:Vetrina	Wikipedia:Etalage
Mudell:Link FA	Sjabloon:Link FA
Dinja	Wereld (Aarde)
Wikipedija:Pjazza	Wikipedia:De kroeg
Takson	Taxon
Papa Pawlu VI	Paus Paulus VI
Etna	Etna (vulkaan)
Clube de Regatas do Flamengo	CR Flamengo
Gerard Piqué	Gerard Piqué
San Lawrenz	Laurentius van Rome
Martin Schulz	Martin Schulz
KAA Gent	AA Gent
Mudell Standard	Standaardmodel van de deeltjesfysica
Teorija ta' kollox	Theorie van alles
Tamworth FC	Tamworth FC
Mafja	Maffia
Manchester United FC	Manchester United FC
Aston Villa FC	Aston Villa FC
West Ham United FC	West Ham United FC
UEFA Champions League	UEFA Champions League
UEFA Europa League	UEFA Europa League
Fenek tal-istrixxi ta' Sumatra	Sumatraans konijn
Tazza tad-Dinja tal-Futbol	Wereldkampioenschap voetbal
Daniel Parejo Muñoz	Dani Parejo
Blackburn Rovers FC	Blackburn Rovers FC
Wolverhampton Wanderers FC	Wolverhampton Wanderers FC
Rafael Correa	Rafael Correa
R. Charleroi SC	R. Sporting du Pays de Charleroi
FC Twente	FC Twente
Motorhead	Motörhead
Milied	Kerstmis
Lingwi Romaniċi	Romaanse talen
Steve Jobs	Steve Jobs
Lady Gaga	Lady Gaga
Indoewropew	Indo-Europese talen
Muammar al-Gaddafi	Moammar al-Qadhafi
Francesco Totti	Francesco Totti
Chișinău	Chisinau
Soċjoloġija	Sociologie
Şalom	Şalom
Didelphidae	Opossums
Caenolestidae	Opossummuizen
Trojja	Troje
The Pirate Bay	The Pirate Bay
Kampjonati Ewropej tal-Futbol 2012	Europees kampioenschap voetbal 2012
Dasyuridae	Echte roofbuideldieren
Audi	Audi
Abkażja	Abchazië
Antropoloġija	Antropologie
Baħar l-Aħmar	Rode Zee
Octave Mirbeau	Octave Mirbeau
Abjad	Wit
Iswed	Zwart (kleur)
Lordi	Lordi
Lingwa uffiċjali	Officiële taal
Provinċja ta' Quảng Bình	Quảng Bình (provincie)
Entrena	Entrena
Mérida (Veneżwela)	Mérida (Venezuela)
Benito Mussolini	Benito Mussolini
LOST (Serje televiżiva)	Lost
Ġebla tal-ġir	Kalksteen
Valletta	Valletta
Papa Ġwanni XXIII	Paus Johannes XXIII
Benetice (Světlá nad Sázavou)	Benetice (Světlá nad Sázavou)
Prixtina	Pristina
Curaçao	Curaçao
Coccinellidae	Lieveheersbeestjes
Metatheria	Buideldieren
Pangolin	Manis
Lagomorpha	Haasachtigen
Baqra tal-baħar	Zeekoeien
Eutheria	Placentadieren
Fenek Ewropew	Konijn (dier)
Leporidae	Hazen en konijnen
Imperu Kushan	Kushana
Qlugħ	Zeil (schip)
Klaas-Jan Huntelaar	Klaas-Jan Huntelaar
Proboscidea	Slurfdieren
Università Niccolò Cusano	Università degli Studi Niccolò Cusano
FK Radnik Bijeljina	FK Radnik Bijeljina
Fażijiet lunari	Schijngestalten
Fariżej	Farizeeën
M'Baye Niang	M'Baye Niang
Liebru Ewropew	Haas (dier)
Lepisma saccharina	Zilvervisje
Laurasiatheria	Laurasiatheria
Afrotheria	Afrotheria
Ewropa t'Isfel	Zuid-Europa
Ewropa Ċentrali	Centraal-Europa
Kristadelfjani	Broeders in Christus
Tim nazzjonali tal-futbol tal-Eġittu	Egyptisch voetbalelftal
Maja	Mayacultuur
Chow Chow	Chowchow
FC Kuban Krasnodar	FK Koeban Krasnodar
Derivata	Afgeleide
Kwalifikazzjoni għall-Kampjonati Ewropej tal-Futbol 2008	Europees kampioenschap voetbal 2008 (kwalificatie)
Chris Smalling	Chris Smalling
Jonny Evans	Jonny Evans
Michael Carrick	Michael Carrick
Multilingwiżmu	Meertaligheid
Lingwa Sileżjana	Silezisch (Slavische taal)
Avril Lavigne	Avril Lavigne
Mikhail Gorbachev	Michail Gorbatsjov
Slogan	Slagzin
Madre Tereża ta' Kalkutta	Moeder Teresa
UEFA Champions League 2013–14	UEFA Champions League 2013/14
Rudolf Clausius	Rudolf Clausius
Auguste Rodin	Auguste Rodin
Blogg	Weblog
Oscar Wilde	Oscar Wilde
Krakovja	Krakau
Thylacinidae	Buidelwolven
Malala Yousafzai	Malala Yousafzai
Carlos Alonso González	Carlos Alonso González
Marsa FC	Marsa FC
Valery Leontiev	Valeri Leontjev
Mużew	Museum
Du Fu	Du Fu
Popolazzjoni	Bevolking
Arċipelagu	Archipel
Lingwa Sqallija	Siciliaans (taal)
Valparaíso	Valparaíso (stad)
Nju	Niue
Tim nazzjonali tal-futbol tal-Iskozja	Schots voetbalelftal
Lingwa Leoniża	Leonees
Żews	Zeus
Lingwa tas-Sinjali	Gebarentaal
Astroloġija	Astrologie
Mošovce	Mošovce
Saint-Dié-des-Vosges	Saint-Dié-des-Vosges
Boris Yeltsin	Boris Jeltsin
Hirohito	Hirohito
Baħar Eġew	Egeïsche Zee
J.K. Rowling	J.K. Rowling
Hiroshima	Hiroshima (stad)
Mitoloġija Griega	Griekse mythologie
Ġeneru (tassonomija)	Geslacht (biologie)
Xjenzi soċjali	Sociale wetenschappen
Lista ta' kodiċi telefoniċi	Lijst van landnummers in de telefonie
Lista ta' bliet kapitali	Lijst van hoofdsteden
Noemi (kantanta)	Noemi
Sit elettroniku	Website
Odissea	Odyssee
Lingwa Ido	Ido (kunsttaal)
Etimoloġija	Etymologie
Nikita Krushchev	Nikita Chroesjtsjov
Kia Motors	Kia Motors
Familja (bijoloġija)	Familie (biologie)
UEFA	UEFA
Arthur Conan Doyle	Arthur Conan Doyle
Sport Club Corinthians Paulista	SC Corinthians Paulista
Lingwa Kopta	Koptisch (taal)
Folklor	Folklore
Siligo	Siligo
Mark Zuckerberg	Mark Zuckerberg
Lingwa tas-Sinjali Newzealander	Nieuw-Zeelandse Gebarentaal
Neolitiku	Neolithicum
Katerina II tar-Russja	Catharina II van Rusland
Guglielmo Marconi	Guglielmo Marconi
Ordni (bijoloġija)	Orde (biologie)
Cork	Cork (stad)
Renju (bijoloġija)	Rijk (biologie)
Novial	Novial
Aung San Suu Kyi	Aung San Suu Kyi
Kompożitur	Componist
Influwenza tal-majjali	Varkensgriep
Serbja u Montenegro	Servië en Montenegro
Romantiċiżmu	Romantiek (stroming)
It-Trinita' Mqaddsa	Drie-eenheid
Faragħun	Farao
Mariupol	Marioepol
Tazza tad-Dinja tal-Futbol 2006	Wereldkampioenschap voetbal 2006
Klaus Ebner	Klaus Ebner
Klassi (bijoloġija)	Klasse (biologie)
Campora San Giovanni	Campora San Giovanni
Bălţi	Bălți (plaats)
Auckland Grammar School	Auckland Grammar School
Bolla postali	Postzegel
Era (mitoloġija)	Hera
Premju Nobel għall-Fiżika	Nobelprijs voor de Natuurkunde
Enya	Enya
Phylum	Stam (biologie)
Enriku VIII tal-Ingilterra	Hendrik VIII van Engeland
São Paulo FC	São Paulo FC
Kelb tal-Fenek	Pharaohond
Baħar Tirren	Tyrreense Zee
Leeds	Leeds
NK Čelik Zenica	NK Čelik Zenica
Surrealiżmu	Surrealisme
San Ġwann (Malta)	San Ġwann
Ħaż-Żabbar	Żabbar
Mosta	Mosta
Tas-Sliema	Sliema
Ħal Qormi	Qormi
Birkirkara	Birkirkara
Radio Studio 54 Network	Radio Studio 54 Network
Lamantin tal-Karibew	Caribische lamantijn
Atti ta' l-Appostli	Handelingen van de apostelen
Żodjaku	Dierenriem
Paulínia	Paulínia
Il-100 ktieb tas-seklu skont Le Monde	Le Mondes 100 boeken van de eeuw
Fonoloġija	Fonologie
Kim Il-sung	Kim Il-sung
Jan Vermeer	Johannes Vermeer
Borussia Dortmund	Borussia Dortmund
Għenba tax-xewk	Kruisbes
Michel de Montaigne	Michel de Montaigne
Golf ta' Biskaja	Golf van Biskaje
Sorċid	Spitsmuizen
Feniċi	Fenicië
Akille	Achilles
Gramma	Gram (eenheid)
.mt	.mt
Michelangelo Merisi da Caravaggio	Caravaggio (schilder)
Tim nazzjonali tal-futbol ta' Spanja	Spaans voetbalelftal
Martin Weinek	Martin Weinek
Björk	Björk
H. G. Wells	Herbert George Wells
Tumas More	Thomas More
Fernando Torres	Fernando Torres
Lamantin	Lamantijnen
Baħar Liguri	Ligurische Zee
Dima Bilan	Dima Bilan
Lega Anżejatika	Hanze
Kubiżmu	Kubisme
Qawwiet tal-Assi tat-Tieni Gwerra Dinjija	Asmogendheden
Wikipedija:Mistoqsijiet rikorrenti	Help:Veelgestelde vragen
Għar ta' Thien Duong	Thiên Đường-grot
Tim nazzjonali tal-futbol tal-Ġermanja	Duits voetbalelftal
Gustave Flaubert	Gustave Flaubert
San Mattew	Matteüs (apostel)
Sant'Ambroġju	Ambrosius van Milaan
Ġwanni Kriżostmu	Johannes Chrysostomus
Papa Piju X	Paus Pius X
Papa Ljun XIII	Paus Leo XIII
Rasputin	Grigori Raspoetin
San Girgor Nażjanżenu	Gregorius van Nazianze
Egon Schiele	Egon Schiele
Duminku ta' Guzmán	Dominicus Guzman
Hamit Altıntop	Hamit Altıntop
Maximilien Robespierre	Maximilien de Robespierre
Ġlormu	Hiëronymus van Stridon
San Bażilju	Basilius van Caesarea
Michel Foucault	Michel Foucault
Daniel Van Buyten	Daniel Van Buyten
Ilarju ta' Poitiers	Hilarius van Poitiers
Rabat (Malta)	Rabat (Malta)
Fgura	Fgura
Żejtun	Żejtun
Naxxar	Naxxar
Iż-Żurrieq	Żurrieq
John Henry Newman	John Henry Newman
Ħ'Attard	Attard
Ħaż-Żebbuġ	Żebbuġ (Malta)
Morus (botanika)	Moerbei
Son Doong	Hang Sơn Đoòng
Alex Ferguson	Alex Ferguson
Erwin Hoffer	Erwin Hoffer
Arkanġlu Mikiel	Michaël (aartsengel)
Titan	Titaan (mythisch wezen)
Kardinal	Kardinaal (geestelijke)
Iżabella ta' Kastilja	Isabella I van Castilië
Liebru	Echte hazen
Felix Mendelssohn	Felix Mendelssohn Bartholdy
Orikteropu	Aardvarken
Leonardo Araújo	Leonardo Nascimento de Araujo
Metodu xjentifiku	Wetenschappelijke methode
Espoo	Espoo
Bijodiversità	Biodiversiteit
Kannella (kulur)	Bruin
Tizjanu	Titiaan
Matteo Renzi	Matteo Renzi
Venere (mitoloġija)	Venus (mythologie)
Tazza tad-Dinja tal-Futbol 2002	Wereldkampioenschap voetbal 2002
Tim nazzjonali tal-futbol tal-Ingilterra	Engels voetbalelftal
Tim nazzjonali tal-futbol ta' Franza	Frans voetbalelftal
Sid Vicious	Sid Vicious
Mario Monti	Mario Monti
Stojċiżmu	Stoa
Martin Heidegger	Martin Heidegger
Tazza tad-Dinja tal-Futbol 1930	Wereldkampioenschap voetbal 1930
Università ta' New York	New York-universiteit
Giulio Andreotti	Giulio Andreotti
Park Ji-Sung	Park Ji-sung
Slaten Maġi	Wijzen uit het oosten
Charles de Foucauld	Charles de Foucauld
Pajjiżi Nordiċi	Noordse landen
Kategorija:Mudelli tal-kimika	Categorie:Wikipedia:Sjablonen scheikunde
Trattat ta' Liżbona	Verdrag van Lissabon
Claudio Monteverdi	Claudio Monteverdi
Iraċ	Klipdasachtigen
Sami Khedira	Sami Khedira
FC Baku	FK Bakoe
Provinċja ta' Soria	Soria (provincie)
Arkanġlu Rafel	Rafaël (aartsengel)
George Abela	George Abela
Moħammed VI	Mohammed VI van Marokko
Jum l-Indipendenza	Nationale feestdag
Lawrence Gonzi	Lawrence Gonzi
L-Ewwel Diviżjoni Maltija	First Division (Malta)
Assedju ta' Malta (1565)	Beleg van Malta (1565)
CONMEBOL	Confederación Sudamericana de Fútbol
Erbivoru	Herbivoor
Schönhausen	Schönhausen (Elbe)
Oskar Schindler	Oskar Schindler
Enejide	Aeneis
Flamurtari Vlorë	KS Flamurtari Vlorë
Besa Kavajë	KS Besa Kavajë
KF Laçi	KF Laçi
Affiss	Affix
Norberto Murara Neto	Norberto Murara Neto
L-Għanja tal-Milied	A Christmas Carol (boek)
Semitiku	Semieten
Marrara	Galblaas
Sottospeċi	Ondersoort
Ħassan II	Hassan II van Marokko
It-Tielet Repubblika Franċiża	Derde Franse Republiek
Joyeux Noël	Joyeux Noël
FK Kukësi	KF Kukësi
KF Skënderbeu Korçë	Skënderbeu Korçë
Carlos Bacca	Carlos Bacca
Bank Ċentrali ta' Malta	Centrale Bank van Malta
Yıldıray Baştürk	Yıldıray Baştürk
Alfred Wegener	Alfred Wegener
Juli Zeh	Juli Zeh
Edith Stein	Edith Stein
Friedrich Carl von Savigny	Friedrich Carl von Savigny
Walter Andreas Schwarz	Walter Andreas Schwarz
Wilhelm von Humboldt	Wilhelm von Humboldt
Wikipedija:Vetrina/Senjalazzjonijiet	Wikipedia:Etalage/Aanmelding kandidaten
Tazza tad-Dinja tal-Futbol 2014	Wereldkampioenschap voetbal 2014
Coronel Fabriciano	Coronel Fabriciano
Senglea Athletic FC	Senglea Athletic
Miroslav Klose	Miroslav Klose
Alla Pugacheva	Alla Poegatsjova
Dante Bonfim Costa Santos	Bonfim Costa Dante
Isco	Isco
Fes	Fez (stad)
Liebru taż-żarbuna tas-silġ	Amerikaanse haas
Greenpeace	Greenpeace
KS Vllaznia Shkodër	KS Vllaznia Shkodër
Teuta Durrës	KS Teuta Durrës
Ragħaj	Schaapherder
Arkanġlu Gabrijel	Gabriël (aartsengel)
Mata Hari	Mata Hari
Fußball-Bundesliga	Bundesliga (Duitsland)
Pressjoni tad-demm	Bloeddruk
Feria del Sol (Mérida)	Feria del Sol (Mérida)
Enea	Aeneas
Politiku	Politicus
David Villa	David Villa
Demenzja	Dementie
Jürgen Klopp	Jürgen Klopp
Tazza tan-Nazzjonijiet Afrikani	Afrikaans kampioenschap voetbal
Romeo u Ġuljetta	Romeo and Juliet (toneelstuk)
Konfederazzjoni Ażjatika tal-Futbol	Asian Football Confederation
Robin Williams	Robin Williams
Normanni	Normandiërs
Tim nazzjonali tal-futbol tal-Brażil	Braziliaans voetbalelftal
Grupp (matematika)	Groep (wiskunde)
Mesut Özil	Mesut Özil
Isabel Allende	Isabel Allende (schrijfster)
Wes Brown	Wes Brown
It-Tempesta	The Tempest
Jum l-Indipendenza (Stati Uniti)	Independence Day (Verenigde Staten)
Mudell:Ċita ktieb	Sjabloon:Citeer boek
Divorzju	Echtscheiding
Chrzanów	Chrzanów (stad)
Impuls FC Dilijan	SC Erebuni Dilijan
Medjugori	Međugorje
Suffiss	Suffix
Artiklu (grammatika)	Lidwoord
Australopithecus	Australopithecus
Festival tal-Eurovision tat-Tfal	Junior Eurovisiesongfestival
Kaspar Capparoni	Kaspar Capparoni
Ħolma ta’ Lejla Sajfija	A Midsummer Night's Dream (toneelstuk)
Berthe Morisot	Berthe Morisot
Manuel Neuer	Manuel Neuer
Penny Black	Penny Black
Armistizju	Wapenstilstand
Anthony Limbombe	Anthony Limbombe
KV Mechelen	KV Mechelen
Heiko Westermann	Heiko Westermann
Montenegro fil-Festival tal-Eurovision	Montenegro op het Eurovisiesongfestival
Papa Ċelestinu V	Paus Celestinus V
Luftëtari Gjirokastër	Luftëtari Gjirokastër
Amedeo Modigliani	Amedeo Modigliani
Appendiċite	Blindedarmontsteking
Marco Streller	Marco Streller
Hakan Yakın	Hakan Yakin
Ludovic Magnin	Ludovic Magnin
Diego Benaglio	Diego Benaglio
Daniel Bernoulli	Daniel Bernoulli
Jacob Bernoulli	Jakob Bernoulli
Stella Mwangi	Stella Mwangi
Dziecinów	Dziecinów (powiat Otwocki)
Pajjiż interkjuż	Binnenstaat
Nicolaus I Bernoulli	Nikolaus I Bernoulli
Gwerer Puniċi	Punische oorlogen
Ġunone	Juno (mythologie)
Massimo Oddo	Massimo Oddo
Fraizer Campbell	Fraizer Campbell
Allianz Arena	Allianz Arena
San Ġużepp	Jozef van Nazareth
Hidetoshi Nakata	Hidetoshi Nakata
FK Borac Banja Luka	FK Borac Banja Luka
L-Aħħar Ċena (Leonardo)	Het Laatste Avondmaal (Leonardo da Vinci)
Macroscelididae	Springspitsmuizen
Dugongu	Doejong
Galway	Galway (stad)
Mario Balotelli	Mario Balotelli
Marvin Compper	Marvin Compper
Fenek ta' denbu qotni tal-muntanji	Bergkatoenstaartkonijn
Macbeth	Macbeth (toneelstuk)
Theria	Theria (zoogdieren)
Akropoli ta' Ateni	Akropolis van Athene
Filatelija	Filatelie
Stromboli	Stromboli (eiland)
The Fame	The Fame (album)
FK Austria Wien	FK Austria Wien
SK Rapid Wien	Rapid Wien
IMMAGINE&POESIA	Immagine & Poesia
Venere ta' Willendorf	Venus van Willendorf
Bandiera ta' Malta	Vlag van Malta
Teorija tal-grafi	Grafentheorie
Lola Pagnani	Lola Pagnani
Bitcoin	Bitcoin
Tim nazzjonali tal-futbol tad-Danimarka	Deens voetbalelftal
Black metal	Black metal
Ġeroglifiċi Eġizzjani	Egyptische hiërogliefen
Pika ta' Kozlov	Ochotona koslowi
Sataniżmu	Satanisme
Grawnd Nazzjonali ta' Bejġing	Nationaal Stadion van Peking
Stadio Giuseppe Meazza	Stadio Giuseppe Meazza
SC Wiener Neustadt	SC Wiener Neustadt
Plotinu	Plotinus
Tim nazzjonali tal-futbol tal-Kroazja	Kroatisch voetbalelftal
Eomanis	Eomanis
Tim nazzjonali tal-futbol tal-Greċja	Grieks voetbalelftal
Pika ta' Muli	Ochotona muliensis
Tazza tad-Dinja tal-Futbol tal-Klabbs 2006	Wereldkampioenschap voetbal voor clubs 2006
Tazza tad-Dinja tal-Futbol tal-Klabbs 2007	Wereldkampioenschap voetbal voor clubs 2007
Tazza tad-Dinja tal-Futbol tal-Klabbs 2009	Wereldkampioenschap voetbal voor clubs 2009
Tazza tad-Dinja tal-Futbol tal-Klabbs 2008	Wereldkampioenschap voetbal voor clubs 2008
Fenek tal-bassasa	Moeraskonijn
Yarala	Yarala
Fenek ta' denbu qotni tal-muntanji ta' Appalach	Appalachenkatoenstaart
Fenek ta' denbu qotni tal-muntanji ta' Manzano	Sylvilagus cognatus
Eklissi	Eclips (sterrenkunde)
Neymar	Neymar
Brendi	Brandewijn (drank)
Dominju (bijoloġija)	Domein (biologie)
Kassisa	Zwarte bes
Daniel Schneidermann	Daniel Schneidermann
Dragan Đokanović	Dragan Đokanović
David de Gea	David de Gea
Westfalenstadion	Signal Iduna Park
Robert Lewandowski	Robert Lewandowski
Għajnuna:Kif timmodifika artiklu	Help:Uitleg
Lidl	Lidl
Jupp Heynckes	Jupp Heynckes
Plutone (mitoloġija)	Pluto (mythologie)
Eddie Fenech Adami	Eddie Fenech Adami
Riccardo Montolivo	Riccardo Montolivo
Ġnien Botaniku ta' Mérida	Botanische Tuin van Mérida
Tazza tad-Dinja tal-Futbol tal-Klabbs 2010	Wereldkampioenschap voetbal voor clubs 2010
Cristian Zaccardo	Cristian Zaccardo
Gwerra totali	Totale oorlog
Nickelodeon	Nickelodeon (televisiezender)
Ugo Grozju	Hugo de Groot (rechtsgeleerde)
René Adler	René Adler
Eruka	Rucola
Ablativ	Ablatief
Tazza Ażjatika tal-Futbol	Aziatisch kampioenschap voetbal
Boomerang TV	Boomerang (zender)
Internazzjonali Soċjalista	Socialistische Internationale (1951)
Nannakola tas-seba' tikek	Zevenstippelig lieveheersbeestje
Santa Sede	Heilige Stoel
Ettore	Hektor (mythologie)
WK	Anno Domini
Reġina ta' Saba	Koningin van Seba
Alġebra astratta	Abstracte algebra
CONCACAF	CONCACAF
Skanderbeg	Skanderbeg
Tim nazzjonali tal-futbol tal-Iżvezja	Zweeds voetbalelftal
Raducz	Raducz
Paul Allen	Paul Allen
Eroj	Held
Kuopio	Kuopio
Sirt	Sirte
Vittoriosa Stars FC	Vittoriosa Stars
Soccer City	Soccer City
Tim nazzjonali tal-futbol tal-Awstrija	Oostenrijks voetbalelftal
Tim nazzjonali tal-futbol tal-Irlanda	Iers voetbalelftal
Nemanja Vidić	Nemanja Vidić
Derry	Derry (Verenigd Koninkrijk)
Ġuvni	Bachelor
Drużiżmu	Druzen
Omnivoru	Omnivoor
George Best	George Best
Oliver Twist	Oliver Twist
Javier Hernández Balcázar	Javier Hernández
Tim nazzjonali tal-futbol tal-Iżvizzera	Zwitsers voetbalelftal
Ekwazzjoni ta' Schrödinger	Schrödingervergelijking
Priżma	Prisma (optica)
Ballun tad-Deheb	Ballon d'Or
Tim nazzjonali tal-futbol tal-Polonja	Pools voetbalelftal
Foviżmu	Fauvisme
Tim nazzjonali tal-futbol tal-Belġju	Belgisch voetbalelftal
Dom Mintoff	Dom Mintoff
Sant'Antnin ta' Padova	Antonius van Padua
Eredivisie	Eredivisie (voetbal)
K. Sint-Niklase SKE	Sint-Niklase SK
Guido de Marco	Guido de Marco
Liebru iswed	Zwarte ezelhaas
Konfederazzjoni Afrikana tal-Futbol	Confédération Africaine de Football
Tim nazzjonali tal-futbol tar-Rumanija	Roemeens voetbalelftal
Dimitar Berbatov	Dimitar Berbatov
Tim nazzjonali tal-futbol tal-Ukrajna	Oekraïens voetbalelftal
Għawdex	Gozo
Tim nazzjonali tal-futbol tal-Ungerija	Hongaars voetbalelftal
Natura mejta	Stilleven
Laura Pausini	Laura Pausini
Gwerra Anglo-Żanżibarjana	Engels-Zanzibarese Oorlog
Children of Bodom	Children of Bodom
Festival tal-Eurovision 1956	Eurovisiesongfestival 1956
Tazza tal-Konfederazzjonijiet	FIFA Confederations Cup
Tim nazzjonali tal-futbol tas-Slovenja	Sloveens voetbalelftal
Darren Fletcher	Darren Fletcher
Gowler	Doelman
Mary Cassatt	Mary Cassatt
Frankinċens	Olibanum
Cape Town Stadium	Groenpuntstadion
Xenarthra	Xenarthra
Lista ta' kimiċi organiċi	Organische verbinding
Lira Maltija	Maltese lire
Antonio Valencia	Luis Antonio Valencia
Tim nazzjonali tal-futbol tas-Slovakkja	Slowaaks voetbalelftal
Tereża ta' Ávila	Theresia van Ávila
Guernica (pittura)	Guernica (schilderij)
Tim nazzjonali tal-futbol ta' New Zealand	Nieuw-Zeelands voetbalelftal
Kompjuter kwantistiku	Kwantumcomputer
Tazza tad-Dinja tal-Futbol 2010	Wereldkampioenschap voetbal 2010
Kantant	Zanger
Andrea Palladio	Andrea Palladio
Heurelho Gomes	Heurelho da Silva Gomes
Moviment Brownjan	Brownse beweging
Filosofija Presokratika	Presocratische filosofie
Marvin Ogunjimi	Marvin Ogunjimi
Apparat Periferali	Randapparaat
Meknès	Meknes
Copa América	Copa América
Żebbuġ (Għawdex)	Żebbuġ (Gozo)
Serje ta' Fourier	Fourierreeks
Santa Katarina ta' Lixandra	Catharina van Alexandrië
Lipari	Eolische Eilanden
Liebru tal-muntanji	Sneeuwhaas
Konfederazzjoni Oċeanika tal-Futbol	Oceania Football Confederation
Kwalifikazzjoni għall-Kampjonati Ewropej tal-Futbol 2012	Europees kampioenschap voetbal 2012 (kwalificatie)
Tim nazzjonali tal-futbol tal-Andorra	Andorrees voetbalelftal
Tim nazzjonali tal-futbol tal-Ażerbajġan	Azerbeidzjaans voetbalelftal
Klassifika dinjija tal-FIFA	FIFA-wereldranglijst
Charlotte Perrelli	Charlotte Perrelli
Tim nazzjonali tal-futbol tal-Bulgarija	Bulgaars voetbalelftal
Tim nazzjonali tal-futbol ta' Wales	Welsh voetbalelftal
Atomium	Atomium
Tim nazzjonali tal-futbol tal-Bożnija u Ħerżegovina	Bosnisch voetbalelftal
Tereża ta' Lisieux	Theresia van Lisieux
Tabella tal-midalji tal-Logħob Olimpiku tas-sajf 2008	Medaillespiegel van de Olympische Zomerspelen 2008
Ellis Park Stadium	Ellispark
Tazza Interkontinentali (futbol)	Wereldbeker voetbal
Bing	Bing (zoekmachine)
Plejer tas-Sena tal-FIFA	Wereldvoetballer van het jaar
Santa Luċija (qaddisa)	Lucia van Syracuse
Tim nazzjonali tal-futbol tal-Armenja	Armeens voetbalelftal
San Bastjan	Sebastiaan (heilige)
Kolugo	Huidvliegers
Tim nazzjonali tal-futbol tal-Każakistan	Kazachs voetbalelftal
Tazza tal-Konfederazzjonijiet 2009	FIFA Confederations Cup 2009
Pika	Fluithazen
Thomas Vermaelen	Thomas Vermaelen
UEFA Champions League 2009–10	UEFA Champions League 2009/10
Tim nazzjonali tal-futbol tal-Lussemburgu	Luxemburgs voetbalelftal
Gareth Bale	Gareth Bale
Inkwiżizzjoni Spanjola	Spaanse Inquisitie
Glen Johnson	Glen Johnson
Tim nazzjonali tal-futbol ta' San Marino	San Marinees voetbalelftal
Pika tal-kullar	Alaskafluithaas
Immakulata Kunċizzjoni	Onbevlekte Ontvangenis van Maria
Nigel de Jong	Nigel de Jong
Tim nazzjonali tal-futbol tal-Bjelorussja	Wit-Russisch voetbalelftal
Tim nazzjonali tal-futbol tal-Albanija	Albanees voetbalelftal
Tim nazzjonali tal-futbol tal-Ġeorġja	Georgisch voetbalelftal
Tim nazzjonali tal-futbol tal-Litwanja	Litouws voetbalelftal
Karmelitani	Karmelieten
UEFA Champions League 2007–08	UEFA Champions League 2007/08
Tim nazzjonali tal-futbol tal-Finlandja	Fins voetbalelftal
Tim nazzjonali tal-futbol tal-Liechtenstein	Liechtensteins voetbalelftal
Premier League 2008–09	Engels voetbalkampioenschap 2008/09
Tim nazzjonali tal-futbol tal-Estonja	Estisch voetbalelftal
Premier League 2010–11	Engels voetbalkampioenschap 2010/11
Ħin supplementari	Verlenging
Peter Mokaba Stadium	Peter Mokabastadion
Joe Hart	Joe Hart
Malena Ernman	Malena Ernman
Premier League 2007–08	Engels voetbalkampioenschap 2007/08
RSC Anderlecht	RSC Anderlecht
Barriera	Groeve
Oroskopju	Horoscoop
Eġizzjan demotiku	Demotisch
Fatt	Feit
FK Partizan	FK Partizan
Tim nazzjonali tal-futbol ta' Malta	Maltees voetbalelftal
Supereroj	Superheld
UEFA Champions League 2008–09	UEFA Champions League 2008/09
Tim nazzjonali tal-futbol ta' Ċipru	Cypriotisch voetbalelftal
Premier League 2009–10	Engels voetbalkampioenschap 2009/10
Tim nazzjonali tal-futbol tal-Montenegro	Montenegrijns voetbalelftal
Andrey Korotayev	Andrej Korotajev
UEFA Champions League 2010–11	UEFA Champions League 2010/11
Rafael Pereira da Silva (twieled fl-1990)	Rafael Pereira da Silva
FA Community Shield	FA Community Shield
Tim nazzjonali tal-futbol tal-Iżlanda	IJslands voetbalelftal
Tim nazzjonali tal-futbol tal-Unjoni Sovjetika	Voetbalelftal van de Sovjet-Unie
Tim nazzjonali tal-futbol tal-Latvja	Lets voetbalelftal
CONCACAF Gold Cup	CONCACAF Gold Cup
Pont du Gard	Pont du Gard
Sligo	Sligo (plaats)
Emblema ta' Malta	Wapen van Malta
Benvenuto Cellini	Benvenuto Cellini
Ordni Militari Sovran ta' Malta	Orde van Malta
Standard Liège	Standard Luik
Club Brugge KV	Club Brugge
Jóhanna Guðrún Jónsdóttir	Jóhanna Guðrún Jónsdóttir
Tim nazzjonali tal-futbol tal-Irlanda ta' Fuq	Noord-Iers voetbalelftal
Edward Sapir	Edward Sapir
Kemmuna	Comino
FC BATE Borisov	FK BATE Borisov
Lucrezia Borgia	Lucrezia Borgia
Klara ta' Assisi	Clara van Assisi
Tim nazzjonali tal-futbol tal-Iżrael	Israëlisch voetbalelftal
Gareth Barry	Gareth Barry
San Valentinu	Valentijn (heilige)
FK Ekranas	FK Ekranas Panevėžys
Mini ta' Cu Chi	Tunnelcomplex van Củ Chi
L-Innu Malti	L-Innu Malti
Midfilder	Middenvelder
Kwalifikazzjoni għat-Tazza tad-Dinja tal-Futbol 2010	Wereldkampioenschap voetbal 2010 (kwalificatie)
Kate Ryan	Kate Ryan
Lys Assia	Lys Assia
Patri Piju	Pater Pio
Analisi komplessa	Functietheorie
Martín Cáceres	Martín Cáceres
Opossum irqiq ta' rasu dejqa	Marmosops cracens
Phascomurexia	Phascomurexia naso
Opossum ġurdien tal-Messiku	Mexicaanse dwergbuidelrat
Opossum sufi ta' Derby	Derbywolhaarbuidelrat
Opossum grazzjuż ta' Aceramarca	Boliviaanse slanke buidelrat
Opossum ġurdien ta' Robinson	Marmosa robinsoni
Thylacinus	Thylacinus
Opossum ġurdien ta' Anderson	Marmosa andersoni
Opossum nanu mistur ta' żaqqu ħamra	Cryptonanus ignitus
Opossum nanu mistur ta' Agricola	Cryptonanus agricolai
Opossum ġurdien ta' Quechua	Marmosa quichua
Opossum ġurdien ta' Guajira	Marmosa xerophila
Opossum grazzjuż ta' Emilia	Gracilinanus emiliae
Opossum ġurdien ta' denbu oħxon eleganti	Thylamys elegans
Opossum irqiq ta' żaqqu bajda	Marmosops noctivagus
Murexechinus	Murexechinus melanurus
Opossum ġurdien sufi ta' denbu għarwien	Micoureus regina
Opossum irqiq ta' Pinheiro	Marmosops pinheiroi
Opossum bugeddum skur	Ecuadoropossummuis
Opossum grazzjuż ħafif	Gracilinanus agilis
Opossum sufi ta' denbu għarwien	Gele wolhaarbuidelrat
Opossum ġurdien sufi ta' żaqqu bajda	Micoureus constantiae
Opossum ta' denbu qasir tal-ġnub ħomor tat-Tramuntana	Monodelphis brevicaudata
Opossum ta' denbu qasir tat-tlett strixxi aħmar	Monodelphis umbristriata
Opossum ta' denbu qasir tat-tlett strixxi ta' Nofsinhar	Monodelphis theresa
Opossum ta' denbu qasir tat-tlett strixxi tat-Tramuntana	Gestreepte buidelspitsmuis
Opossum ġurdien sufi żgħir	Micoureus phaeus
Opossum ta' denbu qasir griż	Huisbuidelspitsmuis
Opossum ta' denbu qasir pigmew	Monodelphis kunsi
Opossum ta' denbu qasir tat-tlett strixxi ta' Ihering	Monodelphis iheringi
Opossum ta' denbu qasir tal-ġnub ħomor ta' Nofsinhar	Monodelphis sorex
Opossum ta' denbu qasir tal-istrixxi kannella ċar	Monodelphis rubida
Opossum ta' denbu qasir ta' Osgood	Monodelphis osgoodi
Opossum ta' denbu qasir tal-ġnub ħomor tal-Amażonja	Monodelphis glirina
Opossum ta' denbu qasir ta' imnieħru twil	Monodelphis scalops
Opossum ġurdien ta' denbu oħxon komuni	Thylamys pusillus
Opossum sufi ta' widnejh kannella	Rode wolhaarbuidelrat
Opossum ġurdien ta' Linnaeus	Aeneasrat
Opossum ġurdien aħmar	Marmosa rubra
Fenek ta' denbu qotni tal-muntanji ta' Davis	Sylvilagus robustus
Opossum grazzjuż tat-Tramuntana	Gracilinanus marica
Opossum grazzjuż tal-Brażil	Gracilinanus microtarsus
Opossum ta' denbu qasir tal-ġnub sofor	Monodelphis dimidiata
Opossum grazzjuż ta' Wood Sprite	Gracilinanus dryas
Opossum ġurdien ta' Tyleria	Marmosa tyleriana
Opossum irqiq ta' Tschudi	Marmosops impavidus
Opossum ġurdien ħamrani	Marmosa lepida
Opossum ġurdien sufi ta' Alston	Micoureus alstoni
Opossum ta' denbu qasir ta' Emilia	Monodelphis emiliae
Opossum ta' denbu qasir ta' Marajó	Monodelphis maraxina
Opossum irqiq griż	Marmosops incanus
Opossum ġurdien ta' denbu oħxon ta' Karimi	Thylamys karimii
Opossum ġurdien ta' denbu oħxon nanu	Thylamys velutinus
Opossum irqiq tal-Brażil	Marmosops paulensis
Opossum ġurdien ta' denbu oħxon ta' żaqqu kannella fl-isfar	Thylamys venustus
Opossum irqiq ta' Bishop	Marmosops bishopi
Opossum ġurdien ta' denbu oħxon ta' Tate	Thylamys tatei
Opossum irqiq ta' Junin	Marmosops juninensis
Opossum ġurdien ta' denbu oħxon ta' żaqqu bajda	Thylamys pallidior
Opossum ġurdien ta' denbu oħxon ta' Cinderella	Thylamys cinderella
Opossum ġurdien ta' denbu oħxon tal-Arġentina	Thylamys sponsorius
Opossum ġurdien sufi ta' Tate	Grijze dwergbuidelrat
Opossum irqiq ta' Neblina	Marmosops neblina
Opossum ġurdien ta' denbu oħxon tal-Paragwaj	Thylamys macrurus
Opossum ġurdien sufi tal-pil twil	Grauwe dwergbuidelrat
Opossum ta' denbu qasir tal-ġnub ħomor tal-kappa	Monodelphis palliolata
Opossum irqiq delikat	Marmosops parvidens
Opossum irqiq ta' Panama	Marmosops invictus
Opossum irqiq ta' Hendley	Handleys slanke dwergbuidelrat
Opossum irqiq skur	Marmosops fuscatus
Opossum ta' denbu qasir sepja	Monodelphis adusta
Royale Union Saint-Gilloise	Royale Union Saint-Gilloise
Łobez	Łobez
Fertilizzazzjoni ''in vitro''	In-vitrofertilisatie
Tim nazzjonali tal-futbol tal-Gżejjer Faroe	Faeröers voetbalelftal
Magnificat	Magnificat
Gowler (futbol)	Doelman (voetbal)
Theofanis Gekas	Theofanis Gekas
Ażerbajġan fil-Festival tal-Eurovision	Azerbeidzjan op het Eurovisiesongfestival
Papat ta' Avignon	Babylonische ballingschap der pausen
G-14	G-14
Glen Vella	Glen Vella
Armenja fil-Festival tal-Eurovision	Armenië op het Eurovisiesongfestival
Tereza Kerndlová	Tereza Kerndlová
Albanija fil-Festival tal-Eurovision	Albanië op het Eurovisiesongfestival
Rush	Rush (band)
Dundalk	Dundalk (Ierland)
Kumitat tar-Reġjuni	Comité van de Regio's
Id-Dsatax-il Emenda għall-Kostituzzjoni tal-Istati Uniti	Negentiende amendement van de grondwet van de Verenigde Staten
Mandejżmu	Mandaeërs
'O sole mio	'O sole mio
SK Sturm Graz	SK Sturm Graz
Il-Merkant ta’ Venezja	The Merchant of Venice
Hugo (film)	Hugo (2011)
Hapoel Tel Aviv FC	Hapoel Tel Aviv FC
UEFA Europa League 2009–10	UEFA Europa League 2009/10
Phil Jones	Phil Jones
UEFA Europa League 2010–11	UEFA Europa League 2010/11
Olympe de Gouges	Olympe de Gouges
Giovanni Falcone	Giovanni Falcone
Mdina	Mdina
Vulcano	Vulcano (eiland)
Tranquillo Barnetta	Tranquillo Barnetta
Liġi tan-numri kbar	Wetten van de grote aantallen
Andorra fil-Festival tal-Eurovision	Andorra op het Eurovisiesongfestival
Kitba jeratika	Hiëratisch schrift
Rapidshare	RapidShare
Batterija	Batterij
Kung fu	Kungfu
San Marino fil-Festival tal-Eurovision	San Marino op het Eurovisiesongfestival
Federico Macheda	Federico Macheda
Regola tal-gowls barra mid-dar	Uitdoelpunt
Ingólfr Arnarson	Ingólfur Arnarson
Talpa marsupjal ta' Nofs in-nhar	Gewone buidelmol
Talpa marsupjal tat-Tramuntana	Kleine buidelmol
Elezzjonijiet Ewropej 2009	Europese Parlementsverkiezingen 2009
KF Tirana	KF Tirana
Superliga Albaniża	Kategoria Superiore
Kewkba ta' Betlehem	Kerstster (religie)
FC Dinamo Minsk	Dinamo Minsk
Nick Drake	Nick Drake
Marokk fil-Festival tal-Eurovision	Marokko op het Eurovisiesongfestival
Zoran Tošić	Zoran Tošić
Golf	Golf
Kwalifikazzjoni għat-Tazza tad-Dinja tal-Futbol 2010 (UEFA)	Wereldkampioenschap voetbal 2010 (kwalificatie UEFA)
Palazz Belvedere	Slot Belvedere
Andrea Poli	Andrea Poli
Bjelorussja fil-Festival tal-Eurovision	Wit-Rusland op het Eurovisiesongfestival
Artemisia Gentileschi	Artemisia Gentileschi
Gżejjer Aran	Araneilanden
André Villas-Boas	André Villas-Boas
Samir Handanovič	Samir Handanovič
Ignazio Abate	Ignazio Abate
Gelson Fernandes	Gelson Fernandes
Idriss Carlos Kameni	Idriss Carlos Kameni
Marlee Matlin	Marlee Matlin
Dasyuromorphia	Roofbuideldieren
Football League	Football League
Fábio Pereira da Silva	Fábio Pereira da Silva
Antonio Nocerino	Antonio Nocerino
Mohamed Bouazizi	Mohammed Bouazizi
Anna Bergendahl	Anna Bergendahl
Denílson Pereira Neves	Denílson Pereira Neves
Emerson Ferreira da Rosa	Emerson Ferreira da Rosa
L-Ewwel Diviżjoni Belġjana	Eerste klasse (voetbal België)
KRC Genk	KRC Genk
Kalkulu tal-varjazzjonijiet	Variatierekening
Ġgantija	Megalithische tempels van Ġgantija
UNCLOS Konvenzjoni tal-Ġnus Magħquda dwar id-Dritt tal-Baħar	VN-zeerechtverdrag
Trama (narrattiva)	Plot
Filippu Neri	Filippus Neri
Neftchi Baku PFC	Neftçi Bakoe
Fenek ta' denbu qotni tal-artijiet baxxi tal-Veneżwela	Sylvilagus varynaensis
Bundesliga (Awstrija)	Bundesliga (Oostenrijk)
Al-Fatiħa	Soera De Opening
Tazza tal-Konfederazzjonijiet 2013	FIFA Confederations Cup 2013
Giuseppe Rossi	Giuseppe Rossi
Darron Gibson	Darron Gibson
Russja fil-Festival tal-Eurovision	Rusland op het Eurovisiesongfestival
Enzo Scifo	Enzo Scifo
Air Malta	Air Malta
Kwalifikazzjoni għat-Tazza tad-Dinja tal-Futbol 2010 (CONCACAF)	Wereldkampioenschap voetbal 2010 (kwalificatie CONCACAF)
F91 Dudelange	F91 Dudelange
FC Santa Coloma	FC Santa Coloma
KSC Lokeren Oost-Vlaanderen	KSC Lokeren Oost-Vlaanderen
AZAL PFK	AZAL PFK
Tito Vilanova	Tito Vilanova
Kwalifikazzjoni għat-Tazza tad-Dinja tal-Futbol 2010 (OFC)	Wereldkampioenschap voetbal 2010 (kwalificatie OFC)
Tazza tad-Dinja tal-Futbol tal-Klabbs	Wereldkampioenschap voetbal voor clubs
No (teatru)	No-spel
AFC	AFC
CAF	CAF
Premier League (diżambigwazzjoni)	Premier League (doorverwijspagina)
Alessandro Nesta	Alessandro Nesta
Johann Bernoulli	Johan Bernoulli
Tribù (bijoloġija)	Geslachtengroep
Santa Katerina ta' Siena	Catharina van Siena
Alexa Internet	Alexa Internet
Tupaja	Toepaja's
Liebru tal-Artiku	Poolhaas
Żarbuna tad-Deheb	Europees topschutter van het seizoen
Denis Law	Denis Law
Taljan	Italiaans
Al-Iħlas	Soera De Toewijding
Notoryctemorphia	Buidelmollen
Daniele Bonera	Daniele Bonera
Incertae sedis	Incertae sedis
Ġużeppina Bakhita	Jozephina Bakhita
Susanne Georgi	Susanne Georgi
Sofonisba Anguissola	Sofonisba Anguissola
Diana Gurtskaya	Diana Goertskaja
Elena Gheorghe	Elena Gheorghe
Hadise	Hadise
Lavinia Fontana	Lavinia Fontana
Marie Myriam	Marie Myriam
Nicole Hohloch	Nicole (Duitse zangeres)
Amanda Michalka	Amanda Michalka
Chiara Siracusa	Chiara Siracusa
Alyson Michalka	Alyson Michalka
Aysel Teymurzadeh	Aysel Teymurzadə
Olta Boka	Olta Boka
Magdalena Tul	Magdalena Tul
Premier League Armen	Bardzragujn chumb
Andrea Demirović	Andrea Demirović
Thea Garrett	Thea Garrett
Rosalba Carriera	Rosalba Carriera
4FUN	4Fun (Litouwse band)
Al-naxid al-xarif	Hymne Cherifien
Ġeorġja fil-Festival tal-Eurovision	Georgië op het Eurovisiesongfestival
FK Sarajevo	FK Sarajevo
Konvenzjoni ta' Vjenna dwar id-Dritt tat-Trattati	Verdrag inzake het verdragenrecht
Mathé Altéry	Mathé Altéry
Grupp D tal-Kampjonati Ewropej tal-Futbol 2008	Europees kampioenschap voetbal 2008/Groep D
Muniti tal-ewro ta' Malta	Maltese euromunten
Kampjonati Ewropej tal-Futbol 2008	Europees kampioenschap voetbal 2008
Myrmecobiidae	Numbat
Papessa Ġovanna	Pausin Johanna
Ġwann Marija Vianney	Johannes Maria Vianney
Ottorino Respighi	Ottorino Respighi
Storja ta' Malta	Geschiedenis van Malta
Fenek pigmew	Dwergkonijn
FC Pyunik	Pyunik Erevan
Mikrostat	Dwergstaat
Vinċenz de Paul	Vincentius a Paulo
Premier League Bjelorussu	Vysjejsjaja Liga
Linfield FC	Linfield FC
Peramelemorphia	Buideldassen
Anders Lindegaard	Anders Lindegaard
Florentino Pérez	Florentino Pérez
Ċipru fil-Festival tal-Eurovision	Cyprus op het Eurovisiesongfestival
Marca	Marca
Rabat	Rabat
Anton Buttigieg	Anton Buttiġieġ
Halloween	Halloween
Kuruna tal-Avvent	Adventskrans
FIFA	FIFA
Primera Divisió	Primera Divisió
Liebru Etjopjan	Ethiopische haas
Liebru tal-altipjan tal-Etjopja	Ethiopische hooglandhaas
Birżebbuġa	Birżebbuġa
Imblokk Kontinentali	Continentaal stelsel
Lista ta' pajjiżi skont l-erja	Lijst van landen naar oppervlakte
Sumgayit PFC	Sumqayıt PFK
Kampjonati Ewropej tal-Futbol	Europees kampioenschap voetbal
FC Wacker Innsbruck (2002)	FC Wacker Innsbruck (2002)
Msida Saint-Joseph FC	Msida Saint Joseph
Constant Vanden Stock Stadium	Constant Vanden Stockstadion
Pangolin ta' denbu twil	Langstaartschubdier
NK Široki Brijeg	NK Široki Brijeg
SV Mattersburg	SV Mattersburg
Jean Parisot de la Valette	Jean de la Valette
Wayne Rooney	Wayne Rooney
Marsa	Marsa (Malta)
Pietru Caxaro	Pietru Caxaro
Tim nazzjonali tal-futbol tal-Awstralja	Australisch voetbalelftal
Finali tat-Tazza tad-Dinja tal-Futbol 2006	Finale wereldkampioenschap voetbal 2006
Pangolin Malajan	Javaans schubdier
Nouvelle Fédération-Board	NF-Board
Alfonsu Marija de Liguori	Alfonsus van Liguori
Bulgarija fil-Festival tal-Eurovision	Bulgarije op het Eurovisiesongfestival
Ukraina fil-Festival tal-Eurovision	Oekraïne op het Eurovisiesongfestival
Bożnija u Ħerżegovina fil-Festival tal-Eurovision	Bosnië en Herzegovina op het Eurovisiesongfestival
Gwen John	Gwen John
Vande Mataram	Vande Mataram
Forma (botanika)	Vorm (biologie)
Attakkant	Aanvaller (voetbal)
Nihat Kahveci	Nihat Kahveci
Elisabetta Canalis	Elisabetta Canalis
Christina Metaxa	Christina Metaxa
Jetty Paerl	Jetty Paerl
Ira Losco	Ira Losco
Ilary Blasi	Ilary Blasi
Olivia Lewis	Olivia Lewis
Pika ta' Forrest	Ochotona forresti
Didelphis	Didelphis
Hasse Jeppson	Hasse Jeppson
CE Principat	CE Principat
Piero Soderini	Piero Soderini
Istitut tal-Unjoni Ewropea għall-Istudji dwar is-Sigurtà	Instituut voor veiligheidsstudies van de Europese Unie
Oscar Romero	Óscar Romero
Nickelodeon (Amerika)	Nickelodeon
Karl Shuker	Karl Shuker
Lisandro López	Lisandro López
Chris Eagles	Chris Eagles
Gianluca Ramazzotti	Gianluca Ramazzotti
Robertu Bellarmino	Robertus Bellarminus
St. Georges FC	St. George's FC
Fenek tax-xmara	Hottentothaas
Opossum ta' spallejh suwed	Gekraagde wolhaarbuidelrat
Fenek ta' Assam	Bengaals konijn
Den Dreef	Stadion Den Dreef
Salve Reġina	Salve Regina
FK Liepājas Metalurgs	FK Liepājas Metalurgs
Michael Mifsud	Michael Mifsud
L-Iklin	Iklin
John O'Shea	John O'Shea
Guillermo Stábile	Guillermo Stábile
Massimo Busacca	Massimo Busacca
Ritchie De Laet	Ritchie De Laet
Manucho Gonçalves	Manucho
Diego Cavalieri	Diego Cavalieri
Bernd Leno	Bernd Leno
Urby Emanuelson	Urby Emanuelson
Pika ta' Nubra	Ochotona nubrica
Pika ta' Gaoligong	Ochotona gaoligongensis
Liebru tad-deżert	Lepus tibetanus
Cryptonanus	Cryptonanus
Pika ħamra taċ-Ċina	Ochotona erythrotis
Pika ta' Thomas	Ochotona thomasi
Pika sewda	Ochotona nigritia
Micromurexia	Micromurexia habbema
Pika ta' Tsing-ling	Ochotona huangensis
Pika tal-Ħimalaja	Himalayafluithaas
Paolo Borsellino	Paolo Borsellino
Żurrieq FC	Zurrieq FC
Martin de Porres	Martinus van Porres
Jô	Jô
Grupp A tat-Tazza tad-Dinja tal-Futbol 2006	Wereldkampioenschap voetbal 2006/Groep A
Adem Ljajić	Adem Ljajić
Lucien Laurent	Lucien Laurent
Sebastian Prödl	Sebastian Prödl
Julien Faubert	Julien Faubert
Danny Simpson	Danny Simpson
Ruġġieru I ta' Sqallija	Rogier I van Sicilië
Michael Mancienne	Michael Mancienne
Dong Fangzhuo	Dong Fangzhuo
San Ġennaru	Januarius van Benevento
Carlos Eugênio Simon	Carlos Simon
Frans Sammut	Frans Sammut
Pascal Zuberbühler	Pascal Zuberbühler
Stanislav Šesták	Stanislav Šesták
Franco Di Santo	Franco Di Santo
Luis Monti	Luis Monti
Patrick Müller	Patrick Müller
Bachir Gemayel	Bashir Gemayel
Digão	Digão
Leonardo Sciascia	Leonardo Sciascia
Edward Maya	Edward Maya
Grupp A tal-Kampjonati Ewropej tal-Futbol 2008	Europees kampioenschap voetbal 2008/Groep A
Federazzjoni tal-Futbol tal-Andorra	Andorrese voetbalbond
Gonzalo Javier Rodríguez	Gonzalo Javier Rodríguez
Tazza tad-Dinja VIVA	VIVA-wereldkampioenschap voetbal
Premier League Malti	Premier League (Malta)
Serebro	Serebro
Nicolas Douchez	Nicolas Douchez
Kroazja fil-Festival tal-Eurovision	Kroatië op het Eurovisiesongfestival
La Liga	Primera División
Joel Obi	Joel Obi
Premier League Ażerbajġan	Premyer Liqası
Grupp Ġ tat-Tazza tad-Dinja tal-Futbol 2006	Wereldkampioenschap voetbal 2006/Groep G
Grupp Ċ tat-Tazza tad-Dinja tal-Futbol 2006	Wereldkampioenschap voetbal 2006/Groep C
Grupp E tat-Tazza tad-Dinja tal-Futbol 2006	Wereldkampioenschap voetbal 2006/Groep E
Grupp F tat-Tazza tad-Dinja tal-Futbol 2006	Wereldkampioenschap voetbal 2006/Groep F
Grupp D tat-Tazza tad-Dinja tal-Futbol 2006	Wereldkampioenschap voetbal 2006/Groep D
Alleati tat-Tieni Gwerra Dinjija	Geallieerden (Tweede Wereldoorlog)
Repubblika Ċeka fil-Festival tal-Eurovision	Tsjechië op het Eurovisiesongfestival
Valletta FC	Valletta FC
Serbja u Montenegro fil-Festival tal-Eurovision	Servië en Montenegro op het Eurovisiesongfestival
Jerzy Grotowski	Jerzy Grotowski
FC Ararat Yerevan	Ararat Jerevan
Gerald Strickland	Gerald Strickland
Gustavo Gutiérrez	Gustavo Gutierrez
Joe Sacco	Joe Sacco
Difensur	Verdediger (voetbal)
Liebru Abissinjan	Abessijnse haas
Achinoam Nini	Noa (zangeres)
Ħamrun	Ħamrun
Ħamrun Spartans FC	Hamrun Spartans
Caravaggio	Caravaggio
Eurovision (diżambigwazzjoni)	Euro-vision
Jores Okore	Jores Okore
Gary Neville	Gary Neville
Balzan FC	Balzan Youths
Roland Linz	Roland Linz
Johnny Leoni	Johnny Leoni
San Staniżlaw Martri	Stanislaus van Krakau
Emiliano Insúa	Emiliano Insúa
Tim Matthys	Tim Matthys
Ritratt ta' Adele Bloch-Bauer I	Portret van Adèle Bloch-Bauer I
Anthony Mamo	Anthony Mamo
Paul Van Himst	Paul Van Himst
György Garics	György Garics
Cercle Brugge KSV	Cercle Brugge
Adolfo Zumelzú	Adolfo Zumelzú
Assedju ta' Malta	Beleg van Malta
Opossum ta' erba' għajnejn kannella	Kaalstaartbuidelrat
KV Oostende	KV Oostende
Memorial Day	Memorial Day
Mixja Neokatekumenali	Neocatechumenaat
Bloggosfera	Blogosfeer
Life of Pi	Het leven van Pi
Lingwa tas-Sinjali Taljana	Italiaanse Gebarentaal
SV Zulte Waregem	SV Zulte Waregem
Semih Şentürk	Semih Şentürk
Helder Camara	Hélder Câmara
Tupaja tat-Tramuntana	Belangers toepaja
Dasyurus	Buidelmarters
Mattia De Sciglio	Mattia De Sciglio
San Gejtanu	Cajetanus van Thiene
Kurt Calleja	Kurt Calleja
Deividas Šemberas	Deividas Šemberas
Pawlu Miki	Paulus Miki
UEFA Europa League 2012–13	UEFA Europa League 2012/13
Ivan Leko	Ivan Leko
Ameridelphia	Ameridelphia
Marsaxlokk FC	Marsaxlokk FC
Servizz Awstrijak barra l-pajjiż	Vereniging voor Diensten in het Buitenland
Pangolin Ġgant	Reuzenschubdier
Jamāhīriyya	Jamahiriya
Lamantin Afrikan	West-Afrikaanse lamantijn
Congratulations (Eurovision)	Congratulations: 50 Jaar Eurovisiesongfestival
Serbja fil-Festival tal-Eurovision	Servië op het Eurovisiesongfestival
Assoċjazzjoni tal-Futbol Albaniż	Albanese voetbalbond
Mosta FC	Mosta FC
Inga u Anush Arshakyans	Inga & Anush
Gżira United FC	Gzira United
Żebbuġ	Żebbuġ
Dingli Swallows FC	Dingli Swallows FC
Fenek ta' denbu qotni tal-Ingilterra l-Ġdida	New-Englandkatoenstaart
OFC	OFC
Leporidu	Hazen
Andrea Petagna	Andrea Petagna
Università ta' Malta	Universiteit van Malta
Ħal Għaxaq	Għaxaq
Plesiadapiformes	Plesiadapiformes
Liebru xkupa	Cantabrische haas
Ungerija fil-Festival tal-Eurovision	Hongarije op het Eurovisiesongfestival
Pika tal-fidda	Ochotona argentata
Facundo Roncaglia	Facundo Roncaglia
Fredrik Stenman	Fredrik Stenman
Hilma af Klint	Hilma af Klint
Owen Hargreaves	Owen Hargreaves
Elvedin Džinić	Elvedin Džinič
Papa Franġisku	Paus Franciscus
Roman Kienast	Roman Kienast
Lamantin Amazoniku	Amazonelamantijn
SV Ried	SV Ried
Petr Elfimov	Pjotr Elfimov
Fabio Coltorti	Fabio Coltorti
Frederick Russell Burnham	Frederick Russell Burnham
Guillermo Subiabre	Guillermo Subiabre
Il-Ktieb ta' Mormon	Boek van Mormon
Santa Madalena Sofia Barat	Madeleine-Sophie Barat
Eddie Gustafsson	Eddie Gustafsson
Eva Gonzalès	Eva Gonzalès
Slovakkja fil-Festival tal-Eurovision	Slowakije op het Eurovisiesongfestival
Carlos Peucelle	Carlos Peucelle
Fud Leclerc	Fud Leclerc
Yulia Savicheva	Joelia Savitsjeva
Mattia Preti	Mattia Preti
Prospero Grech	Prospero Grech
Víctor Fernández	Víctor Fernández
It-Twerżiqa	De Schreeuw (schilderij)
Fabrizio Faniello	Fabrizio Faniello
Euarchontoglires	Euarchontoglires
Paramore	Paramore
Ħal Luqa	Luqa
Grupp B tal-Kampjonati Ewropej tal-Futbol 2008	Europees kampioenschap voetbal 2008/Groep B
Pangolin ta' Temminck	Temmincks schubdier
Festival tal-Eurovision taż-Żgħar 2008	Junior Eurovisiesongfestival 2008
Coritiba Foot Ball Club	Coritiba Foot Ball Club
Ajruport Internazzjonali ta' Tan Son Nhat	Internationale Luchthaven Tân Sơn Nhất
L-Uffiċċju tal-Pubblikazzjonijiet tal-Unjoni Ewropea	Bureau voor publicaties van de Europese Unie
Nani	Nani (voetballer)
Edwin van der Sar	Edwin van der Sar
Paolo Maldini	Paolo Maldini
Loreen	Loreen
Gonzalo Higuaín	Gonzalo Higuaín
Tim nazzjonali tal-futbol tat-Turkija	Turks voetbalelftal
Tim nazzjonali tal-futbol tar-Repubblika Ċeka	Tsjechisch voetbalelftal
Tomasz Kuszczak	Tomasz Kuszczak
Anderson Luís de Abreu Oliveira	Anderson Luís De Abreu Oliveira
UEFA Champions League 2011–12	UEFA Champions League 2011/12
Charles Manson	Charles Manson
UEFA Champions League 2012–13	UEFA Champions League 2012/13
Arda Turan	Arda Turan
Patt tas-Sindki	Burgemeestersconvenant
Oġġett (filosofija)	Object (filosofie)
RAEC Mons	RAEC Mons
Renault Samsung Motors	Renault Samsung Motors
Galatasaray SK	Galatasaray SK
Linosa	Linosa
Tazza tad-Dinja tal-Futbol tal-Klabbs 2005	Wereldkampioenschap voetbal voor clubs 2005
Tazza tad-Dinja tal-Futbol tal-Klabbs 2000	Wereldkampioenschap voetbal voor clubs 2000
Andrew Cohen	Andrew Cohen (voetballer)
Andrew Hogg	Andrew Hogg
Moldova fil-Festival tal-Eurovision	Moldavië op het Eurovisiesongfestival
Latvja fil-Festival tal-Eurovision	Letland op het Eurovisiesongfestival
Nichi Vendola	Nichi Vendola
Waasland-Beveren	KVRS Waasland - SK Beveren
Liebru ta' Yarkand	Jarkandhaas
Kwalifikazzjoni għat-Tazza tad-Dinja tal-Futbol 2010 (CONMEBOL)	Wereldkampioenschap voetbal 2010 (kwalificatie CONMEBOL)
KS Bylis Ballsh	KS Bylis Ballsh
Liebru ta' Granada	Iberische haas
Eurobandið	Eurobandið
Matías Suárez	Matías Suárez
Mircea Rednic	Mircea Rednic
Radja Nainggolan	Radja Nainggolan
Qormi FC	Qormi FC
Felipe Santana	Felipe Santana
Xgħajra	Xgħajra
André Schembri	Andre Schembri
Stade Charles Tondreau	Stade Charles Tondreau
Tibdil fil-Lingwa	Taalverandering
Ronaldo	Ronaldo Luis Nazário de Lima
Patrick Ouchène	Patrick Ouchène
Kaká	Kaká
FC Shakhtyor Salihorsk	Sjachtjor Salihorsk
Kalkara	Kalkara (Malta)
Wied il-Għajn (Marsaskala)	Marsaskala
Badjcinus	Badjcinus
Pika ta' Ladak	Ochotona ladacensis
Cofie Bekoe	Cofie Bekoe
Aleksandar Trajkovski	Aleksandar Trajkovski
Liebru l-ġebel aħmar ta' Smith	Smiths rotshaas
Planigale	Platkopbuidelmuizen
Liebru l-ġebel aħmar ta' Jameson	Jamesons rode rotshaas
FK Leotar	FK Leotar Trebinje
FC Neman Grodno	Neman Grodno
Rumanija fil-Festival tal-Eurovision	Roemenië op het Eurovisiesongfestival
Trofew Bravo	Europees voetballer van het jaar onder 21
Jelle Vossen	Jelle Vossen
Alfred Sant	Alfred Sant
Giuseppe Merisi	Giuseppe Merisi
Luka Peruzović	Luka Peruzović
Fenek tal-istrixxi ta' Annam	Nesolagus timminsi
Finali tal-UEFA Champions League 2013	Finale UEFA Champions League 2013
Tupaja ta' Horsfield	Javaanse toepaja
Lista tal-kodiċi nazzjonali tal-FIFA	Lijst van FIFA-landcodes
Liebru antilop	Ezelhaas
Liebru sufi	Tibetaanse haas
Tupaja tal-Filippini	Filipijnse toepaja
Senġi tal-buxxveld	Zuid-Afrikaanse olifantspitsmuis
Tupaja ta' Madras	Elliottoepaja
Tupaja komuni	Gewone toepaja
Senġi ħamrani	Rosse olifantspitsmuis
Fenek tal-art mistgħadra	Waterkonijn (haasachtige)
FC Mika	MIKA Ashtarak
Santa Venera	Santa Venera
Tazza tad-Dinja VIVA 2006	VIVA-wereldkampioenschap voetbal 2006
Pika tal-isteppa	Dwergfluithaas
Munxar	Munxar
Opossum nanu mistur ta' Rio Grande do Sul	Cryptonanus guahybae
Partit Nazzjonalista (Malta)	Partit Nazzjonalista
FC Minsk	FK Minsk
Ħal Kirkop	Kirkop
Sannat	Sannat (Gozo)
Urugan Felix (2007)	Felix (orkaan)
Super Cup Ewropea 2013	UEFA Super Cup 2013
Jeroen Simaeys	Jeroen Simaeys
Logħob tal-Pajjiżi ż-Żgħar tal-Ewropa 2009	Spelen van de Kleine Staten van Europa 2009
Xagħra	Xagħra
Fenek ta' denbu qotni tad-deżert	Woestijnkatoenstaartkonijn
FC Encamp	FC Encamp
Kon-Katidral ta' San Ġwann	Sint-Janscokathedraal
FIFA Puskás Award	FIFA Ferenc Puskás Award
Folivoru	Folivoor
KV Kortrijk	KV Kortrijk
Wikipedija:Abbrevjazzjoni	Wikipedia:Verwijzing
Croagh Patrick	Croagh Patrick
Australidelphia	Australidelphia
Gżira (lokalità)	Gżira
Tupaja ta' żaqqu dehebi	Tupaia chrysogaster
UE Sant Julià	UE Sant Julià
The Kite Runner	De vliegeraar
Luzzu	Luzzu
Fenek ta' Bunyoro	Midden-Afrikaans konijn
TM-XML	TM-XML
Liebru ta' denbu iswed	Zwartstaarthaas
Battalja ta' Champaubert	Slag bij Champaubert
Qerda tal-innoċenti	Kindermoord van Bethlehem
Senġi ta' Kap	Kaapse olifantspitsmuis
Beerschot AC	K. Beerschot AC
UE Santa Coloma	UE Santa Coloma
Malta fil-Festival tal-Eurovision	Malta op het Eurovisiesongfestival
Argosstadion Achter de Kazerne	Argosstadion Achter de Kazerne
Gianpaolo Bellini	Gianpaolo Bellini
Antechinus	Breedvoetbuidelmuizen
Tupaja ta' saqajħ twal	Langvoettoepaja
Sminthopsis	Smalvoetbuidelmuizen
Mario Been	Mario Been
Tupaja l-kbir	Tana (dier)
Alof de Wignacourt	Alof de Wignacourt
Ħal Safi	Safi (Malta)
Pika ħamra tat-Turkestan	Rode fluithaas
Mario Carević	Mario Carević
Japok	Wateropossum
Glires	Glires
Cinco de Mayo	Cinco de mayo
Litwanja fil-Festival tal-Eurovision	Litouwen op het Eurovisiesongfestival
Liebru ta' Tehuantepec	Mexicaanse haas
Shirak FC	Shirak Gyumri
Fenek tal-vulkan	Vulkaankonijn
San Ġiljan (lokalità)	San Ġiljan
Xlendi	Xlendi
Arjan Swinkels	Arjan Swinkels
Ouija Board	Ouijabord
Kerċem	Kerċem
Iqbal Masih	Iqbal Masih
San Franġisk t'Assisi	Franciscus van Assisi
Tim nazzjonali tal-futbol tal-Italja	Italiaans voetbalelftal
Insettivoru	Insectivoor
Daknamstadion	Daknamstadion
European Border Breakers Awards	European Border Breakers Award
Pietà Hotspurs FC	Pietà Hotspurs FC
Partit Laburista (Malta)	Malta Labour Party
Trzebinia	Trzebinia
Fenek ta' Amami	Amamikonijn
Mġarr	Mġarr
Argyrolagidae	Argyrolagidae
Kolokolo	Monito del monte
Opossum tal-Patagonja	Patagonische buidelrat
Wolfsberger AC	Wolfsberger AC
FK Khazar Lankaran	FK Khazar Lenkoran
SV Grödig	SV Grödig
FC Admira Wacker Mödling	FC Admira Wacker Mödling
Bolla fiskali	Fiscale zegel
SP Tre Penne	SP Tre Penne
FC Lusitanos	FC Lusitanos
Logan Bailly	Logan Bailly
Cartoon Network	Cartoon Network
De facto	De facto
Lista ta' pajjiżi skont il-popolazzjoni	Lijst van landen naar inwonertal
Klad	Clade
Joe Brincat	Joe Brincat
Kunsilli lokali ta' Malta	Districten van Malta
Grupp Ċ tal-Kampjonati Ewropej tal-Futbol 2008	Europees kampioenschap voetbal 2008/Groep C
Tim nazzjonali tal-futbol tal-Komunità tal-Istati Indipendenti	Voetbalelftal van Gemenebest van Onafhankelijke Staten
Vadis Odjidja-Ofoe	Vadis Odjidja-Ofoe
Inter Baku PFC	FK Inter Bakoe
FK Qarabağ	FK Qarabağ
Lierse SK	K. Lierse SK
Tim nazzjonali tal-futbol tar-Russja	Russisch voetbalelftal
FC Gomel	FC Homel
Floriana FC	Floriana FC
Euarchonta	Euarchonta
Assoċjazzjoni tal-Futbol ta' Malta	Maltese voetbalbond
Inter Club d'Escaldes	Inter Club d'Escaldes
Lorenzo Staelens	Lorenzo Staelens
Cobh	Cobh
László Köteles	László Köteles
John van den Brom	John van den Brom
Alex Thépot	Alex Thépot
Margaritu ta' Brindisi	Margaritus van Brindisi
Pawlu Boffa	Paul Boffa
Ġużeppi Moscati	Giuseppe Moscati
Rhynchocyon	Slurfhondjes
Dendrohyrax	Westelijke boomklipdas
Glaucodon	Glaucodon
Filfla	Filfla
Ħal Tarxien	Tarxien
Gilbert Agius	Gilbert Agius
Tupaja ta' denbu pinna	Vederstaarttoepaja
Liebru ta' Kap	Kaapse haas
Rabat Ajax FC	Rabat Ajax
Turan Tovuz PFC	PFK Turan Tovuz
JK Nõmme Kalju	Nõmme JK Kalju
Fond Soċjali Ewropew	Europees Sociaal Fonds
Birgu	Birgu
Rabat (Għawdex)	Victoria (Malta)
Pangolin tas-siġar	Afrikaans boomschubdier
Finali tal-Kampjonati Ewropej tal-Futbol 2008	Finale Europees kampioenschap voetbal 2008
Pangolin Indjan	Indisch schubdier
Axxendent	Ascendant en descendant
Filosofija Ellenistika	Hellenistische filosofie
L-Ewwel Diviżjoni tal-Football League	Football League First Division
Mellieħa	Mellieħa
Gżejjer ta' San Pawl	Islands of St. Paul
FC Belshina Bobruisk	Belshina Babrujsk
FC Torpedo-BelAZ Zhodino	Tarpeda-BelAZ Zjodzina
Bormla	Cospicua
FC Banants	Banants Erevan
Għajnsielem	Għajnsielem
Foeke Booy	Foeke Booy
David Hubert	David Hubert
Wakamatha	Wakamatha
Varjetà (botanika)	Variëteit (biologie)
It-Tieni Diviżjoni tal-Football League	Football League Second Division
FK Olimpic	FK Olimpik Sarajevo
Don Pino Puglisi	Pino Puglisi
FC Brest	Dinamo Brest
Tupaja tal-muntanji	Bergtoepaja
Fenek ta' denbu qotni tal-Lvant	Floridakonijn
Marsaxlokk	Marsaxlokk
Ħal Lija	Lija
Tlacuatzin	Tlacuatzin canescens
John Buttigieg	John Buttigieg
Olivier Deschacht	Olivier Deschacht
Ħal Balzan	Balzan
Birkirkara FC	Birkirkara FC
Trattat ta' Adeżjoni 2003	Verdrag tot toetreding (2003)
Familja Bernoulli	Bernoulli
Furjana	Floriana
FC Dnepr Mogilev	FK Dnepr Mahiljow
Grupp B tat-Tazza tad-Dinja tal-Futbol 2006	Wereldkampioenschap voetbal 2006/Groep B
Dugongidae	Doejongs
FC Naftan Novopolotsk	FC Naftan Navapolatsk
Ulisses FC	Uliss Erevan
Lista ta' lingwi uffiċjali	Lijst van officiële talen
Regina (grupp)	Regina (groep)
It-Tripletta	Treble (voetbal)
Partizani Tirana	Partizan Tirana
Kapaz PFC	Kəpəz PFK
Raħal Ġdid	Paola (Malta)
L-Isla	Senglea
Gandzasar FC	Gandzasar Kapan
Liebru ta' Burma	Birmaanse haas
Fenek ta' denbu qotni tal-foresta	Braziliaans konijn
Liebru tal-Alaska	Alaskahaas
Borussia Dortmund II	Borussia Dortmund II
UEFA Jubilee Awards	UEFA Jubilee Awards
Lemma ta’ Borel-Cantelli	Lemma van Borel-Cantelli
Apollo (divinità)	Apollo (god)
Ħad-Dingli	Dingli
Transnistrija	Transnistrië
Gabala FC	Qäbälä PFK
Necromanis	Necromanis
Għajnuna:Kontenut	Portaal:Hulp en beheer
Għajnuna:Gwida essenzjali	Wikipedia:Snelcursus
Oud-Heverlee Leuven	Oud-Heverlee Leuven
Logħob tal-Pajjiżi ż-Żgħar tal-Ewropa	Spelen van de Kleine Staten van Europa
Marca (gazzetta)	Marca (krant)
UE Engordany	UE Engordany
Siġġiewi	Siġġiewi
Xewkija	Xewkija
Ole Madsen	Ole Madsen
Pika ta' Turuchan	Ochotona turuchanensis
Caruana	Caruana
Cristal Arena	Cristal Arena
Francis Dickoh	Francis Dickoh
Senġi ta' erbat iswaba	Viertenige olifantspitsmuis
Tarxien Rainbows FC	Tarxien Rainbows
Liebru Taljan	Corsicaanse haas
Liebru ta' denbu abjad	Prairiehaas
Pika ta' Moupin	Tibetaanse fluithaas
Tupaja ż-żgħir	Kleine toepaja
Hibernians FC	Hibernians FC
Sarcophilus	Sarcophilus
Joseph Muscat	Joseph Muscat
Malta fil-Festival tal-Eurovision taż-Żgħar	Malta op het Junior Eurovisiesongfestival
Glen De Boeck	Glen De Boeck
Senġi ta' saqajħ skuri	Elephantulus fuscipes
Gipsy.cz	Gipsy.cz
Jurgen Cavens	Jurgen Cavens
Hany Ramzy	Hany Ramzy
Carmel Busuttil	Carmel Busuttil
Mario Muscat	Mario Muscat
Senġi skur	Elephantulus fuscus
Stade Maurice Dufrasne	Stade Maurice Dufrasne
KSV Waregem	KSV Waregem
Vito Plut	Vito Plut
Tupaja Kalamjan	Tupaia moellendorffi
Michael Essien	Michael Essien
Senġi ċċangjat	Gevlekt slurfhondje
Ġorġ Borg Olivier	George Borg Olivier
Stephen Wellman	Stephen Wellman
Enrico Mizzi	Enrico Mizzi
FC Red Bull Salzburg	Red Bull Salzburg
Festivalbar	Festivalbar
Fontana (Għawdex)	Fontana (Gozo)
Westport (Irlanda)	Westport (Ierland)
Għasri	Għasri
Ta' Xbiex	Ta' Xbiex
Liebru tax-xgħari	Struikhaas
Opossum ta' denbu sufi	Pluimstaartbuidelrat
Mqabba	Mqabba
Ħal Għargħur	Għargħur
Gudja	Gudja
Abraham Kumedor	Abraham Kumedor
Karmenu Mifsud Bonnici	Carmelo Mifsud Bonnici
Pika ta' Sardinja	Prolagus sardus
Liebru l-ġebel aħmar ta' Natal	Grote rode rotshaas
Simurq PFC	FK Simurq Zaqatala
Chacodelphys	Chacodelphys
Markapaġna	Bladwijzer (boek)
Madonna tal-Karmnu	Heilige Maagd Maria van de berg Karmel
Stejdjum Jan Breydel	Jan Breydelstadion
Opossum bugeddum ta' mnieħru twil	Chiliopossummuis
Liebru Ċiniż	Chinese haas
Santa Luċija, Malta	Santa Luċija
Manuel Pinto da Fonseca	Manuel Pinto de Fonseca
Premier League Malti 1909–10	Premier League (Malta) 1909/10
Cynocephalus volans	Filipijnse vliegende kat
Premier League Malti 1916–17	Premier League (Malta) 1916/17
Premier League Malti 1913–14	Premier League (Malta) 1913/14
Premier League Malti 1914–15	Premier League (Malta) 1914/15
Premier League Malti 1911–12	Premier League (Malta) 1911/12
Premier League Malti 1912–13	Premier League (Malta) 1912/13
Laurent Ciman	Laurent Ciman
K. Waterschei SV Thor Genk	Waterschei SV Thor
Senġi ta' wiċċu griż	Rhynchocyon udzungwensis
Luttu nazzjonali	Dag van nationale rouw
Apolonia Fier	Apolonia Fier
Senġi ta' widnejh tondi tal-Karù	Slurfspitsmuis
Liverpool FC	Liverpool FC
Flor-de-Lis	Flor-de-Lis
FIFPro	FIFPro
Pika tat-Tramuntana	Noordelijke fluithaas
Antechinomys	Australische buidelspringmuis
Waldo's People	Waldo's People
Stade du Pays de Charleroi	Stade du Pays de Charleroi
Subphylum	Onderstam (biologie)
Liebru Korean	Koreahaas
FC Slavia-Mozyr	FK Slavia-Mozyr
Pika ta' Daurian	Daurische fluithaas
Merlin (serje televiżiva)	Merlin (televisieserie)
Tim nazzjonali tal-futbol ta' Malta (nisa)	Maltees vrouwenvoetbalelftal
Wikipedija:Ambaxxata	Wikipedia:Ambassade
Fenek ta' denbu qotni ta' Dice	Dices katoenstaartkonijn
Lutreolina	Dikstaartbuidelrat
Kampjonat tal-futbol Ingliż 1888-89	Engels voetbalkampioenschap 1888/89
Karmenu Vella	Karmenu Vella
KS Lushnja	KS Lushnja
Sliema Wanderers FC	Sliema Wanderers
Liebru ta' Yunnan	Yunnanhaas
Jamie Pace	Jamie Pace
Pika tal-Afganistan	Perzische fluithaas
Scooch	Scooch
Senġi ta' taħt dahru dehebi	Goudstuitslurfhondje
KS Kastrioti	KS Kastrioti Krujë
Tupaja ta' Nikobar	Nicobarentoepaja
Pangolin ta' Palaw	Palawanschubdier
Tazza Maltija	Maltese voetbalbeker
Opossum bugeddum Peruvjan	Peruopossummuis
FK Tomori Berat	KS Tomori Berat
Kim Ojo	Kim Ojo
Shkumbini Peqin	KS Shkumbini Peqin
Grawnd Nazzjonali Ta' Qali	Ta' Qalistadion
Liebru ta' Hainan	Hainanhaas
Liebru ta' Tolai	Tolaihaas
Liebru Ġappuniż	Japanse haas
Candies (grupp)	Candies
Pika tax-xofftejn suwed	Zwartlipfluithaas
Palazz tal-Gran Mastru	Grootmeesterspaleis (Valletta)
Tazza tad-Dinja VIVA 2008	VIVA-wereldkampioenschap voetbal 2008
Ravan Baku FC	Ravan Bakoe
FK Rudar Prijedor	FK Rudar Prijedor
Wikipedija:Glossarju	Help:Terminologie op Wikipedia
Pseudantechinus	Pseudantechinus
Kategorija:Ġermanja	Categorie:Duitsland
Kategorija:Italja	Categorie:Italië
Kategorija:Stati Uniti	Categorie:Verenigde Staten
Kategorija:Russja	Categorie:Rusland
Kategorija:Renju Unit	Categorie:Verenigd Koninkrijk
Kategorija:Spanja	Categorie:Spanje
Kategorija:Indja	Categorie:India
Kategorija:Turkija	Categorie:Turkije
Kategorija:New Zealand	Categorie:Nieuw-Zeeland
Pixxivoru	Piscivoor
Senġi iswed u aħmar	Steppeslurfhondje
Phascolosorex	Gestreepte buidelmuizen
It-Tielet Diviżjoni tal-Football League	Football League Third Division
Kategorija:Afganistan	Categorie:Afghanistan
Kategorija:Alġerija	Categorie:Algerije
Kategorija:Awstrija	Categorie:Oostenrijk
Kategorija:Pajjiżi l-Baxxi	Categorie:Nederland
Kategorija:Niġerja	Categorie:Nigeria
Kategorija:Polonja	Categorie:Polen
Kategorija:Portugall	Categorie:Portugal
Kategorija:Żvizzera	Categorie:Zwitserland
Kategorija:Ukraina	Categorie:Oekraïne
Kategorija:Vjetnam	Categorie:Vietnam
Kategorija:Fiżika	Categorie:Natuurkunde
Kategorija:Bijoloġija	Categorie:Biologie
Kategorija:Kimika	Categorie:Scheikunde
Kategorija:Storja	Categorie:Geschiedenis
Kategorija:Ġeografija	Categorie:Geografie
Kategorija:Arti viżiva	Categorie:Beeldende kunst
Kategorija:Reliġjon	Categorie:Religie
Kategorija:Sport	Categorie:Sport
Kategorija:Xjenza	Categorie:Wetenschap
Kategorija:Unjoni Ewropea	Categorie:Europese Unie
Kategorija:Ċinema	Categorie:Film
Kategorija:Komunikazzjoni	Categorie:Communicatie
Liebru Indjan	Zwartnekhaas
Liebru tal-ġnub bojod	Witflankhaas
Liebru Manċurjan	Mandsjoerijse haas
Dasycercus	Kamstaartbuidelmuizen
MICHAEL	MICHAEL (webportal)
Myoictis	Gestreepte buidelmarters
Premier League 2011–12	Engels voetbalkampioenschap 2011/12
Fenek xkupilja	Californisch konijn
Marco Ureña	Marco Ureña
Paramurexia	Paramurexia
Gohi Bi Zoro Cyriac	Gohi Bi Zoro Cyriac
Palazz ta' Sant'Anton	San Anton Palace
Fenek ta' denbu qotni tal-Messiku	Mexicaanse katoenstaartkonijn
Liebru tas-savana Afrikana	Savannehaas
Herman Vanderpoortenstadion	Herman Vanderpoortenstadion
Fenek ta' denbu qotni ta' Omiltemi	Omiltemikatoenstaartkonijn
Stat kostrutt	Status constructus
Kategorija:Mietu fl-2012	Categorie:Lijsten van personen overleden in 2012
Partit Nazzjonalista	Nationale Partij
Jules Ottenstadion	Jules Ottenstadion
Juvenes Translatores	Juvenes Translatores
Kevin Sammut	Kevin Sammut
Phascogale	Penseelstaartbuidelmuizen
Ningaui	Ningaui's
Senġi tal-blat tal-Punent	Klipolifantspitsmuis
Tupaja ta' Palaw	Palawantoepaja
Pika ta' Glover	Ochotona gloveri
Fenek tat-Tres Marias	Tres Maríaskatoenstaart
Tupaja rqiq	Slanke toepaja
Tupaja mpitter	Getekende toepaja
Senġi tas-Somalja	Somaliolifantspitsmuis
Christian Brüls	Christian Brüls
Pika ta' Pallas	Mongoolse fluithaas
Tupaja ta' denbu lixx tat-Tramuntana	Noordelijke zachtstaarttoepaja
Tupaja ta' denbu lixx ta' Borneo	Zuidelijke zachtstaarttoepaja
Senġi ta' wiċċu qasir	Kortneusolifantspitsmuis
Senġi tal-blat tal-Lvant	Oostelijke rotssengi
Pika ta' Hoffmann	Ochotona hoffmanni
Pika ta' Gansu	Ochotona cansus
Tupaja ħamrani	Roodstaarttoepaja
Fenek xkupilja ta' San Jose	San José-Bachmankonijn
Tupaja strixxat	Gestreepte toepaja
Pika tal-widnejn kbar	Grootoorfluithaas
No. 5, 1948	No. 5, 1948
Senġi tal-Afrika ta' Fuq	Noord-Afrikaanse olifantspitsmuis
Ħin tal-Afrika tal-Lvant	Oost-Afrikaanse Tijd
Ben Yagan	Ben Yagan
Liora	Liora Simon
Nicklas Helenius	Nicklas Helenius Jensen
Regenboogstadion	Regenboogstadion
Aleksandar Tonev	Aleksandar Tonev
Jacky Mathijssen	Jacky Mathijssen
Robin Henkens	Robin Henkens
Roei Dayan	Roy Dayan
Merkurju	Mercure
Jim Larsen	Jim Larsen
Logħob tal-Pajjiżi ż-Żgħar tal-Ewropa 2011	Spelen van de Kleine Staten van Europa 2011
Mustapha Jarju	Mustapha Jarju
Kategorija:Ekoloġija	Categorie:Ecologie
Lista tal-ispeċi tal-mammiferi l-ġodda li ġew deskritti xjentifikament fis-sena 2003	Lijst van nieuw beschreven zoogdieren (2003)
Kategorija:Diżambigwazzjoni	Categorie:Wikipedia:Doorverwijspagina
Kategorija:Olimpjadi	Categorie:Olympische Spelen
Kategorija:Filosofija	Categorie:Filosofie
Kategorija:Psikoloġija	Categorie:Psychologie
Kategorija:Buddiżmu	Categorie:Boeddhisme
Kategorija:Kristjaneżmu	Categorie:Christendom
Kategorija:Induiżmu	Categorie:Hindoeïsme
Kategorija:Iżlam	Categorie:Islam
Kategorija:Ġudaiżmu	Categorie:Jodendom
Oġġett	Object
Michael Degiorgio	Michael Degiorgio
Wallace Fernando Pereira	Wallace Fernando Pereira
Malta fil-Festival tal-Eurovision 2009	Malta op het Eurovisiesongfestival 2009
Alashkert FC	Alashkert FC
Darren Keet	Darren Keet
Lista tal-ispeċi tal-mammiferi l-ġodda li ġew deskritti xjentifikament fis-sena 2001	Lijst van nieuw beschreven zoogdieren (2001)
Ahmed Samir Farag	Ahmed Samir Farag
Melita FC	Melita FC
Davy De Fauw	Davy De fauw
Lista ta' l-ispeċi tal-mammiferi l-ġodda li ġew deskritti xjentifikament fis-sena 2005	Lijst van nieuw beschreven zoogdieren (2005)
Kanzunetta Maltija għall-Ewropa	Malta Song for Europe
Francisco Martos	Francisco Martos
Keeuna	Keeuna
Freethiel Stadion	Freethiel
Opossum nanu mistur tal-Bolivja	Cryptonanus unduaviensis
Ronaldo (diżambigwazzjoni)	Ronaldo
Ġan Franġisk Abela	Giovanni Francesco Abela
Lingwa tas-Sinjali Olandiża	Nederlandse Gebarentaal
Forti Sant’Anġlu	Fort Sint-Angelo
Dasylurinja	Dasylurinja
Hein Vanhaezebrouck	Hein Vanhaezebrouck
Peter Maes	Peter Maes
Barinya	Barinya
Puyenbekestadion	Puyenbekestadion
Michy Batshuayi	Michy Batshuayi
Frederik Vanderbiest	Frederik Vanderbiest
Malta fil-Festival tal-Eurovision 2013	Malta op het Eurovisiesongfestival 2013
Prorastomus	Prorastomus
Stefan Sultana	Stefan Sultana
Francky Dury	Francky Dury
Bochotnica	Bochotnica
Lista ta' l-ispeċi tal-mammiferi l-ġodda li ġew deskritti xjentifikament fis-sena 2002	Lijst van nieuw beschreven zoogdieren (2002)
Ganbulanyi	Ganbulanyi
Juan Carlos Garrido	Juan Carlos Garrido
Fede Galizia	Fede Galizia
Stat Iżlamiku	Islamitische Staat (in Irak en de Levant)
Guillermo Burdisso	Guillermo Burdisso
Benedicta Boccoli	Benedicta Boccoli
Chucks Nwoko	Chucks Nwoko
Senġi tal-blat tal-Karù	Elephantulus pilicaudus
Opossum nanu mistur ta' Chacoan	Cryptonanus chacoensis
Jérémy Taravel	Jérémy Taravel
Mixodectidae	Mixodectidae
Lista ta' l-ispeċi tal-mammiferi l-ġodda li ġew deskritti xjentifikament fis-sena 2004	Lijst van nieuw beschreven zoogdieren (2004)
Palaeolagus	Palaeolagus
Ankotarinja	Ankotarinja
Arnar Viðarsson	Arnar Viðarsson
Kastell ta' Rayen	Rayen-kasteel
Harm van Veldhoven	Harm van Veldhoven
Plagiomenidae	Plagiomenidae
Antonio Luna Rodríguez	Antonio Luna (voetballer)
Metaxytherium	Metaxytherium
Procavia	Rotsklipdassen
Opossum irqiq ta' Creighton	Marmosops creightoni
Argyrolagus	Argyrolagus
Detritivoru	Detrivoor
Albertparkstadion	Albertparkstadion
Alessandro Cordaro	Alessandro Cordaro
Orycteropodidae	Buistandigen
Kategorija:Abbozzi	Categorie:Wikipedia:Beginnetje
Kategorija:Pjaneti	Categorie:Planeet
Kategorija:Abbozzi tal-mużika	Categorie:Wikipedia:Beginnetje muziek
Kategorija:Abbozzi tal-kultura	Categorie:Wikipedia:Beginnetje kunst & cultuur
Kategorija:Kultura	Categorie:Cultuur
Kategorija:Snin	Categorie:Jaren
Kategorija:Xjenzi soċjali	Categorie:Geesteswetenschappen
Kategorija:Kontinenti	Categorie:Continent
12 Years a Slave	12 Years a Slave
Għajnuna:Gwida essenzjali/Editjar	Wikipedia:Snelcursus/Bewerken
Mudell:SistemaSolari	Sjabloon:Navigatie zonnestelsel
Sezzjoni (botanika)	Sectie (biologie)
Wikipedija:Konvenzjonijiet ta' nomenklatura	Wikipedia:Benoemen van een pagina
Sottoġeneru	Ondergeslacht
Opossum ta' denbu qasir tal-Perù	Monodelphis ronaldi
Opossum ta' denbu qasir ta' Reig	Monodelphis reigi
Naxxar Lions FC	Naxxar Lions FC
Ronny Van Geneugden	Ronny Van Geneugden
Prorastomidae	Prorastomidae
Għajnuna:Kif tirreġistra	Help:Aanmelden
Għajnuna:Wikiketta	Wikipedia:Wikiquette
Kategorija:Bots tal-Wikipedija	Categorie:Wikipedia:Bots
Polydolopimorphia	Polydolopimorphia
Procaviidae	Klipdassen
Mudell:Kwota	Sjabloon:Citaat
Kategorija:Nies Taljani	Categorie:Italiaans persoon
Kategorija:Mużiċisti Amerikani	Categorie:Amerikaans musicus
Kategorija:Futbolers Ġermaniżi	Categorie:Duits voetballer
Protosiren	Protosiren
Mudell:Tl	Sjabloon:Tl
Mudell:Kaxxa tal-utent	Sjabloon:Gebruikersbox
Sergio Mattarella	Sergio Mattarella
Danail Mitev	Danail Mitev
Kategorija:Pajjiżi	Categorie:Land
Wikipedija:Amministraturi	Wikipedia:Moderator
Kategorija:Każakistan	Categorie:Kazachstan
Wikipedija:Amministraturi/Kandidati	Wikipedia:Aanmelding moderatoren
Wikipedija:Bot	Wikipedia:Bots
Kategorija:Kategoriji moħbija	Categorie:Wikipedia:Verborgen categorie
Kategorija:Internet	Categorie:Internet
Kategorija:Botanika	Categorie:Plantkunde
Kategorija:Politika	Categorie:Politiek
Kategorija:Arti	Categorie:Kunst
Eġittu	Egypte (land)
Kategorija:2013	Categorie:2013
Bryan Cristante	Bryan Cristante
Mudell:Bot	Sjabloon:Bot
Kanada	Canada
Kategorija:Ungerija	Categorie:Hongarije
Kategorija:Stati membri tal-Unjoni Ewropea	Categorie:Lidstaat van de Europese Unie
Kategorija:Belġju	Categorie:België
Kategorija:Ċekja	Categorie:Tsjechië
Kategorija:Danimarka	Categorie:Denemarken
Kategorija:Estonja	Categorie:Estland
Kategorija:Finlandja	Categorie:Finland
Kategorija:Latvja	Categorie:Letland
Kategorija:Iżlanda	Categorie:IJsland
Kategorija:Litwanja	Categorie:Litouwen
Kategorija:Malta	Categorie:Malta
Kategorija:Żvezja	Categorie:Zweden
Kategorija:Slovakkja	Categorie:Slowakije
Kategorija:Slovenja	Categorie:Slovenië
Kategorija:Repubblika tal-Irlanda	Categorie:Ierland
Kategorija:Artikli fil-vetrina	Categorie:Wikipedia:Etalage-artikelen
Wikipedija:Rispons tal-esperjenza tal-utent	Wikipedia:Feedback voor het User Experience Team
Kategorija:Logħob elettroniku	Categorie:Computerspel
Wikipedija:Bot/Rikjesti	Wikipedia:Verzoekpagina voor bots
Mudell:Flagicon	Sjabloon:Vlagland
Kategorija:Pajjiżi tal-Ewropa	Categorie:Land in Europa
Kategorija:Ewropa	Categorie:Europa
Kategorija:Għajnuna	Categorie:Wikipedia:Help
Mudell:Dokumentazzjoni	Sjabloon:Sjabdoc
Wikipedija:Bot/Rikjesti għall-approvazzjoni	Wikipedia:Aanmelding botgebruikers
Wikipedija:Politika dwar il-protezzjoni	Help:Beveiligde pagina's
Kategorija:Wikipedjani	Categorie:Wikipedia:Gebruikers
Wikipedija:Kunsens	Wikipedia:Consensus
Wikipedija:L-ebda attakk personali	Wikipedia:Geen persoonlijke aanvallen
Wikipedija:Kuntatt	Help:Contact met Wikipedia
Kategorija:Utenti skont il-lingwa	Categorie:Wikipedia:Babel
Kategorija:Politiki tal-Wikipedija	Categorie:Wikipedia:Richtlijnen
Wikipedija:Sondaġġi	Wikipedia:Stemlokaal
Wikipedija:Firem	Wikipedia:Ondertekening
Wikipedija:Abbozz	Wikipedia:Beginnetje
Wikipedija:Artikli rikjesti	Wikipedia:Gewenste artikelen
Mudell:Softredirect	Sjabloon:Softredirect
Mudell:Ħassar minnufih	Sjabloon:Nuweg
Kategorija:Lingwa	Categorie:Taal
Għajnuna:Kif tibda artiklu	Help:Nieuwe pagina aanmaken
Kategorija:Wikipedija	Categorie:Encyclopedie Wikipedia
Kanċillier tal-Ġermanja	Bondskanselier van Duitsland
Wikipedija:Ċaħda ġenerali	Wikipedia:Vrijwaringsclausule
Kategorija:Paġni mhux indiċizzati	Categorie:Wikipedia:Niet te indexeren pagina's
Wikipedija:Mudelli kollha	Wikipedia:Sjablonen voor artikelboodschappen
Kategorija:Avvenimenti kurrenti	Categorie:Actuele gebeurtenis
Wikipedija:Manwal tal-istil	Wikipedia:Conventies
Mudell:Navbox	Sjabloon:Navigatie
Mudell:Abbrevjazzjoni	Sjabloon:Verwijzing
Kategorija:Żoni tal-ħin	Categorie:Tijdzone
Galeopterus variegatus	Maleise vliegende kat
Eżametru dattiliku	Dactylische hexameter
Festival tal-Eurovision 2014	Eurovisiesongfestival 2014
Kategorija:Mudelli ta' bnadar	Categorie:Wikipedia:Sjablonen vlag
Mudell:!-	Sjabloon:!-
Mudell:!!	Sjabloon:!!
Mudell:=	Sjabloon:=
Mudell:Tnavbar	Sjabloon:Tnavbar
Mudell:Ċiklu	Sjabloon:Loop
Mudell:0	Sjabloon:0
Kategorija:Mudelli ta' formattjar	Categorie:Wikipedia:Sjablonen opmaak
Mudell:Clear	Sjabloon:Clearboth
Il-Portal tad-Dejta Miftuħa tal-UE	Opendataportaal van de EU
Mudell:Kulur	Sjabloon:Tekstkleur
Mudell:Deskrizzjoni kmand	Sjabloon:Afkorting
FK Mladost Velika Obarska	FK Mladost Velika Obarska
Wikipedija:Lista ta' artikli li kull Wikipedija għandu jkollha	Wikipedia:Archief/Wikipedia:Artikelen die elke Wikipedia zou moeten hebben
Kategorija:Afrika	Categorie:Afrika
Kategorija:Elettronika	Categorie:Elektronica
Kategorija:Xhur tas-sena	Categorie:Maand
Mudell:Wikisors	Sjabloon:Wikisource
Mudell:Babel	Sjabloon:Babel
Mudell:Commons	Sjabloon:Commons
Mudell:Link GA	Sjabloon:Link GA
Mudell:Referenzi	Sjabloon:References
Kategorija:Avvenimenti sportivi kurrenti	Categorie:Actuele sportgebeurtenis
Opossum ta' denbu qasir ta' strixxa waħda	Monodelphis unistriata
Għajnuna:Esplora lill-Wikipedija	Help:Zoeken
Mudell:Stub	Sjabloon:Beginnetje
Mudell:Utent ar-1	Sjabloon:Gebruiker ar-1
Mudell:Utent az	Sjabloon:Gebruiker az
Mudell:Utent be-2	Sjabloon:Gebruiker be-2
Mudell:Utent da-1	Sjabloon:Gebruiker da-1
Mudell:Utent bg-1	Sjabloon:Gebruiker bg-1
Mudell:Utent eo-3	Sjabloon:Gebruiker eo-3
Mudell:Utent de	Sjabloon:Gebruiker de
Mudell:Utent de-1	Sjabloon:Gebruiker de-1
Mudell:Utent el	Sjabloon:Gebruiker el
Mudell:Utent es	Sjabloon:Gebruiker es
Mudell:Utent de-3	Sjabloon:Gebruiker de-3
Mudell:Utent en-3	Sjabloon:Gebruiker en-3
Mudell:Utent en-1	Sjabloon:Gebruiker en-1
Mudell:Utent en-2	Sjabloon:Gebruiker en-2
Mudell:Utent en-4	Sjabloon:Gebruiker en-4
Mudell:Utent en	Sjabloon:Gebruiker en
Mudell:Utent de-2	Sjabloon:Gebruiker de-2
Mudell:Utent es-1	Sjabloon:Gebruiker es-1
Mudell:Utent fa	Sjabloon:Gebruiker fa
Mudell:Utent fr-1	Sjabloon:Gebruiker fr-1
Mudell:Utent ia-2	Sjabloon:Gebruiker ia-2
Mudell:Utent hr	Sjabloon:Gebruiker hr
Mudell:Utent it-3	Sjabloon:Gebruiker it-3
Mudell:Utent grc-1	Sjabloon:Gebruiker grc-1
Mudell:Utent ja-4	Sjabloon:Gebruiker ja-4
Mudell:Utent sk	Sjabloon:Gebruiker sk
Mudell:Utent tr-2	Sjabloon:Gebruiker tr-2
Mudell:Utent fr-2	Sjabloon:Gebruiker fr-2
Mudell:Utent ja	Sjabloon:Gebruiker ja
Mudell:Utent it-1	Sjabloon:Gebruiker it-1
Mudell:Utent fr	Sjabloon:Gebruiker fr
Mudell:Ebda firma	Sjabloon:Afzender
Mudell:Pl	Sjabloon:Pl
Kategorija:Turiżmu	Categorie:Toerisme
Kategorija:1957	Categorie:1957
Kategorija:1949	Categorie:1949
Kategorija:1927	Categorie:1927
Kategorija:1919	Categorie:1919
Kategorija:Moldova	Categorie:Moldavië
Kategorija:Ażerbajġan	Categorie:Azerbeidzjan
Mudell:Plejers fit-tim tal-futbol/nofs	Sjabloon:Voetbalselectie mid
Kategorija:Asja	Categorie:Azië
Kategorija:Ċili	Categorie:Chili
Kategorija:Seklu 21	Categorie:21e eeuw
Kategorija:Utenti uk	Categorie:Wikipedia:Gebruiker uk
Kategorija:1930	Categorie:1930
Kategorija:Utenti uk-N	Categorie:Wikipedia:Gebruiker uk-M
Kategorija:1936	Categorie:1936
Kategorija:1947	Categorie:1947
Kategorija:1937	Categorie:1937
Kategorija:1940	Categorie:1940
Kategorija:1934	Categorie:1934
Kategorija:1960	Categorie:1960
Kategorija:1943	Categorie:1943
Kategorija:1951	Categorie:1951
Kategorija:1942	Categorie:1942
Kategorija:1959	Categorie:1959
Kategorija:1938	Categorie:1938
Kategorija:1928	Categorie:1928
Kategorija:1913	Categorie:1913
Kategorija:1918	Categorie:1918
Kategorija:1954	Categorie:1954
Kategorija:1941	Categorie:1941
Kategorija:1955	Categorie:1955
Kategorija:1950	Categorie:1950
Kategorija:1921	Categorie:1921
Kategorija:1977	Categorie:1977
Kategorija:1946	Categorie:1946
Kategorija:1948	Categorie:1948
Kategorija:1932	Categorie:1932
Mudell:Plejers fit-tim tal-futbol	Sjabloon:Voetbalselectie speler
Kategorija:Futbol	Categorie:Voetbal
Kategorija:1945	Categorie:1945
Mudell:Mod	Sjabloon:Modulo
Kategorija:1923	Categorie:1923
Kategorija:1935	Categorie:1935
Kategorija:1910	Categorie:1910
Kategorija:1917	Categorie:1917
Kategorija:1904	Categorie:1904
Kategorija:1926	Categorie:1926
Kategorija:1907	Categorie:1907
Kategorija:1914	Categorie:1914
Mudell:Utent sv	Sjabloon:Gebruiker sv
Kategorija:1929	Categorie:1929
Kategorija:1920	Categorie:1920
Mudell:Utent it	Sjabloon:Gebruiker it
Kategorija:1925	Categorie:1925
Mudell:Utent uk	Sjabloon:Gebruiker uk
Kategorija:1905	Categorie:1905
Kategorija:1915	Categorie:1915
Mudell:Utent es-2	Sjabloon:Gebruiker es-2
Kategorija:1908	Categorie:1908
Kategorija:Mudelli ta' avviż	Categorie:Wikipedia:Sjablonen gebruikersboodschap
Kategorija:1901	Categorie:1901
Kategorija:1903	Categorie:1903
Kategorija:1902	Categorie:1902
Kategorija:1900	Categorie:1900
Mudell:Ru	Sjabloon:Ru
Mudell:PaġnaPrinċipali/Proġetti	Sjabloon:Hoofdpagina/Projecten
Kategorija:1933	Categorie:1933
Kategorija:1912	Categorie:1912
Mudell:Xhur	Sjabloon:Navigatie maanden
Kategorija:Klabbs tal-futbol Ingliżi	Categorie:Engelse voetbalclub
Kategorija:Mudelli tal-koordinati	Categorie:Wikipedia:Sjablonen coördinaten
Kategorija:Klabbs tal-futbol Spanjoli	Categorie:Spaanse voetbalclub
Kategorija:1952	Categorie:1952
Mudell:Premier League	Sjabloon:Navigatie voetbal Engeland Premier League
Kategorija:Klabbs tal-futbol Ġermaniżi	Categorie:Duitse voetbalclub
Kategorija:Lingwistika	Categorie:Taalkunde
Mudell:Football kit	Sjabloon:Tenue voetbal
Kategorija:1911	Categorie:1911
Kategorija:1922	Categorie:1922
Kategorija:1924	Categorie:1924
Kategorija:1906	Categorie:1906
Kategorija:Klabbs tal-futbol	Categorie:Voetbalclub
Kategorija:Mudelli tal-futbol	Categorie:Wikipedia:Sjablonen voetbal
Kategorija:Utenti fr-1	Categorie:Wikipedia:Gebruiker fr-1
Mudell:Wikiquote	Sjabloon:Wikiquote
Kategorija:Innijiet Nazzjonali	Categorie:Volkslied
Mudell:Afrika	Sjabloon:Navigatie landen Afrika
Mudell:Edizzjoni Olimpika	Sjabloon:Infobox Olympische Spelen
Mudell:Infobox artist mużikali	Sjabloon:Infobox artiest
Mudell:Es	Sjabloon:Es
Mudell:Cs	Sjabloon:Cs
Mudell:Infobox Pajjiż	Sjabloon:Infobox land
Mudell:Mas	Sjabloon:Max
Mudell:Fi	Sjabloon:Fi
Mudell:Stampa kbira	Sjabloon:Panorama
Mudell:Sar	Sjabloon:Uitgevoerd
Mudell:Awdjo	Sjabloon:Audio
Għajnuna:Gwida essenzjali/Ħoloq	Wikipedia:Snelcursus (Wikipedia links)
Kategorija:Timijiet nazzjonali tal-futbol Ewropej	Categorie:Nationaal voetbalelftal in Europa
Mudell:Biżestili	Sjabloon:Schrikkeljaar
Mudell:Politika	Sjabloon:Reglement
Mudell:Vetrina	Sjabloon:Etalage
Mudell:Round4	Sjabloon:Wedstrijdschema laatste 4 zonder 3e plaats
Kategorija:Utenti en-4	Categorie:Wikipedia:Gebruiker en-4
Kategorija:Utenti en	Categorie:Wikipedia:Gebruiker en
Kategorija:Utenti zh	Categorie:Wikipedia:Gebruiker zh
Kategorija:Kroazja	Categorie:Kroatië
Kategorija:Utenti zh-N	Categorie:Wikipedia:Gebruiker zh-M
Kategorija:Utenti en-2	Categorie:Wikipedia:Gebruiker en-2
Mudell:TOCright	Sjabloon:Inhoud rechts
Mudell:Utent zh	Sjabloon:Gebruiker zh
Mudell:Infobox Tim nazzjonali tal-futbol	Sjabloon:Infobox nationaal voetbalelftal
Mudell:Leġenda	Sjabloon:Legenda
Mudell:Ċita web	Sjabloon:Citeer web
Vojvodja	Woiwodschap
Kategorija:Unuri tal-futbol	Categorie:Voetbalprijs
Kategorija:Kċina	Categorie:Voeding
Mudell:Coor URL	Sjabloon:MapsServer
Mudell:Min	Sjabloon:Min
Mudell:Wikizzjunarju	Sjabloon:Wikt
Mudell:Utent nl-2	Sjabloon:Gebruiker nl-2
Kategorija:Terminoloġija tal-futbol	Categorie:Voetbalterminologie
Mudell:Languageicon	Sjabloon:Taalaanduiding
Kategorija:Agrikoltura	Categorie:Landbouw
Kategorija:Utenti hi	Categorie:Wikipedia:Gebruiker hi
Mudell:Golden goal	Sjabloon:Golden goal
Kategorija:Seklu 20	Categorie:20e eeuw
Kategorija:Politiċi	Categorie:Politicus
Kategorija:Amerika	Categorie:Amerika
Mudell:Użioħra	Sjabloon:Zie dp
Kategorija:Mudelli tal-lingwi tal-utenti	Categorie:Wikipedia:Sjablonen babel
Kategorija:Bliet tal-Marokk	Categorie:Stad in Marokko
Mudell:Clade	Sjabloon:Clade
Mudell:ISEMXAHAR	Sjabloon:MONTHNAME
Mudell:Infobox Kariga pubblika	Sjabloon:Infobox ambtsbekleder
Mudell:Proġetti oħra	Sjabloon:Zusterproject klein
Mudell:Sortname	Sjabloon:SortNaam
Mudell:Wikifikazzjoni	Sjabloon:Wikify
Kategorija:Seklu 19	Categorie:19e eeuw
Kategorija:Kittieba	Categorie:Schrijver
Mudell:Yel	Sjabloon:Gele kaart
Mudell:Tim ta' AC Milan	Sjabloon:Navigatie selectie AC Milan
Mudell:Utent pt-1	Sjabloon:Gebruiker pt-1
Kategorija:1931	Categorie:1931
Kategorija:1958	Categorie:1958
Kategorija:1956	Categorie:1956
Kategorija:1944	Categorie:1944
Kategorija:Jiem ta' Jannar	Categorie:Januari
Kategorija:1916	Categorie:1916
Kategorija:1939	Categorie:1939
Kategorija:1909	Categorie:1909
Kategorija:Klabbs tal-futbol Taljani	Categorie:Italiaanse voetbalclub
Mudell:Utent no-2	Sjabloon:Gebruiker no-2
Mudell:Kategorijamoħbija	Sjabloon:Hiddencat
Mudell:Dokumentazzjoni mudell	Sjabloon:Sjabdoc direct
Mudell:Bundesliga	Sjabloon:Navigatie voetbal Duitsland Bundesliga
Mudell:CcTLD	Sjabloon:Navigatie landelijke topleveldomeinen
Mudell:Div col	Sjabloon:Kolommen2
Mudell:Klassifikazzjoni	Sjabloon:Beoordeling-5
Kategorija:Notoryctemorphia	Categorie:Buidelmol
Kategorija:Pittura	Categorie:Schilderkunst
Kategorija:Pajjiżi mhux rikonoxxuti	Categorie:Niet-erkende staat
Mudell:Goal	Sjabloon:Goal
Mudell:Paġna utent	Sjabloon:Gebruikerspagina
Kategorija:UEFA Europa League	Categorie:UEFA Europa League
Mudell:Infobox Album	Sjabloon:Infobox muziekalbum
Mudell:Utent	Sjabloon:Gebruikerlinks
Jherson Vergara	Jherson Vergara
Kategorija:Ajruporti fil-Vjetnam	Categorie:Vliegveld in Vietnam
Mudell:Logħba futbol	Sjabloon:Footballbox
Mudell:Emerġenza-buttuna-tifi	Sjabloon:Noodrem
Mudell:Imdb	Sjabloon:Link IMDb naam
Kategorija:Tuneżija	Categorie:Tunesië
Mudell:It	Sjabloon:It
Mudell:Infobox Stadju	Sjabloon:Infobox stadion
Mudell:Wikibarijiet	Sjabloon:Wikinews
Mudell:TwoLegStart	Sjabloon:Tabelkop wedstrijd 2
Mudell:Pajjiżi fil-Logħob Olimpiku tas-Sajf 2008	Sjabloon:Navigatie landen op de Olympische Zomerspelen 2008
Mudell:Kontra	Sjabloon:Tegen
Mudell:LTU	Sjabloon:LT
Kategorija:Utenti ja-N	Categorie:Wikipedia:Gebruiker ja-M
Kategorija:Futbolers Belġjani	Categorie:Belgisch voetballer
Kategorija:Futbolers Sloveni	Categorie:Sloveens voetballer
Kategorija:Artikli kandidati għall-vetrina tal-Wikipedija	Categorie:Wikipedia:Etalagenominaties
Mudell:Pdf	Sjabloon:Pdf
Kategorija:Imperi	Categorie:Keizerrijk
Mudell:Diżambigwazzjoni	Sjabloon:Dp
Kategorija:1962	Categorie:1962
Mudell:Pt	Sjabloon:Pt
Mudell:Ma sarx	Sjabloon:Nietuitgevoerd
Mudell:Uk	Sjabloon:Uk
Kategorija:Mudelli infobox	Categorie:Wikipedia:Sjablonen infobox
Mudell:Penmiss	Sjabloon:Penmis
Kategorija:Real Madrid CF	Categorie:Real Madrid
Kategorija:Storja ta' l-isport	Categorie:Sportgeschiedenis
Kategorija:Futbol fi Spanja	Categorie:Voetbal in Spanje
Mudell:Pengoal	Sjabloon:Pengoal
Kategorija:Mietu fl-2013	Categorie:Lijsten van personen overleden in 2013
Mudell:Is	Sjabloon:Is
Mudell:Utent no-3	Sjabloon:Gebruiker no-3
Mudell:Infobox Filosfu	Sjabloon:Infobox filosoof
Mudell:Hy	Sjabloon:Hy
Kategorija:Teoloġija	Categorie:Christelijke theologie
Mudell:Infobox Organizzazzjoni	Sjabloon:Infobox organisatie
Robin Stjernberg	Robin Stjernberg
Mudell:Hr	Sjabloon:Hr
Mudell:Tr	Sjabloon:Tr
Mudell:Az	Sjabloon:Az
Kategorija:Arkitettura	Categorie:Architectuur
Mudell:Nl	Sjabloon:Nl
Mudell:Utent it-2	Sjabloon:Gebruiker it-2
Mudell:De	Sjabloon:De
Kategorija:Bliet tal-Italja	Categorie:Gemeente in Italië
Mudell:Għoti tal-penalties	Sjabloon:Penshootoutbox
Mudell:Infobox Ċelebrità	Sjabloon:Infobox persoon
Kategorija:1953	Categorie:1953
Mudell:Tim ta' AS Roma	Sjabloon:Navigatie selectie AS Roma
Mudell:Lista ta' kapitali Ewropej skont ir-reġjun	Sjabloon:Navigatie hoofdsteden Europa
Mudell:L-Ewwel Diviżjoni Belġjana	Sjabloon:Navigatie voetbal België Eerste klasse
Mudell:Football League Championship	Sjabloon:Navigatie voetbal Engeland Football League Championship
Mudell:Sr	Sjabloon:Sr
Kategorija:Isqfijiet Kattoliċi Rumani	Categorie:Rooms-katholiek bisschop
Mudell:Coord	Sjabloon:Coördinaten
Kategorija:FIFA	Categorie:FIFA
Kategorija:Timijiet nazzjonali tal-futbol Oċeaniċi	Categorie:Nationaal voetbalelftal in Oceanië
Kategorija:Futbolers Ivorjani	Categorie:Ivoriaans voetballer
Mudell:Utent bg	Sjabloon:Gebruiker bg
Mudell:Ewropa	Sjabloon:Navigatie landen Europa
Kategorija:Futbolers skont in-nazzjonalità	Categorie:Voetballer naar nationaliteit
Kategorija:Utenti yue	Categorie:Wikipedia:Gebruiker yue
Kategorija:Utenti hif	Categorie:Wikipedia:Gebruiker hif
Kategorija:Utenti az	Categorie:Wikipedia:Gebruiker az
Kategorija:Utenti be	Categorie:Wikipedia:Gebruiker be
Kategorija:Utenti hr	Categorie:Wikipedia:Gebruiker hr
Kategorija:Utenti eo	Categorie:Wikipedia:Gebruiker eo
Kategorija:Utenti fr	Categorie:Wikipedia:Gebruiker fr
Kategorija:Utenti cy	Categorie:Wikipedia:Gebruiker cy
Kategorija:Utenti id	Categorie:Wikipedia:Gebruiker id
Kategorija:Utenti ga	Categorie:Wikipedia:Gebruiker ga
Kategorija:Utenti ja	Categorie:Wikipedia:Gebruiker ja
Kategorija:Utenti nn	Categorie:Wikipedia:Gebruiker nn
Kategorija:Utenti pt	Categorie:Wikipedia:Gebruiker pt
Kategorija:Utenti scn	Categorie:Wikipedia:Gebruiker scn
Kategorija:Utenti sv	Categorie:Wikipedia:Gebruiker sv
Kategorija:Utenti fr-3	Categorie:Wikipedia:Gebruiker fr-3
Kategorija:Utenti it-3	Categorie:Wikipedia:Gebruiker it-3
Kategorija:Utenti no-3	Categorie:Wikipedia:Gebruiker no-3
Kategorija:Utenti pl-3	Categorie:Wikipedia:Gebruiker pl-3
Kategorija:Utenti scn-3	Categorie:Wikipedia:Gebruiker scn-3
Kategorija:Utenti da-1	Categorie:Wikipedia:Gebruiker da-1
Kategorija:Utenti ga-1	Categorie:Wikipedia:Gebruiker ga-1
Kategorija:Utenti nl-1	Categorie:Wikipedia:Gebruiker nl-1
Kategorija:Utenti scn-1	Categorie:Wikipedia:Gebruiker scn-1
Kategorija:Utenti tr-1	Categorie:Wikipedia:Gebruiker tr-1
Kategorija:Utenti ar-1	Categorie:Wikipedia:Gebruiker ar-1
Kategorija:Utenti id-4	Categorie:Wikipedia:Gebruiker id-4
Kategorija:Utenti it-4	Categorie:Wikipedia:Gebruiker it-4
Kategorija:Utenti pl-4	Categorie:Wikipedia:Gebruiker pl-4
Kategorija:Utenti be-2	Categorie:Wikipedia:Gebruiker be-2
Kategorija:Utenti da-2	Categorie:Wikipedia:Gebruiker da-2
Kategorija:Utenti fr-2	Categorie:Wikipedia:Gebruiker fr-2
Kategorija:Utenti cy-2	Categorie:Wikipedia:Gebruiker cy-2
Kategorija:Utenti hi-2	Categorie:Wikipedia:Gebruiker hi-2
Kategorija:Utenti it-2	Categorie:Wikipedia:Gebruiker it-2
Kategorija:Utenti ja-2	Categorie:Wikipedia:Gebruiker ja-2
Kategorija:Utenti nl-2	Categorie:Wikipedia:Gebruiker nl-2
Kategorija:Utenti pl-2	Categorie:Wikipedia:Gebruiker pl-2
Kategorija:Utenti scn-2	Categorie:Wikipedia:Gebruiker scn-2
Kategorija:Utenti tr-2	Categorie:Wikipedia:Gebruiker tr-2
Kategorija:Utenti be-N	Categorie:Wikipedia:Gebruiker be-M
Kategorija:Utenti cs-N	Categorie:Wikipedia:Gebruiker cs-M
Kategorija:Utenti hr-N	Categorie:Wikipedia:Gebruiker hr-M
Kategorija:Utenti fr-N	Categorie:Wikipedia:Gebruiker fr-M
Kategorija:Utenti it-N	Categorie:Wikipedia:Gebruiker it-M
Kategorija:Utenti nl-N	Categorie:Wikipedia:Gebruiker nl-M
Kategorija:Utenti no-N	Categorie:Wikipedia:Gebruiker no-M
Kategorija:Utenti ru-N	Categorie:Wikipedia:Gebruiker ru-M
Kategorija:Utenti scn-N	Categorie:Wikipedia:Gebruiker scn-M
Kategorija:Divertiment	Categorie:Amusement
Mudell:Nfteams	Sjabloon:Link nationalfootballteams.com
Kategorija:UEFA Champions League	Categorie:UEFA Champions League
Mudell:Utent yue	Sjabloon:Gebruiker yue
Mudell:Utent pdc-1	Sjabloon:Gebruiker pdc-1
Kategorija:Għall-wikifikazzjoni	Categorie:Wikipedia:Wikificatie nodig
Kategorija:Kompetizzjonijiet tal-UEFA	Categorie:Toernooi van de UEFA
Kategorija:UEFA	Categorie:UEFA
Kategorija:Utenti af	Categorie:Wikipedia:Gebruiker af
Kategorija:Utenti af-3	Categorie:Wikipedia:Gebruiker af-3
Kategorija:Utenti ar	Categorie:Wikipedia:Gebruiker ar
Kategorija:Utenti az-N	Categorie:Wikipedia:Gebruiker az-M
Kategorija:Pajjiżi fil-Festival tal-Eurovision	Categorie:Land op het Eurovisiesongfestival
Kategorija:Utenti bg	Categorie:Wikipedia:Gebruiker bg
Kategorija:Utenti bg-1	Categorie:Wikipedia:Gebruiker bg-1
Kategorija:Utenti bg-N	Categorie:Wikipedia:Gebruiker bg-M
Kategorija:Mużiċisti Awstrijaċi	Categorie:Oostenrijks musicus
Kategorija:Utenti cs	Categorie:Wikipedia:Gebruiker cs
Kategorija:Utenti da	Categorie:Wikipedia:Gebruiker da
Kategorija:Provinċja ta' Quang Binh	Categorie:Quảng Bình
Kategorija:Utenti de	Categorie:Wikipedia:Gebruiker de
Kategorija:Utenti de-2	Categorie:Wikipedia:Gebruiker de-2
Kategorija:Utenti de-3	Categorie:Wikipedia:Gebruiker de-3
Kategorija:Utenti de-4	Categorie:Wikipedia:Gebruiker de-4
Kategorija:Utenti de-N	Categorie:Wikipedia:Gebruiker de-M
Kategorija:Utenti el	Categorie:Wikipedia:Gebruiker el
Kategorija:Utenti el-N	Categorie:Wikipedia:Gebruiker el-M
Kategorija:Utenti en-3	Categorie:Wikipedia:Gebruiker en-3
Kategorija:Utenti en-N	Categorie:Wikipedia:Gebruiker en-M
Kategorija:Utenti eo-3	Categorie:Wikipedia:Gebruiker eo-3
Kategorija:Utenti es	Categorie:Wikipedia:Gebruiker es
Kategorija:Utenti es-1	Categorie:Wikipedia:Gebruiker es-1
Mudell:Pajjiżi tal-Unjoni Ewropea	Sjabloon:Navigatie Europese Unie
Kategorija:Utenti es-2	Categorie:Wikipedia:Gebruiker es-2
Kategorija:Utenti es-3	Categorie:Wikipedia:Gebruiker es-3
Kategorija:Utenti es-N	Categorie:Wikipedia:Gebruiker es-M
Kategorija:Utenti fa	Categorie:Wikipedia:Gebruiker fa
Kategorija:Utenti fa-N	Categorie:Wikipedia:Gebruiker fa-M
Kategorija:Utenti fi	Categorie:Wikipedia:Gebruiker fi
Kategorija:Utenti fi-N	Categorie:Wikipedia:Gebruiker fi-M
Kategorija:Utenti ga-2	Categorie:Wikipedia:Gebruiker ga-2
Kategorija:Utenti ga-3	Categorie:Wikipedia:Gebruiker ga-3
Kategorija:Utenti grc	Categorie:Wikipedia:Gebruiker grc
Kategorija:Utenti grc-1	Categorie:Wikipedia:Gebruiker grc-1
Kategorija:Utenti hu	Categorie:Wikipedia:Gebruiker hu
Kategorija:Utenti hu-1	Categorie:Wikipedia:Gebruiker hu-1
Mudell:Tim ta' Bayer 04 Leverkusen	Sjabloon:Navigatie selectie Bayer 04 Leverkusen
Kategorija:Plejers ta' Grasshopper Club Zürich	Categorie:Grasshopper Club Zürich
Kategorija:Politiċi Veneżwelani	Categorie:Venezolaans politicus
Mudell:Tim ta' Málaga CF	Sjabloon:Navigatie selectie Málaga CF
Kategorija:Utenti pl-N	Categorie:Wikipedia:Gebruiker pl-M
Kategorija:Utenti pt-1	Categorie:Wikipedia:Gebruiker pt-1
Kategorija:Ġeometrija	Categorie:Meetkunde
Kategorija:Kampjonati Ewropej tal-Futbol 2012	Categorie:Europees kampioenschap voetbal 2012
Għajnuna:Gwida essenzjali/Ifformattjar	Wikipedia:Snelcursus/Opmaken
Kategorija:Utenti it	Categorie:Wikipedia:Gebruiker it
Kategorija:Utenti it-1	Categorie:Wikipedia:Gebruiker it-1
Kategorija:Futbolers Ażerbajġani	Categorie:Azerbeidzjaans voetballer
Kategorija:Vulkani	Categorie:Vulkaan
Kategorija:Provinċji tal-Vjetnam	Categorie:Provincie van Vietnam
Kategorija:Kompetizzjonijiet tal-futbol skont il-pajjiż	Categorie:Nationale voetbalcompetitie
Mudell:Informazzjoni	Sjabloon:Information
Kategorija:Pitturi tar-Rinaxximent	Categorie:Renaissanceschilder
Kategorija:Bijoloġi evoluzzjonarji	Categorie:Evolutiebioloog
Kategorija:Knisja Kattolika Rumana	Categorie:Rooms-katholieke Kerk
Kategorija:Kowċis Olandiżi	Categorie:Nederlands voetbalcoach
Kategorija:Mużiċisti Olandiżi	Categorie:Nederlands musicus
Kategorija:Kantanti Olandiżi	Categorie:Nederlands zanger
Mudell:Klassifikazzjoni xjentifika	Sjabloon:Zijbalk biologische taxonomie
Kategorija:Utenti ru-1	Categorie:Wikipedia:Gebruiker ru-1
Mudell:TOClimit	Sjabloon:Inhoud beperkt
Wikipedija:Babel	Wikipedia:Babel
Kategorija:Abbozzi tal-kimika	Categorie:Wikipedia:Beginnetje scheikunde
Kategorija:Futbolers Olandiżi	Categorie:Nederlands voetballer
Kategorija:Kompożituri tal-opra	Categorie:Operacomponist
Kategorija:Ibħra	Categorie:Zee
Kategorija:Bliet tal-Polonja	Categorie:Stad in Polen
Kategorija:Kompożituri skont in-nazzjonalità	Categorie:Componist naar nationaliteit
Mudell:Bundesliga (Awstrija)	Sjabloon:Navigatie voetbal Oostenrijk Bundesliga
Kategorija:Atturi skont in-nazzjonalità	Categorie:Acteur naar nationaliteit
Kategorija:Sistema solari	Categorie:Zonnestelsel
Trasformata ta' Fourier	Fouriertransformatie
Kategorija:Entomoloġija	Categorie:Entomologie
Kategorija:Carnivora	Categorie:Roofdier
Mudell:Premier League Bjelorussu	Sjabloon:Navigatie voetbal Wit-Rusland Vysjejsjaja Liga
Kategorija:Klabbs tal-futbol Torok	Categorie:Turkse voetbalclub
Kategorija:Futbolers Pollakki	Categorie:Pools voetballer
Kategorija:Mużiċisti Bulgari	Categorie:Bulgaars musicus
Kategorija:Poeti Spanjoli	Categorie:Spaans dichter
Portal:Sport	Portaal:Sport
Mudell:Id	Sjabloon:Id
Kategorija:Xjenza soċjali	Categorie:Sociale wetenschap
Kategorija:Bjelorussja	Categorie:Wit-Rusland
Kategorija:Kantanti Kanadiżi	Categorie:Canadees zanger
Kategorija:Pajjiżi tal-Afrika	Categorie:Land in Afrika
Kategorija:Klabbs tal-futbol Ażerbajġani	Categorie:Azerbeidzjaanse voetbalclub
Mudell:Utent da-3	Sjabloon:Gebruiker da-3
Didelphimorphia	Didelphimorphia
Mudell:Tim ta' FC Barcelona	Sjabloon:Navigatie selectie FC Barcelona
Mudell:Utent ja-2	Sjabloon:Gebruiker ja-2
Mudell:Utent ru-2	Sjabloon:Gebruiker ru-2
Mudell:Lv	Sjabloon:Lv
Kategorija:Futbol fil-Polonja	Categorie:Voetbal in Polen
Kategorija:Utenti ru	Categorie:Wikipedia:Gebruiker ru
Kategorija:Utenti ru-2	Categorie:Wikipedia:Gebruiker ru-2
Kategorija:Utenti ru-3	Categorie:Wikipedia:Gebruiker ru-3
Kategorija:Utenti sv-3	Categorie:Wikipedia:Gebruiker sv-3
Kategorija:Utenti sv-N	Categorie:Wikipedia:Gebruiker sv-M
Kategorija:Utenti tr	Categorie:Wikipedia:Gebruiker tr
Kategorija:Utenti uk-4	Categorie:Wikipedia:Gebruiker uk-4
Kategorija:Utenti yue-N	Categorie:Wikipedia:Gebruiker yue-M
Mudell:En	Sjabloon:En
Mudell:Premier League Malti	Sjabloon:Navigatie voetbal Malta Premier League
Kategorija:Mużiċisti	Categorie:Musicus
Kategorija:Logħob ta' abilità mentali	Categorie:Logische puzzel
Mudell:DotNET	Sjabloon:Navigatie .NET-framework
Mudell:Timijiet nazzjonali tal-UEFA	Sjabloon:Navigatie elftallen UEFA
Mudell:Tim ta' Manchester United FC	Sjabloon:Navigatie selectie Manchester United FC
Mudell:Da	Sjabloon:Da
Kategorija:Kantanti Irlandiżi	Categorie:Iers zanger
Mudell:Sq	Sjabloon:Sq
Kategorija:Terminoloġija sportiva	Categorie:Sportterminologie
Kategorija:Matematiċi Russi	Categorie:Russisch wiskundige
Kategorija:Soċjoloġija	Categorie:Sociologie
Mudell:Tim ta' ACF Fiorentina	Sjabloon:Navigatie selectie ACF Fiorentina
Kategorija:Seklu 17	Categorie:17e eeuw
Mudell:Tim ta' Arsenal FC	Sjabloon:Navigatie selectie Arsenal FC
Mudell:Premier League Ażerbajġan	Sjabloon:Navigatie voetbal Azerbeidzjan Premyer Liqası
Mudell:Tim ta' Bologna FC 1909	Sjabloon:Navigatie selectie Bologna FC 1909
Kategorija:2014	Categorie:2014
Mudell:Utent sv-3	Sjabloon:Gebruiker sv-3
Mudell:Fr	Sjabloon:Fr
Kategorija:Portali	Categorie:Wikipedia:Portalen
Kategorija:Futbolers Sud-Koreani	Categorie:Zuid-Koreaans voetballer
Mudell:Utent af-3	Sjabloon:Gebruiker af-3
Marie Louise Coleiro Preca	Marie-Louise Coleiro Preca
Kategorija:Mużika popolari	Categorie:Wereldmuziek
Mudell:Artiklu prinċipali	Sjabloon:Zie hoofdartikel
Mudell:Plejers fit-tim tal-futbol/tmiem	Sjabloon:Voetbalselectie end
Kategorija:Avvenimenti sportivi	Categorie:Sportevenement
Kategorija:Avvenimenti sportivi futuri	Categorie:Toekomstige sportgebeurtenis
Mudell:Plejers fit-tim tal-futbol/bidu	Sjabloon:Voetbalselectie start
Kategorija:Avvenimenti futuri	Categorie:Toekomstige gebeurtenis
Kategorija:It-Tieni Gwerra Dinjija	Categorie:Tweede Wereldoorlog
Kategorija:L-Ewwel Gwerra Dinjija	Categorie:Eerste Wereldoorlog
Mudell:L-Ewwel fir-Rankings Mondjali tal-FIFA	Sjabloon:Tijdlijn leiders FIFA-wereldranglijst
Kategorija:Logħob tal-mejda	Categorie:Bordspel
Kategorija:Mudelli ta' ċitazzjoni tas-sorsi	Categorie:Wikipedia:Sjablonen voetnoot
Kategorija:UC Sampdoria	Categorie:UC Sampdoria
Mudell:Tim ta' FC Bayern Munich	Sjabloon:Navigatie selectie FC Bayern München
Kategorija:Tubulidentata	Categorie:Buistandige
Kategorija:Klabbs tal-futbol Albaniżi	Categorie:Albanese voetbalclub
Kategorija:Kittieba Spanjoli	Categorie:Spaans schrijver
Kategorija:Klabbs tal-futbol Bjelorussi	Categorie:Wit-Russische voetbalclub
Kategorija:Klabbs tal-futbol Latvjani	Categorie:Letse voetbalclub
Kategorija:Klabbs tal-futbol Maltin	Categorie:Maltese voetbalclub
Mudell:Round8	Sjabloon:Wedstrijdschema laatste 8
Mudell:Cquote	Sjabloon:Cquote
Mudell:Tim ta' Cercle Brugge KSV	Sjabloon:Navigatie selectie Cercle Brugge
Mudell:Tim ta' Chelsea FC	Sjabloon:Navigatie selectie Chelsea FC
Kategorija:Angola	Categorie:Angola
Kategorija:Libja	Categorie:Libië
Kategorija:Marokk	Categorie:Marokko
Kategorija:Unuri u trofej sportivi	Categorie:Sportprijs
Kategorija:Mietu fl-2011	Categorie:Lijsten van personen overleden in 2011
Kategorija:Kantanti Taljani	Categorie:Italiaans zanger
Kategorija:1830	Categorie:1830
Kategorija:1870	Categorie:1870
Kategorija:1871	Categorie:1871
Kategorija:1872	Categorie:1872
Kategorija:1874	Categorie:1874
Kategorija:1875	Categorie:1875
Kategorija:1876	Categorie:1876
Kategorija:1877	Categorie:1877
Kategorija:1879	Categorie:1879
Kategorija:1880	Categorie:1880
Kategorija:1881	Categorie:1881
Kategorija:1882	Categorie:1882
Kategorija:1883	Categorie:1883
Kategorija:1884	Categorie:1884
Kategorija:1885	Categorie:1885
Kategorija:1886	Categorie:1886
Kategorija:1887	Categorie:1887
Kategorija:1889	Categorie:1889
Kategorija:1890	Categorie:1890
Kategorija:1891	Categorie:1891
Kategorija:1892	Categorie:1892
Kategorija:1893	Categorie:1893
Kategorija:1894	Categorie:1894
Kategorija:1895	Categorie:1895
Kategorija:1897	Categorie:1897
Kategorija:1899	Categorie:1899
Kategorija:1961	Categorie:1961
Kategorija:1964	Categorie:1964
Kategorija:1965	Categorie:1965
Kategorija:1966	Categorie:1966
Kategorija:1967	Categorie:1967
Kategorija:1969	Categorie:1969
Kategorija:1970	Categorie:1970
Kategorija:1972	Categorie:1972
Kategorija:1973	Categorie:1973
Kategorija:1974	Categorie:1974
Kategorija:1975	Categorie:1975
Kategorija:1976	Categorie:1976
Kategorija:1978	Categorie:1978
Kategorija:1979	Categorie:1979
Kategorija:1980	Categorie:1980
Kategorija:1981	Categorie:1981
Kategorija:1982	Categorie:1982
Kategorija:1983	Categorie:1983
Kategorija:1984	Categorie:1984
Kategorija:1985	Categorie:1985
Kategorija:1986	Categorie:1986
Kategorija:1987	Categorie:1987
Kategorija:1988	Categorie:1988
Kategorija:1989	Categorie:1989
Kategorija:1990	Categorie:1990
Kategorija:1991	Categorie:1991
Kategorija:1992	Categorie:1992
Kategorija:1993	Categorie:1993
Kategorija:1994	Categorie:1994
Kategorija:1995	Categorie:1995
Kategorija:Fußball-Bundesliga	Categorie:Bundesliga
Kategorija:1996	Categorie:1996
Kategorija:1997	Categorie:1997
Kategorija:1999	Categorie:1999
Kategorija:2000	Categorie:2000
Kategorija:2001	Categorie:2001
Kategorija:2002	Categorie:2002
Kategorija:2004	Categorie:2004
Kategorija:2005	Categorie:2005
Kategorija:2006	Categorie:2006
Kategorija:2007	Categorie:2007
Kategorija:2008	Categorie:2008
Kategorija:2009	Categorie:2009
Kategorija:2010	Categorie:2010
Kategorija:2011	Categorie:2011
Kategorija:Ajruporti skont il-pajjiż	Categorie:Vliegveld naar land
Kategorija:Pajjiżi gżejjer	Categorie:Eilandnatie
Kategorija:Politika ta' Malta	Categorie:Politiek in Malta
Kategorija:Ġurnalisti Franċiżi	Categorie:Frans journalist
Kategorija:Storja tal-futbol	Categorie:Geschiedenis van het voetbal
Kategorija:Grawnds tal-futbol fl-Italja	Categorie:Voetbalstadion in Italië
Kategorija:Futbol fil-Gambja	Categorie:Voetbal in Gambia
Kategorija:Futbol fil-Greċja	Categorie:Voetbal in Griekenland
Kategorija:Futbol fin-Niġerja	Categorie:Voetbal in Nigeria
Kategorija:Futbol fl-Afrika t'Isfel	Categorie:Voetbal in Zuid-Afrika
Kategorija:Futbol fil-Latvja	Categorie:Voetbal in Letland
Kategorija:Futbol fir-Rumanija	Categorie:Voetbal in Roemenië
Kategorija:Futbol fil-Litwanja	Categorie:Voetbal in Litouwen
Kategorija:Futbol fil-Montenegro	Categorie:Voetbal in Montenegro
Kategorija:Futbol f'Malta	Categorie:Voetbal in Malta
Kategorija:Futbol fl-Istati Uniti	Categorie:Voetbal in de Verenigde Staten
Kategorija:Futbol fil-Belġju	Categorie:Voetbal in België
Kategorija:Futbol fil-Bożnija u Ħerżegovina	Categorie:Voetbal in Bosnië en Herzegovina
Kategorija:Futbol fil-Bulgarija	Categorie:Voetbal in Bulgarije
Kategorija:Futbol fis-Serbja	Categorie:Voetbal in Servië
Kategorija:Futbol fl-Unjoni Sovjetika	Categorie:Voetbal in de Sovjet-Unie
Kategorija:Futbol fl-Iżvizzera	Categorie:Voetbal in Zwitserland
Kategorija:Futbol fl-Iskozja	Categorie:Voetbal in Schotland
Kategorija:Futbol fis-Slovakkja	Categorie:Voetbal in Slowakije
Kategorija:Futbol fl-Arġentina	Categorie:Voetbal in Argentinië
Kategorija:Futbol fl-Iżlanda	Categorie:Voetbal in IJsland
Kategorija:Futbol fl-Irlanda	Categorie:Voetbal in Ierland
Kategorija:Futbol fl-Albanija	Categorie:Voetbal in Albanië
Kategorija:Futbol fl-Angola	Categorie:Voetbal in Angola
Kategorija:Futbol fl-Estonja	Categorie:Voetbal in Estland
Kategorija:Futbol fl-Awstralja	Categorie:Voetbal in Australië
Kategorija:Futbol f'Wales	Categorie:Voetbal in Wales
Kategorija:Futbol fl-Iżrael	Categorie:Voetbal in Israël
Kategorija:Futbol fiċ-Ċina	Categorie:Voetbal in China
Kategorija:Futbol fil-Kamerun	Categorie:Voetbal in Kameroen
Kategorija:Futbol fil-Kosta tal-Avorju	Categorie:Voetbal in Ivoorkust
Kategorija:Futbol f'Ċipru	Categorie:Voetbal in Cyprus
Mudell:Utent be	Sjabloon:Gebruiker be
Mudell:Utent ga-2	Sjabloon:Gebruiker ga-2
Mudell:Utent hu-1	Sjabloon:Gebruiker hu-1
Mudell:Utent ru-1	Sjabloon:Gebruiker ru-1
Mudell:Utent tr-1	Sjabloon:Gebruiker tr-1
Mudell:Utent uk-4	Sjabloon:Gebruiker uk-4
Mudell:Utent zh-1	Sjabloon:Gebruiker zh-1
Kategorija:Poeti skont in-nazzjonalità	Categorie:Dichter naar nationaliteit
Kategorija:Mużiċisti skont in-nazzjonalità	Categorie:Musicus naar nationaliteit
Kategorija:Skulturi skont in-nazzjonalità tagħhom	Categorie:Beeldhouwer naar nationaliteit
Kategorija:Filosfi skont in-nazzjonalità	Categorie:Filosoof naar nationaliteit
Kategorija:Vulkani skont il-pajjiż	Categorie:Vulkaan naar land
Kategorija:Storja ta' Malta	Categorie:Geschiedenis van Malta
Kategorija:Futbol fil-Gana	Categorie:Voetbal in Ghana
Kategorija:Futbol fl-Olanda	Categorie:Voetbal in Nederland
Kategorija:Futbol fin-Norveġja	Categorie:Voetbal in Noorwegen
Kategorija:Futbol fil-Ġermanja	Categorie:Voetbal in Duitsland
Kategorija:Futbol fil-Bjelorussja	Categorie:Voetbal in Wit-Rusland
Kategorija:Futbol fl-Irlanda ta' Fuq	Categorie:Voetbal in Noord-Ierland
Kategorija:Futbol fil-Brażil	Categorie:Voetbal in Brazilië
Kategorija:Futbol fl-Armenja	Categorie:Voetbal in Armenië
Kategorija:Futbol fl-Ażerbajġan	Categorie:Voetbal in Azerbeidzjan
Kategorija:Futbol fl-Awstrija	Categorie:Voetbal in Oostenrijk
Kategorija:Futbol fl-Urugwaj	Categorie:Voetbal in Uruguay
Kategorija:Futbol fl-Italja	Categorie:Voetbal in Italië
Kategorija:Futbol fl-Ingilterra	Categorie:Voetbal in Engeland
Kategorija:Futbol fir-Repubblika Ċeka	Categorie:Voetbal in Tsjechië
Kategorija:Futbol fil-Każakistan	Categorie:Voetbal in Kazachstan
Kategorija:Futbol fil-Kolombja	Categorie:Voetbal in Colombia
Kategorija:Futbol fit-Turkija	Categorie:Voetbal in Turkije
Kategorija:Futbol fil-Portugall	Categorie:Voetbal in Portugal
Kategorija:Futbol fl-Ungerija	Categorie:Voetbal in Hongarije
Mudell:TwoLegResult	Sjabloon:Tabelrij wedstrijd 2
Kategorija:Festival tal-Eurovision	Categorie:Eurovisiesongfestival
Kategorija:Kowċis Arġentini	Categorie:Argentijns voetbalcoach
Kategorija:Kowċis Awstrijaċi	Categorie:Oostenrijks voetbalcoach
Kategorija:Kowċis Belġjani	Categorie:Belgisch voetbalcoach
Kategorija:Kowċis Brażiljani	Categorie:Braziliaans voetbalcoach
Kategorija:Kowċis Ingliżi	Categorie:Engels voetbalcoach
Kategorija:Kowċis Skoċċiżi	Categorie:Schots voetbalcoach
Kategorija:Teatru	Categorie:Theater
Kategorija:Kowċis Kroati	Categorie:Kroatisch voetbalcoach
Kategorija:Kowċis Ġermaniżi	Categorie:Duits voetbalcoach
Kategorija:Kantanti skont in-nazzjonalità	Categorie:Zanger naar nationaliteit
Kategorija:Kowċis Rumeni	Categorie:Roemeens voetbalcoach
Kategorija:Kowċis Spanjoli	Categorie:Spaans voetbalcoach
Kategorija:Futbolers Albaniżi	Categorie:Albanees voetballer
Kategorija:Futbolers Angoliżi	Categorie:Angolees voetballer
Kategorija:Futbolers Arġentini	Categorie:Argentijns voetballer
Kategorija:Futbolers Armeni	Categorie:Armeens voetballer
Kategorija:Futbolers Awstraljani	Categorie:Australisch voetballer
Kategorija:Futbolers Awstrijaċi	Categorie:Oostenrijks voetballer
Kategorija:Futbolers Bożnijaċi	Categorie:Bosnisch voetballer
Kategorija:Futbolers Brażiljani	Categorie:Braziliaans voetballer
Kategorija:Futbolers Ingliżi	Categorie:Engels voetballer
Mudell:Newtrali	Sjabloon:Neutraal
Kategorija:Kantanti Żvediżi	Categorie:Zweeds zanger
Kategorija:Kantanti Iżlandiżi	Categorie:IJslands zanger
Kategorija:Kantanti Iżraeljani	Categorie:Israëlisch zanger
Kategorija:Kantanti Pollakki	Categorie:Pools zanger
Kategorija:Kantanti Franċiżi	Categorie:Frans zanger
Kategorija:Utenti nl	Categorie:Wikipedia:Gebruiker nl
Kategorija:Ekonomisti Russi	Categorie:Russisch econoom
Kategorija:Utenti nn-3	Categorie:Wikipedia:Gebruiker nn-3
Kategorija:Utenti no-2	Categorie:Wikipedia:Gebruiker no-2
Kategorija:Utenti no	Categorie:Wikipedia:Gebruiker no
Kategorija:Utenti zh-1	Categorie:Wikipedia:Gebruiker zh-1
Kategorija:Armenja	Categorie:Armenië
Kategorija:Fiżiċi Brittaniċi	Categorie:Brits natuurkundige
Kategorija:Atturi Taljani	Categorie:Italiaans acteur
Kategorija:Finanza	Categorie:Financiering
Kategorija:Diskografiji	Categorie:Discografie
Kategorija:Kompetizzjonijiet tal-futbol	Categorie:Voetbalwedstrijd
Kategorija:Uffiċjali tal-pulizija Belġjani	Categorie:Belgisch politiefunctionaris
Kategorija:Sports għal persuni b'diżabbilità	Categorie:Gehandicaptensport
Kategorija:Televiżjoni	Categorie:Televisie
Kategorija:Prim Ministri ta' Malta	Categorie:Premier van Malta
Kategorija:Skulturi	Categorie:Beeldhouwer
Kategorija:Seklu 14	Categorie:14e eeuw
Kategorija:Seklu 13	Categorie:13e eeuw
Kategorija:Seklu 16	Categorie:16e eeuw
Kategorija:Seklu 12	Categorie:12e eeuw
Kategorija:Seklu 18	Categorie:18e eeuw
Kategorija:Kompożituri Russi	Categorie:Russisch componist
Kategorija:Kompożituri Franċiżi	Categorie:Frans componist
Kategorija:Kompożituri Barokki	Categorie:Barokcomponist
Kategorija:Kompożituri Pollakki	Categorie:Pools componist
Kategorija:Kompożituri Ġermaniżi	Categorie:Duits componist
Kategorija:Kompożituri Awstrijaċi	Categorie:Oostenrijks componist
Kategorija:Mużiċisti Pollakki	Categorie:Pools musicus
Kategorija:Skulturi Taljani	Categorie:Italiaans beeldhouwer
Kategorija:Storiċi Russi	Categorie:Russisch historicus
Kategorija:Mużiċisti Norveġiżi	Categorie:Noors musicus
Kategorija:Mużiċisti Daniżi	Categorie:Deens musicus
Kategorija:Mużiċisti Russi	Categorie:Russisch musicus
Kategorija:Mużiċisti Brażiljani	Categorie:Braziliaans musicus
Kategorija:Mużiċisti Żvediżi	Categorie:Zweeds musicus
Kategorija:Mużiċisti Irlandiżi	Categorie:Iers musicus
Kategorija:Mużiċisti Brittaniċi	Categorie:Brits musicus
Kategorija:Mużiċisti Taljani	Categorie:Italiaans musicus
Kategorija:Mużiċisti Ġeorġjani	Categorie:Georgisch musicus
Kategorija:Mużiċisti Kanadiżi	Categorie:Canadees musicus
Kategorija:Mużiċisti Franċiżi	Categorie:Frans musicus
Kategorija:Kompożituri Rumeni	Categorie:Roemeens componist
Kategorija:Kompożituri Taljani	Categorie:Italiaans componist
Kategorija:Mużiċisti Ġermaniżi	Categorie:Duits musicus
Kategorija:Politiċi Maltin	Categorie:Maltees politicus
Kategorija:Politiċi Taljani	Categorie:Italiaans politicus
Kategorija:Politiċi Franċiżi	Categorie:Frans politicus
Kategorija:Filosfi Griegi	Categorie:Grieks filosoof
Kategorija:Filosfi Ġermaniżi	Categorie:Duits filosoof
Kategorija:Filosfi Brittaniċi	Categorie:Brits filosoof
Kategorija:Bavarja	Categorie:Beieren
Kategorija:Futbolers Niġerjani	Categorie:Nigeriaans voetballer
Kategorija:Futbolers Rumeni	Categorie:Roemeens voetballer
Kategorija:Futbolers Bulgari	Categorie:Bulgaars voetballer
Kategorija:Futbolers Żvediżi	Categorie:Zweeds voetballer
Kategorija:Futbolers Skoċċiżi	Categorie:Schots voetballer
Kategorija:.NET	Categorie:.NET framework
Kategorija:Futbolers Ekwadorjani	Categorie:Ecuadoraans voetballer
Kategorija:Futbolers Urugwajani	Categorie:Uruguayaans voetballer
Kategorija:Futbolers Eġizzjani	Categorie:Egyptisch voetballer
Kategorija:Futbolers Ċiniżi	Categorie:Chinees voetballer
Kategorija:Futbolers Franċiżi	Categorie:Frans voetballer
Kategorija:Teorija tal-logħob	Categorie:Speltheorie
Kategorija:1873	Categorie:1873
Kategorija:1878	Categorie:1878
Kategorija:1896	Categorie:1896
Kategorija:1963	Categorie:1963
Kategorija:2012	Categorie:2012
Kategorija:Sportivi Sud-Koreani	Categorie:Zuid-Koreaans sporter
Kategorija:Imprendituri Amerikani	Categorie:Amerikaans ondernemer
Kategorija:Inventuri Brittaniċi	Categorie:Brits uitvinder
Kategorija:Futbolers Torok	Categorie:Turks voetballer
Kategorija:Futbolers Montenegrini	Categorie:Montenegrijns voetballer
Kategorija:Futbolers Żvizzeri	Categorie:Zwitsers voetballer
Kategorija:Futbolers Spanjoli	Categorie:Spaans voetballer
Kategorija:Futbolers Ungeriżi	Categorie:Hongaars voetballer
Kategorija:Futbolers Serbi	Categorie:Servisch voetballer
Kategorija:Futbolers Taljani	Categorie:Italiaans voetballer
Kategorija:Futbolers Daniżi	Categorie:Deens voetballer
Kategorija:Futbolers Galliċi	Categorie:Welsh voetballer
Kategorija:Futbolers Nord-Irlandiżi	Categorie:Noord-Iers voetballer
Kategorija:Futbolers Irlandiżi	Categorie:Iers voetballer
Kategorija:Futbolers Kolombjani	Categorie:Colombiaans voetballer
Kategorija:Futbolers Kroati	Categorie:Kroatisch voetballer
Kategorija:Futbolers Portugiżi	Categorie:Portugees voetballer
Kategorija:Kantanti Norveġiżi	Categorie:Noors zanger
Kategorija:Kantanti Brażiljani	Categorie:Braziliaans zanger
Kategorija:Kantanti Russi	Categorie:Russisch zanger
Kategorija:Kantanti Daniżi	Categorie:Deens zanger
Kategorija:Denominazzjonijiet Kristjani	Categorie:Christelijk kerkgenootschap
Kategorija:Abbozzi tal-matematika	Categorie:Wikipedia:Beginnetje wiskunde
Kategorija:Abbozzi tal-bijoloġija	Categorie:Wikipedia:Beginnetje biologie
Kategorija:Abbozzi tal-ġeografija	Categorie:Wikipedia:Beginnetje geografie
Kategorija:Seklu 15	Categorie:15e eeuw
Kategorija:Futbol fi New Zealand	Categorie:Voetbal in Nieuw-Zeeland
Kategorija:Futbol fil-Messiku	Categorie:Voetbal in Mexico
Kategorija:Futbol fl-Iżvezja	Categorie:Voetbal in Zweden
Kategorija:Futbol fl-Ukrajna	Categorie:Voetbal in Oekraïne
Kategorija:Futbol fil-Kroazja	Categorie:Voetbal in Kroatië
Kategorija:Futbol fi Franza	Categorie:Voetbal in Frankrijk
Kategorija:Ġeorġja	Categorie:Georgië
Kategorija:Kantanti Amerikani	Categorie:Amerikaans zanger
Kategorija:Bijoloġi Brittaniċi	Categorie:Brits bioloog
Kategorija:Mużiċisti Żvizzeri	Categorie:Zwitsers musicus
Kategorija:Mużiċisti Armeni	Categorie:Armeens musicus
Kategorija:Mużiċisti Ażerbajġani	Categorie:Azerbeidzjaans musicus
Kategorija:Mużiċisti Iżraeljani	Categorie:Israëlisch musicus
Kategorija:Ġeoloġi Brittaniċi	Categorie:Brits geoloog
Kategorija:Futbolers Ganiżi	Categorie:Ghanees voetballer
Kategorija:1968	Categorie:1968
Kategorija:Futbol fir-Russja	Categorie:Voetbal in Rusland
Kategorija:Futbol fl-Ekwador	Categorie:Voetbal in Ecuador
Kategorija:Futbol fl-Eġittu	Categorie:Voetbal in Egypte
Kategorija:Kantanti Torok	Categorie:Turks zanger
Kategorija:Futbol fl-Andorra	Categorie:Voetbal in Andorra
Kategorija:Nies Maltin	Categorie:Maltees persoon
Kategorija:Matematiċi Brittaniċi	Categorie:Brits wiskundige
Mudell:Infobox Eurovision	Sjabloon:Infobox Eurovisie
Kategorija:Mużiċisti Belġjani	Categorie:Belgisch musicus
Kategorija:Futbolers Gambjani	Categorie:Gambiaans voetballer
Kategorija:Futbolers Griegi	Categorie:Grieks voetballer
Kategorija:Futbolers Sud-Afrikani	Categorie:Zuid-Afrikaans voetballer
Kategorija:Futbolers Litwani	Categorie:Litouws voetballer
Kategorija:Futbolers Maċedoni	Categorie:Macedonisch voetballer
Kategorija:Futbolers Maltin	Categorie:Maltees voetballer
Kategorija:Futbolers Senegaliżi	Categorie:Senegalees voetballer
Kategorija:Futbolers Iżlandiżi	Categorie:IJslands voetballer
Kategorija:Futbolers Iżraeljani	Categorie:Israëlisch voetballer
Kategorija:Futbolers Kamerunjani	Categorie:Kameroens voetballer
Kategorija:1898	Categorie:1898
Kategorija:1998	Categorie:1998
Kategorija:Libanu	Categorie:Libanon
Kategorija:Kantanti Ġermaniżi	Categorie:Duits zanger
Kategorija:Kantanti Belġjani	Categorie:Belgisch zanger
Kategorija:Mużiċisti Iżlandiżi	Categorie:IJslands musicus
Kategorija:Kompożituri Irlandiżi	Categorie:Iers componist
Kategorija:Futbolers Messikani	Categorie:Mexicaans voetballer
Kategorija:2003	Categorie:2003
Kategorija:Futbol fid-Danimarka	Categorie:Voetbal in Denemarken
Kategorija:Mudelli tal-Unjoni Ewropea	Categorie:Wikipedia:Sjablonen Europese Unie
Kategorija:Xjenzati Brittaniċi	Categorie:Brits wetenschapper
Kategorija:Mudelli ta' tħassir	Categorie:Wikipedia:Sjablonen weg
Kategorija:1971	Categorie:1971
Kategorija:Abbozzi tal-politika	Categorie:Wikipedia:Beginnetje politiek
Kategorija:Abbozzi tal-astronomija	Categorie:Wikipedia:Beginnetje astronomie
Kategorija:Abbozzi tal-istorja	Categorie:Wikipedia:Beginnetje geschiedenis
Kategorija:Abbozzi tar-reliġjon	Categorie:Wikipedia:Beginnetje religie
Mudell:Utent de-4	Sjabloon:Gebruiker de-4
Kategorija:Abbozzi tal-ekonomija	Categorie:Wikipedia:Beginnetje economie
Kategorija:Futbol Asjatiku	Categorie:Voetbal in Azië
Kategorija:Futbol fl-Afrika	Categorie:Voetbal in Afrika
Kategorija:Futbol fl-Amerika t'Isfel	Categorie:Voetbal in Zuid-Amerika
Kategorija:Futbol fl-Ewropa	Categorie:Voetbal in Europa
Kategorija:Futbol fl-Oċeanja	Categorie:Voetbal in Oceanië
Kategorija:Futbol skont il-kontinent	Categorie:Voetbal naar continent
Kategorija:San Marino	Categorie:San Marino
Kategorija:Liechtenstein	Categorie:Liechtenstein
Kategorija:Andorra	Categorie:Andorra
Kategorija:Serbja	Categorie:Servië
Kategorija:Pajjiżi skont il-kontinent	Categorie:Land naar continent
Kategorija:Albanija	Categorie:Albanië
Kategorija:Pajjiżi tal-Karibew	Categorie:Caraïbisch land
Kategorija:Pajjiżi tal-Oċeanja	Categorie:Land in Oceanië
Kategorija:Pajjiżi tal-Amerika ta' Fuq	Categorie:Land in Noord-Amerika
Kategorija:Klabbs tal-futbol Litwani	Categorie:Litouwse voetbalclub
Kategorija:Referis tal-futbol skond in-nazzjonalita	Categorie:Voetbalscheidsrechter naar nationaliteit
Kategorija:Referis tal-futbol Ingliżi	Categorie:Engels voetbalscheidsrechter
Kategorija:Referis tal-futbol Taljani	Categorie:Italiaans voetbalscheidsrechter
Kategorija:Timijiet nazzjonali tal-futbol	Categorie:Nationaal voetbalelftal
Kategorija:Vulkani tal-Italja	Categorie:Vulkaan in Italië
Kategorija:Oċeani	Categorie:Oceaan
Kategorija:Antropoloġija	Categorie:Antropologie
Kategorija:Bliet tal-Veneżwela	Categorie:Stad in Venezuela
Mudell:Tim ta' Inter Milan	Sjabloon:Navigatie selectie Internazionale
Kategorija:Repubbliki	Categorie:Republiek
Kategorija:Chelsea FC	Categorie:Chelsea FC
Kategorija:Arsenal FC	Categorie:Arsenal FC
Kategorija:Liverpool FC	Categorie:Liverpool FC
Kategorija:Inter Milan	Categorie:FC Internazionale Milano
Kategorija:Manchester United FC	Categorie:Manchester United FC
Kategorija:AC Milan	Categorie:AC Milan
Kategorija:Klabbs tal-futbol Olandiżi	Categorie:Nederlandse voetbalclub
Kategorija:Tupaja	Categorie:Toepaja
Kategorija:Lagomorpha	Categorie:Haasachtige
Kategorija:Proboscidea	Categorie:Slurfdier
Kategorija:Hyracoidea	Categorie:Klipdasachtige
Kategorija:Kantanti Albaniżi	Categorie:Albanees zanger
Kategorija:Kantanti Rumeni	Categorie:Roemeens zanger
Kategorija:Pajjiżi tal-Amerika t'Isfel	Categorie:Land in Zuid-Amerika
Kategorija:Abbozzi tal-isport	Categorie:Wikipedia:Beginnetje sport
Kategorija:Timijiet nazzjonali tal-futbol Ażjatiċi	Categorie:Nationaal voetbalelftal in Azië
Kategorija:Timijiet nazzjonali tal-futbol Afrikani	Categorie:Nationaal voetbalelftal in Afrika
Kategorija:Timijiet nazzjonali li m'għadhomx jeżistu	Categorie:Voormalig nationaal voetbalelftal
Kategorija:Presidenti ta' Malta	Categorie:President van Malta
Mudell:Utent id-4	Sjabloon:Gebruiker id-4
Kategorija:Klabbs tal-futbol tal-Andorra	Categorie:Andorrese voetbalclub
Kategorija:Analisi matematika	Categorie:Wiskundige analyse
Kategorija:Sirenia	Categorie:Zeekoe
Kategorija:Mitoloġija Griega	Categorie:Griekse mythologie
Kategorija:Bliet kapitali	Categorie:Hoofdstad
Kategorija:Avvenimenti	Categorie:Evenement
Kategorija:HIV/AIDS	Categorie:Aids
Kategorija:Tazza Ażjatika tal-Futbol	Categorie:Asian Cup
Kategorija:Filatelija	Categorie:Filatelie
Kategorija:Arkeoloġija	Categorie:Archeologie
Kategorija:Astroloġija	Categorie:Astrologie
Kategorija:Logħob Olimpiku tas-sajf 2008	Categorie:Olympische Zomerspelen 2008
Kategorija:Ho Chi Minh (belt)	Categorie:Ho Chi Minhstad
Kategorija:Elettriċità	Categorie:Elektriciteit
Kategorija:Posta	Categorie:Postaal systeem
Kategorija:Utenti pl	Categorie:Wikipedia:Gebruiker pl
Kategorija:Trasport	Categorie:Vervoer
Kategorija:Ir-Rivoluzzjoni Franċiża	Categorie:Franse Revolutie
Kategorija:Żfin	Categorie:Dans
Kategorija:Sports tat-timijiet	Categorie:Teamsport
Kategorija:Teorija tal-grafi	Categorie:Grafentheorie
Kategorija:Teorija tan-numri	Categorie:Getaltheorie
Kategorija:Kantanti	Categorie:Zanger
Kategorija:Futbolers	Categorie:Voetballer
Kategorija:Matematiċi	Categorie:Wiskundige
Kategorija:Presidenti tal-Italja	Categorie:President van Italië
Kategorija:Kompetizzjonijiet tal-futbol fil-Ġermanja	Categorie:Duitse voetbalcompetitie
Kategorija:Sportivi	Categorie:Sporter
Kategorija:Dermoptera	Categorie:Huidvlieger
Kategorija:Skultura	Categorie:Beeldhouwkunst
Kategorija:Montenegro	Categorie:Montenegro
Kategorija:Kampjonati Ewropej tal-Futbol 2008	Categorie:Europees kampioenschap voetbal 2008
Mudell:Hu	Sjabloon:Hu
Mudell:Utent ga-1	Sjabloon:Gebruiker ga-1
Kategorija:Peramelemorphia	Categorie:Buideldas
Kategorija:Kultura tal-Veneżwela	Categorie:Cultuur in Venezuela
Kategorija:Bliet ta' Malta	Categorie:Plaats in Malta
Kategorija:Bliet tal-Vjetnam	Categorie:Stad in Vietnam
Għajnuna:Sintassi	Help:Wikificeren
Kategorija:Bliet kapitali fl-Ewropa	Categorie:Hoofdstad in Europa
Kategorija:Pika	Categorie:Fluithaas
Kategorija:Partiti politiċi ta' Malta	Categorie:Maltese politieke partij
Kategorija:Sports tal-bord	Categorie:Boardsport
Kategorija:Logħob tal-ballun	Categorie:Balsport
Kategorija:Belt Valletta	Categorie:Valletta
Kategorija:Mużiċisti Albaniżi	Categorie:Albanees musicus
Kategorija:Pholidota	Categorie:Schubdierachtige
Kategorija:Storja tal-matematika	Categorie:Geschiedenis van de wiskunde
Mudell:Żoni tal-ħin	Sjabloon:Navigatie tijdzones
Kategorija:Etoloġi	Categorie:Etholoog
Kategorija:Klabbs tal-futbol Belġjani	Categorie:Belgische voetbalclub
Kategorija:Saħħa	Categorie:Gezondheid
Kategorija:Grawnds tal-futbol skont il-pajjiż	Categorie:Voetbalstadion naar land
Mudell:Staġuni tal-Premier League Malti	Sjabloon:Navigatie voetbalseizoenen Malta
Mudell:Tim ta' Club Brugge KV	Sjabloon:Navigatie selectie Club Brugge
Kategorija:Klabbs tal-futbol Russi	Categorie:Russische voetbalclub
Kategorija:Mudelli tal-klabbs tal-futbol Belġjani	Categorie:Wikipedia:Sjablonen voetbalelftal België
Kategorija:Mudelli tal-klabbs tal-futbol Ġermaniżi	Categorie:Wikipedia:Sjablonen voetbalelftal Duitsland
Mudell:Utent pl-4	Sjabloon:Gebruiker pl-4
Kategorija:Abbozzi tax-xjenza	Categorie:Wikipedia:Beginnetje wetenschap & technologie
Kategorija:Isqfijiet Taljani	Categorie:Italiaans bisschop
Portal:Matematika	Portaal:Wiskunde
Kategorija:Mużiċisti Litwani	Categorie:Litouws musicus
Kategorija:Kompożituri Iżlandiżi	Categorie:IJslands componist
Kategorija:Lingwi Internazzjonali Awżiljari	Categorie:Internationale hulptaal
Mudell:Tim ta' RSC Anderlecht	Sjabloon:Navigatie selectie RSC Anderlecht
Kategorija:William Shakespeare	Categorie:William Shakespeare
Kategorija:Galatasaray SK	Categorie:Galatasaray SK
Kategorija:Mudelli tal-mużika	Categorie:Wikipedia:Sjablonen muziek
Kategorija:Kantanti Montenegrini	Categorie:Montenegrijns zanger
Kategorija:Kantanti Armeni	Categorie:Armeens zanger
Kategorija:Kittieba tar-Rinaxximent	Categorie:Renaissancedichter
Mudell:Infobox Kulur	Sjabloon:Infobox kleur
Kategorija:Kompożituri	Categorie:Componist
Kategorija:Macroscelididae	Categorie:Springspitsmuis
Mudell:Pajjiżi tal-Eurovision	Sjabloon:Navigatie landen Eurovisiesongfestival
Mudell:Utent scn-3	Sjabloon:Gebruiker scn-3
Mudell:Utent scn-2	Sjabloon:Gebruiker scn-2
Mudell:Utent hi-2	Sjabloon:Gebruiker hi-2
Mudell:Oc	Sjabloon:Oc
Mudell:Mt	Sjabloon:Mt
Mudell:MLT	Sjabloon:MT
Kategorija:Tazza tad-Dinja VIVA	Categorie:VIVA Wereldkampioenschap voetbal
Kategorija:Tazza tad-Dinja tal-Futbol 2006	Categorie:Wereldkampioenschap voetbal 2006
Kategorija:Kwalifikazzjoni għat-Tazza tad-Dinja tal-Futbol 2010	Categorie:Wereldkampioenschap voetbal 2010 kwalificatie
Kategorija:Grawnds tal-futbol fil-Ġermanja	Categorie:Voetbalstadion in Duitsland
Kategorija:ACF Fiorentina	Categorie:ACF Fiorentina
Kategorija:Abbozzi tal-agrikoltura	Categorie:Wikipedia:Beginnetje landbouw
Kategorija:Federazzjonijiet tal-futbol	Categorie:Voetbalbond
Kategorija:Kantanti Ażerbajġani	Categorie:Azerbeidzjaans zanger
Kategorija:Kantanti Bjelorussi	Categorie:Wit-Russisch zanger
Mudell:Tim ta' Valencia CF	Sjabloon:Navigatie selectie Valencia CF
Kategorija:Ktieb ta' Mormon	Categorie:Boek van Mormon
Kategorija:Borussia Dortmund	Categorie:Borussia Dortmund
Kategorija:Referis tal-futbol Brażiljani	Categorie:Braziliaans voetbalscheidsrechter
Kategorija:Alkimisti Brittaniċi	Categorie:Brits alchemist
Kategorija:Pajjiżi tal-Amerika Ċentrali	Categorie:Land in Centraal-Amerika
Kategorija:Cercle Brugge KSV	Categorie:Cercle Brugge
Kategorija:Dasyuromorphia	Categorie:Roofbuideldier
Mudell:TOCleft	Sjabloon:Inhoud links
Kategorija:Edizzjonijiet tal-Festival tal-Eurovision	Categorie:Eurovisiesongfestival naar jaar
Kategorija:FC Barcelona	Categorie:FC Barcelona
Kategorija:FC Bayern Munich	Categorie:FC Bayern München
Kategorija:Tazza tad-Dinja tal-Futbol tal-Klabbs	Categorie:Wereldkampioenschap voetbal voor clubs
Kategorija:Tazza tad-Dinja tal-Futbol	Categorie:Wereldkampioenschap voetbal
Kategorija:Plejers tas-Sena tal-FIFA	Categorie:Wereldvoetballer van het jaar
Kategorija:FK Sarajevo	Categorie:FK Sarajevo
Kategorija:Kantanti Ċiprijotti	Categorie:Cypriotisch zanger
Kategorija:Klabbs tal-futbol Armeni	Categorie:Armeense voetbalclub
Kategorija:Klabbs tal-futbol Awstrijaċi	Categorie:Oostenrijkse voetbalclub
Kategorija:Klabbs tal-futbol Bożnijaċi	Categorie:Bosnische voetbalclub
Kategorija:Klabbs tal-futbol Estonjani	Categorie:Estische voetbalclub
Kategorija:Klabbs tal-futbol Iżraeljani	Categorie:Israëlische voetbalclub
Kategorija:Klabbs tal-futbol Serbi	Categorie:Servische voetbalclub
Kategorija:Futbol fil-Korea t'Isfel	Categorie:Voetbal in Zuid-Korea
Kategorija:Grawnds tal-futbol fil-Belġju	Categorie:Voetbalstadion in België
Kategorija:Mudelli ta' kwotazzjoni	Categorie:Wikipedia:Sjablonen bronvermelding
Kategorija:Logħob tal-Pajjiżi ż-Żgħar tal-Ewropa	Categorie:Spelen van de Kleine Staten van Europa
Kategorija:Gran Mastri tal-Ordni ta' San Ġwann	Categorie:Grootmeester van de Orde van Malta
Kategorija:Simboli Olimpiċi	Categorie:Olympisch symbool
Kategorija:Irlanda	Categorie:Ierland (eiland)
Kategorija:Preżentaturi televiżivi Taljani	Categorie:Italiaans presentator
Għajnuna:Kronoloġija	Help:Paginageschiedenis
Kategorija:Festival tal-Eurovision taż-Żgħar	Categorie:Junior Eurovisiesongfestival
Kategorija:KAA Gent	Categorie:AA Gent
Kategorija:KRC Genk	Categorie:KRC Genk
Kategorija:KV Kortrijk	Categorie:KV Kortrijk
Kategorija:KV Mechelen	Categorie:KV Mechelen
Kategorija:Ordni Militari Sovran ta' Malta	Categorie:Orde van Malta
Kategorija:Logħob lingwistiku	Categorie:Taalspelletje
Portal:Kimika	Portaal:Scheikunde
Kategorija:Abbozzi tal-letteratura	Categorie:Wikipedia:Beginnetje literatuur
Kategorija:Kompożituri Maltin	Categorie:Maltees componist
Kategorija:Avukati Maltin	Categorie:Maltees advocaat
Kategorija:Letteratura Maltija	Categorie:Maltese literatuur
Kategorija:Mużiċisti Maltin	Categorie:Maltees musicus
Kategorija:Poeti Maltin	Categorie:Maltees dichter
Kategorija:Kantanti Maltin	Categorie:Maltees zanger
Għajnuna:Verżjoni għall-ipprintjar	Help:Printen
Kategorija:RSC Anderlecht	Categorie:RSC Anderlecht
Kategorija:Abbozzi tal-mediċina	Categorie:Wikipedia:Beginnetje geneeskunde
Kategorija:Mikelanġlu	Categorie:Michelangelo Buonarroti
Kategorija:Mużiċisti Montenegrini	Categorie:Montenegrijns musicus
Kategorija:SSC Napoli	Categorie:SSC Napoli
Kategorija:SV Zulte Waregem	Categorie:SV Zulte Waregem
Kategorija:Abbozzi tal-filosofija	Categorie:Wikipedia:Beginnetje filosofie
Kategorija:SK Sturm Graz	Categorie:SK Sturm Graz
Kategorija:Pitturi ta' Pablo Picasso	Categorie:Werk van Picasso
Kategorija:Lingwi Semitiċi	Categorie:Semitische taal
Kategorija:Paucituberculata	Categorie:Opossummuis
Kategorija:Kantanti Ġeorġjani	Categorie:Georgisch zanger
Kategorija:Mużiċisti Slovakki	Categorie:Slowaaks musicus
Kategorija:Kantanti Slovakki	Categorie:Slowaaks zanger
Kategorija:Grawnds tal-futbol fl-Afrika t'Isfel	Categorie:Voetbalstadion in Zuid-Afrika
Kategorija:Referis tal-futbol Spanjoli	Categorie:Spaans voetbalscheidsrechter
Kategorija:Provinċja ta' Agrigento	Categorie:Agrigento (provincie)
Kategorija:Provinċja ta' Kaltanissetta	Categorie:Caltanissetta (provincie)
Kategorija:Ludwig van Beethoven	Categorie:Ludwig van Beethoven
Kategorija:Ateiżmu	Categorie:Atheïsme
Kategorija:Standard Liège	Categorie:Standard Luik
Kategorija:Edizzjonijiet tal-Kampjonati Ewropej tal-Futbol	Categorie:Europees kampioenschap voetbal
Kategorija:Gżejjer diżabitati ta' Malta	Categorie:Onbewoond Maltees eiland
Kategorija:Didelphimorphia	Categorie:Opossum
Kategorija:Bolol	Categorie:Postzegel
Kategorija:Xjenza Applikati	Categorie:Toegepaste wetenschap
Kategorija:Trattati tal-Unjoni Ewropea	Categorie:Verdrag van de Europese Unie
Kategorija:Coritiba Foot Ball Club	Categorie:Coritiba Foot Ball Club
Kategorija:Futbol fil-Maċedonja	Categorie:Voetbal in Macedonië
Kategorija:Provinċja ta' Bergamo	Categorie:Bergamo (provincie)
Kategorija:Birkirkara FC	Categorie:Birkirkara FC
Kategorija:Kantanti Bulgari	Categorie:Bulgaars zanger
Kategorija:Tupaiidae	Categorie:Echte toepaja
Manidae	Schubdieren
Kategorija:Provinċja ta' Lodi	Categorie:Lodi (provincie)
Kategorija:Kantanti Żvizzeri	Categorie:Zwitsers zanger
Kategorija:Microbiotheria	Categorie:Microbiotheria
Kategorija:Pedagoġija	Categorie:Pedagogiek
Mudell:Edizzjonijiet tal-Logħob tal-Pajjiżi ż-Żgħar tal-Ewropa	Sjabloon:Navigatie Spelen van de Kleine Staten van Europa
Serie A 2013–14	Serie A 2013/14
Kategorija:Sports ta' preċiżjoni	Categorie:Precisiesport
Kategorija:Preistorja	Categorie:Prehistorie
Kategorija:Drammi ta' William Shakespeare	Categorie:Toneelstuk van Shakespeare
Kategorija:Mużiċisti Torok	Categorie:Turks musicus
Kategorija:Ptilocercidae	Categorie:Vederstaarttoepaja
Kategorija:Mużiċisti Bjelorussi	Categorie:Wit-Russisch musicus
Kategorija:Mużiċisti Ċiprijotti	Categorie:Cypriotisch musicus
Kategorija:Neftchi Baku PFC	Categorie:Neftçi Bakoe
Kategorija:Mudelli tal-Paġna prinċipali	Categorie:Wikipedia:Sjablonen hoofdpagina
Għajnuna:Gwida essenzjali/Sorsi	Wikipedia:Snelcursus (Externe links)
Mudell:Infobox Gazzetta	Sjabloon:Infobox krant
Mudell:IMSLP	Sjabloon:Link IMSLP
Kategorija:Utenti en-1	Categorie:Wikipedia:Gebruiker en-1
Kategorija:Utenti de-1	Categorie:Wikipedia:Gebruiker de-1
Kategorija:Atturi Amerikani	Categorie:Amerikaans acteur
Kategorija:Mużiċisti Rumeni	Categorie:Roemeens musicus
Mudell:Tim ta' Sunderland AFC	Sjabloon:Navigatie selectie Sunderland AFC
Mudell:Tim ta' Borussia Dortmund	Sjabloon:Navigatie selectie Borussia Dortmund
Mudell:Tim ta' VfL Wolfsburg	Sjabloon:Navigatie selectie VfL Wolfsburg
Mudell:Tim ta' SS Lazio	Sjabloon:Navigatie selectie Lazio Roma
Għajnuna:Medja	Help:Gebruik van geluid
Wikipedija:Ċaħda medika	Wikipedia:Voorbehoud bij medische informatie
Mudell:Kunsill Nordiku	Sjabloon:Navigatie Noordse Raad
Mudell:Primera Divisió	Sjabloon:Navigatie voetbal Andorra Lliga de Primera Divisió
Mudell:Tim ta' Real Madrid CF	Sjabloon:Navigatie selectie Real Madrid
Għajnuna:Gwida essenzjali/Diskussjoni	Wikipedia:Snelcursus/Overlegpagina's
Għajnuna:Gwida essenzjali/Linji gwida	Wikipedia:Snelcursus (Onthoud)
Mudell:Tim ta' Wigan Athletic FC	Sjabloon:Navigatie selectie Wigan Athletic
Mudell:Tim ta' KRC Genk	Sjabloon:Navigatie selectie KRC Genk
Mudell:Kunsilli lokali ta' Malta u Għawdex	Sjabloon:Navigatie gemeenten Malta
Wikipedija:Wikipedija fis-sit tiegħek	Wikipedia:Banners
Għajnuna:Gwida essenzjali/Konklużjoni	Wikipedia:Snelcursus/Tot slot
Mudell:Tim ta' Manchester City FC	Sjabloon:Navigatie selectie Manchester City FC
Mudell:Utent scn	Sjabloon:Gebruiker scn
Mudell:Tim ta' RAEC Mons	Sjabloon:Navigatie selectie RAEC Mons
Mudell:Federazzjonijiet tal-UEFA	Sjabloon:Navigatie leden UEFA
Mudell:Superliga Albaniża	Sjabloon:Navigatie voetbal Albanië Kategoria Superiore
Mudell:Tim ta' Liverpool FC	Sjabloon:Navigatie selectie Liverpool FC
Mudell:Tim ta' Birmingham City FC	Sjabloon:Navigatie selectie Birmingham City
Mudell:Tim ta' Hull City AFC	Sjabloon:Navigatie selectie Hull City AFC
Mudell:Tim ta' Aston Villa FC	Sjabloon:Navigatie selectie Aston Villa
Mudell:Tim ta' Tottenham Hotspur FC	Sjabloon:Navigatie selectie Tottenham Hotspur
Mudell:Tim ta' Villareal CF	Sjabloon:Navigatie selectie Villarreal
Murexia	Murexia
Wikipedija:VisualEditor	Wikipedia:Visuele tekstverwerker
Mudell:Tim ta' Paris Saint-Germain FC	Sjabloon:Navigatie selectie Paris Saint-Germain
Premier League 2013–14	Engels voetbalkampioenschap 2013/14
Mudell:Tim ta' KAA Gent	Sjabloon:Navigatie selectie AA Gent
Mudell:Tim ta' KV Kortrijk	Sjabloon:Navigatie selectie KV Kortrijk
Mudell:Tim ta' Standard Liège	Sjabloon:Navigatie selectie Standard Luik
Mudell:Tim ta' Olympique Lyonnais	Sjabloon:Navigatie selectie Olympique Lyonnais
Mudell:Tim ta' Fulham FC	Sjabloon:Navigatie selectie Fulham FC
Mudell:Tim ta' Lierse SK	Sjabloon:Navigatie selectie K. Lierse SK
Mudell:Tim ta' SC Lokeren	Sjabloon:Navigatie selectie Sporting Lokeren
Mudell:Tim ta' KV Mechelen	Sjabloon:Navigatie selectie KV Mechelen
Mario Notaro	Mario Notaro
Mudell:Tim ta' Waasland-Beveren	Sjabloon:Navigatie selectie Waasland-Beveren
Mudell:Grawnds tal-Ewwel Diviżjoni Belġjana	Sjabloon:Navigatie stadions betaald voetbal België
Mudell:Tim ta' SV Zulte Waregem	Sjabloon:Navigatie selectie SV Zulte Waregem
Mudell:Tim ta' Beerschot AC	Sjabloon:Navigatie selectie Beerschot AC
Mudell:Tim ta' Oud-Heverlee Leuven	Sjabloon:Navigatie selectie Oud-Heverlee Leuven
Mudell:Tim ta' R. Charleroi SC	Sjabloon:Navigatie selectie Sporting Charleroi
Birdman (film)	Birdman (film)
Edward Snowden	Edward Snowden
Mudell:Premijer Liga	Sjabloon:Navigatie voetbal Bosnië en Herzegovina Premijer Liga
Premier League Malti 2013–14	Premier League (Malta) 2013/14
Lista ta' l-ispeċi tal-mammiferi l-ġodda li ġew deskritti xjentifikament fis-sena 2007	Lijst van nieuw beschreven zoogdieren (2007)
Lista ta' l-ispeċi tal-mammiferi l-ġodda li ġew deskritti xjentifikament fis-sena 2008	Lijst van nieuw beschreven zoogdieren (2008)
Gaia Cauchi	Gaia Cauchi
Coreca	Coreca
Speċjali:TibdilRiċenti	Speciaal:RecenteWijzigingen
Kategorija:Utenti ja-4	Categorie:Wikipedia:Gebruiker ja-4
Krimea	Republiek van de Krim
Maurizio Malvestiti	Maurizio Malvestiti
Eurotamandua	Eurotamandua
