Naakaii Łizhiní Bikéyah	Afrika
Binaʼadaałtzózí Dinéʼiʼ Bikéyah	Japan
Bitsiighaʼ Łichííʼí Bikéyah	Ierland (land)
Hángewii	Hongarije
Dibé Diníí Bikéyah	Spanje
Wááshindoon Bikéyah Ałhidadiidzooígíí	Verenigde Staten
Bélgii Bikéyah	België
Látsębooʼ	Luxemburg (land)
Yágháhookáán	Heelal
Nahasdzáán	Aarde (planeet)
Nahoditsʼǫʼłání	Finland
Déinish Dineʼé Bikéyah	Denemarken
Póolish Dineʼé Bikéyah	Polen
Łitʼoowę́ęya	Litouwen
Ídelii	Italië
Swis Bikéyah	Zwitserland
Óóswiya	Oostenrijk
Gwíík Dineʼé Bikéyah	Griekenland
Tʼóok Bikéyah	Turkije
Béésh Bichʼahníí Bikéyah	Europa (werelddeel)
(*@@@u0026asia")	Azië
Shádiʼááhjí kéyah yistinígíí	Antarctica
Kéyah Wóyahgo Siʼánígíí	Nederland
Béésh bee akʼeʼelchíhí tʼáá bí nitsékeesígíí	Computer
Hastiin alą́ąjįʼ dahsidáhígíí Barack Obama	Barack Obama
Táłtłʼááh Chʼosh Bitooh (Kéyah Dah Siʼánígíí)	Uruguay
Bilasáana	Appel (plant)
Méhigo	Mexico (land)
Akééháshį́į́h Hahoodzo	Californië
Máaz	Mars (planeet)
Kénya	Kenia
Iithiyópya	Ethiopië
Gáana	Ghana
Náshdóítsoh bitsiijįʼ daditłʼooígíí	Leeuw (dier)
Dáághahii Dinéʼiʼ Bikéyah	Frankrijk
Łééchąąʼí	Hond
Tótaʼ Dinéʼiʼ Bikéyah	Verenigd Koninkrijk
Mósí	Kat (dier)
Dáághahii bizaad	Frans
Łóóʼ	Vissen (dieren)
Bwazííl	Brazilië
Biʼééʼ Łichííʼí Bikéyah	Rusland
Łóóʼtsoh dóó Tééh hóyáanii	Walvisachtigen
Élábéemah Hahoodzo	Alabama
Béésh Bichʼahii Bikéyah	Duitsland
Bééshbichʼahii bizaad	Duits
Tin Bikéyah	IJsland
Ééstii Bikéyah	Estland
Séetin	Saturnus (planeet)
Didzéchííʼ	Kers (fruit)
Chidí naatʼaʼí	Vliegtuig
Hastiin alą́ąjįʼ dahsidáhígíí George W. Bush	George W. Bush
Létbiiya	Letland
Yóókwein	Oekraïne
Chek Bikéyah	Tsjechië
Słóbaʼ Bikéyah	Slowakije
Słobíín Bikéyah	Slovenië
Wooméiniya	Roemenië
Bálgaa Bikéyah	Bulgarije
Dziłigaii Bikéyah	Albanië
Haʼaʼaahjí Hakʼaz Dineʼé Bikéyah	Groenland
Kwóóʼad Bikéyah	Kroatië
Bosna dóó Hetsog Bikéyah	Bosnië en Herzegovina
Azééwii Bikéyah	Azerbeidzjan
Andówa	Andorra
Béésh Łichíiʼii Bikéyah	Cyprus
Jóojah (Kéyah)	Georgië
Kʼazah Bikéyah	Kazachstan
Dziłizhin Bikéyah	Montenegro
Bádikin Sídii	Vaticaanstad
San Mawínoo Bikéyah	San Marino
Kyóoba	Cuba (land)
Hashkʼaan Bikéyah	Barbados
Indoníízha	Indonesië
Tʼóok bizaad	Turks
Kéyah Naakai Łizhinii Bikéyah Shádiʼááhjí Siʼánígíí	Zuid-Afrika
Aljííya	Algerije
Ózbeʼ Bikéyah	Oezbekistan
Tó	Water
Níłchʼi naalkidí	Televisie
Chíilii	Chili
Doodaatsaahii (Jíísas)	Jezus (traditioneel-christelijk)
Mókiwii	Mercurius (planeet)
Ákáʼátʼįįł (béésh ntsékeesígíí álʼíní)	Apple Inc.
Biinis	Venus (planeet)
Jíbitoo	Jupiter (planeet)
Yoowéinis	Uranus (planeet)
Néʼtoon	Neptunus (planeet)
Sį́ʼgaboo	Singapore
Tłóotoo	Pluto (dwergplaneet)
Łííhtensain	Liechtenstein
Dágháilchįįh	Adolf Hitler
Naaltsoos biniiʼ	Facebook
Naaki góneʼ yéigo daʼahijoogą́ą́ʼ	Tweede Wereldoorlog
Ałhíʼayiiltááh	Wiskunde
Aooméénii Bikéyah	Armenië
Ooljééʼ	Maan
Nahatʼeʼiitsoh Bikéyah	Australië (land)
Béésh Łigaii Bikéyah	Argentinië
Kolíya Bikéyah Náhookǫsjí Siʼánígíí	Noord-Korea
Naayééʼ	Dinosauriërs
Bilasáana bitseeʼ nineezígíí	Peer (plant)
Naturalis Historia of Pliny the Elder	Naturalis historia
Encyclopædia Britannica	Encyclopædia Britannica
Tó yaʼnidaʼaazgééd	Aquaduct (watergang)
Chʼil łitsooí díkʼǫ́zhígíí	Citroen (vrucht)
Hashkʼaan (łitsooígíí)	Banaan (vrucht)
Sǫʼ	Ster (hemellichaam)
Jóhonaaʼéí	Zon
Háájiʼjin	Waterstof (element)
Níłchʼi Ászólí	Helium
Haʼaʼaahjí Tíímow	Oost-Timor
Séwes	Ceres (dwergplaneet)
Haʼooméya	Haumea
Maakiimaakii	Makemake
Ééwis	Eris (dwergplaneet)
Káábin	Koolstof
Níłchʼi Yáʼátʼéehii	Zuurstof (element)
Hadoh dóó hakʼaz neiłkidígíí	Thermometer
Níłchʼi Łitsxooí	Neon (element)
Chihuahua Hahoodzo	Chihuahua (staat)
Soodin	Natrium
Béésh Łikoní	Magnesium
Béésh Ászólí	Aluminium
Tó Wónaanídę́ę́ʼ Bitsįʼ Yishtłizhii Bikéyah	India
Tʼoobááloo	Tuvalu
Béésh (Fe)	IJzer (element)
Tʼónga	Tonga (land)
Łeetsoii	Zwavel
Samóa	Samoa
Sólomon Tó Bináhaazyínígíí	Salomonseilanden
Banoʼáátʼoo	Vanuatu
Páápowa Bigíní Ániidí	Papoea-Nieuw-Guinea
Níłchʼi Dootłʼizhí	Argon
Eʼeʼaahjí Tónteel bikáaʼgi Kéyah Yázhí dah Ndaaʼeełgo Ałhidadiidzooígíí	Micronesia
Káálsiiyin	Calcium
Dilyį́hí	Lood (element)
Kílíbas	Kiribati
Chʼah Diʼilii Bikéyah	Mongolië
Fííjii	Fiji
Béésh doo Ńdiniichxíihii	Titanium
Táłkááʼ Bighan Dineʼé Bikéyah	Venezuela
Méíin Hahoodzo	Maine
Łį́į́ʼ	Paard (dier)
Naaldeehii	Dierenrijk
Sówinam	Suriname
Kéyah Nahasdzáán Ałníiʼgi Siʼánígíí	Ecuador
Kolámbiya	Colombia
Béésh Łibáhí	Kobalt
Bolíbiya	Bolivia
Béésh Łichíiʼii	Koper (element)
Niihémpshoo Hahoodzo	New Hampshire
Chʼosh doo yitʼíinii dláádí dóó Ábishjaaʼ	Schimmels
Jaméíkʼa	Jamaica
Méésíchóoshish Hahoodzo	Massachusetts
Kanédikiʼ Hahoodzo	Connecticut
Naaʼahóóhai	Kip (vogel)
Antíígwa dóó Hashkʼaan Bikéyah Yázhí	Antigua en Barbuda
Kéyah Ałkéé Nitį́įgo Dah Ndaaʼeełí	Hawaï
Damóo Bikéyah	Dominica
Domingo Bikéyah	Dominicaanse Republiek
Bisóodi	Varken (tam)
Héítii	Haïti
Iiwą́ą́	Iran
Iiwááʼ	Irak
Hakʼaz Dineʼé Bikéyah Hahoodzo	Alaska
Ízrel Bikéyah	Israël
Shádiʼááhjí Ásáí Bikéyah	Jemen
Jóoʼdan	Jordanië
Gah Bikeeʼ Taahíʼahí	Florida (staat)
Kíígiz Bikéyah	Kirgizië
Hoozdo Hahoodzo	Arizona (staat)
Kóóweiʼ	Koeweit
Lááʼos	Laos
Łíbanoo	Libanon
Óogin Hahoodzo	Oregon
Naakaii Dootłʼizhí Bikéyah Yázhí (Tó Bináhaazyínígíí)	Maldiven
Kéyah dah siʼánígíí	Amerika (continent)
Áshįįh Biiʼtó Hahoodzo	Utah
Béégashii	Rund
Maléízha	Maleisië
Dziłgaiitsoh Honeezkʼazii Bikéyah	Nepal
Omą́ą́	Oman
Eʼeʼaahjí Naakaii Dootłʼizhí Bikéyah	Pakistan
Kʼatár	Qatar
Ásáí Bikéyah Saʼoodí	Saoedi-Arabië
Swii Lankʼa	Sri Lanka
Sííwiya	Syrië
Tʼajiʼ Bikéyah	Tadzjikistan
Tʼáí Bikéyah	Thailand
Kǫʼ naʼałbąąsii diné bee nágéhéʼ	Trein
Tʼóokmen Bikéyah	Turkmenistan
Ásáí Bikéyah Yázhí Ałhidadiidzooígíí	Verenigde Arabische Emiraten
Biʼednam	Vietnam
Kolíya Bikéyah Shádiʼááhjí Siʼánígíí	Zuid-Korea
Óola	Goud
Naʼałkaahí	Wetenschapper
Bangla Bikéyah	Bangladesh
Angóola	Angola
Iiʼniʼ Tłʼiishtsoh Bikéyah	Bhutan
Bwoonéí	Brunei
Tʼanzanííya	Tanzania
Béésh Tózháanii	Kwik
Kéyah Dańlíinii	Filipijnen
Naakaii Łizhinii Bikéyah Beʼałnííʼ	Centraal-Afrikaanse Republiek
Hastiin Albert Einstein	Albert Einstein
Tʼóogo	Togo
Hooghan Tsé Bee Ádaalyaaí Bikéyah	Zimbabwe
Shádiʼááhjí Soodą́ą	Zuid-Soedan
Tswana Dineʼé Bikéyah	Botswana
Wóndii Dineʼé Bikéyah	Burundi
Ooljééʼ Bikéyah Yázhí	Comoren
Kéyah Káango Náhookǫsjí Siʼánígíí	Congo-Brazzaville
Kéyah Káango Shádiʼááhjí Siʼánígíí	Congo-Kinshasa
Jibótii	Djibouti (land)
Gíní Nahasdzáán Ałníiʼgi Siʼánígíí	Equatoriaal-Guinea
Gabǫ́ǫ́ (Kéyah)	Gabon
Géémbiya	Gambia (land)
Gíní	Guinee
Gíní Bisó	Guinee-Bissau
Chį́į́h Yee Adilohii Bideeʼ Tónteel Bibąąh	Ivoorkust
Táłtłʼááh Chʼosh Daadánígíí Bitooh (Łizhinii Bikéyahdi)	Kameroen
Tónteel Bibąąh Dootłʼizhí	Kaapverdië
Sotho Dineʼé Bikéyah	Lesotho
Łíbya	Libië
Madaʼgéésgáá	Madagaskar
Malááwii	Malawi
Moowitéínya	Mauritanië
Moroko	Marokko
Namííbya	Namibië
Yogénda	Oeganda
Wánda Dineʼé Bikéyah	Rwanda
Seishel	Seychellen
Náshdóítsoh Bitsiijįʼ Daditłʼooʼígíí Bidził	Sierra Leone
Soomáálii Bikéyah	Somalië
Soodą́ą	Soedan
Swáazi Dineʼé Bikéyah	Swaziland
Nahasdzáán Bikáaʼgi Kéyah Naaznilgo Ałhidadiidzooígíí	Verenigde Naties
Nidaashchʼąąʼígíí	Kleur
Béésh Łigaii	Zilver
Béésh Dildǫʼí	Tin (element)
Łéétsoh	Uranium
Hastiin alą́ąjįʼ dahsidáhígíí Bill Clinton	Bill Clinton
Míshigin Hahoodzo	Michigan
Tó Nitsaa Nílį́bąąh Hahoodzo	Illinois (staat)
Náhookǫsjí Dzígaii	North Dakota
Ałnííʼjí Dzígaii	South Dakota
Ayání Naakaii Hahoodzo	Montana (staat)
Tóʼííbézhí	Wyoming
Nímasii Kʼidadilyéhé	Idaho
Ahééhałtį́į́h Hahoodzo	Washington (staat)
Naʼazhǫǫsh Hahoodzo	Nevada (staat)
Kayíbíyinsíí (tónteel)	Caraïbische Zee
Dibé Nitsaa Hahoodzo	Colorado (staat)
Naakaii bizaad	Spaans
Naʼashjéʼii	Spinnen (dieren)
Chʼosh bijáád tseebíhígíí	Spinachtigen
Chʼosh bideeʼ ádaadinígíí	Chelicerata
Chʼosh bijáád dahólónígíí	Geleedpotigen
Béeso	Geld
Bijíniyah Hahoodzo	Virginia (staat)
Eʼeʼaahjí Bijiniyah Hahoodzo	West Virginia
Kin Yótʼááh Deezʼá Hahoodzo	New York (staat)
Wóód Áalin Hahoodzo	Rhode Island (staat)
Chʼosh bijáád hastání	Insecten
Méelin Hahoodzo	Maryland
Déláwee Hahoodzo	Delaware
Oohááyoo Hahoodzo	Ohio (staat)
Pénsówéíniyah Hahoodzo	Pennsylvania
Niijéízii Hahoodzo	New Jersey
Índíʼyéenah Hahoodzo	Indiana
Chidí	Auto
Jóojah Hahoodzo	Georgia (staat)
Akałii Bikéyah	Texas (staat)
Náhookǫsjí Kééláanah Hahoodzo	North Carolina
Shádiʼááhjí Kééláanah Hahoodzo	South Carolina
Méhigoʼ sídii	Mexico-Stad
Bilasáana diwozhí	Ananas
Mísísípii Hahoodzo	Mississippi (staat)
Ténésii Hahoodzo	Tennessee
Yootó Hahoodzo	New Mexico
Mínisóodah Hahoodzo	Minnesota
Wiskaansin Hahoodzo	Wisconsin
Haʼaʼaahjí Dzígaii	Iowa (staat)
Nabeeskah Hahoodzo	Nebraska
Shádiʼááhjí Dzígaii	Kansas (staat)
Tó Dzígaii Nílį́	Missouri (staat)
Tónteel Chʼínílį́	Louisiana (staat)
Kentákii Hahoodzo	Kentucky
Dził Biiʼ Dzígaii	Arkansas (staat)
Halgai Hóteel Hahoodzo	Oklahoma
Ho Chi Min Sídii	Ho Chi Minhstad
Bilagáana bizaad	Engels
Náhookǫsjí Hakʼaz Dineʼé Bikéyah	Nunavut
1901 – 1950	1902
Tłʼiish	Slangen
1951 – 2000	1979
Pope Benedict XVI	Paus Benedictus XVI
Maʼii Ashkii	Geronimo (indianenleider)
Tsin naaʼeeł táłtłʼááh naagháhígíí	Onderzeeboot
Tahoniigááh	Griep
Tłʼízí	Geit
Kǫʼ	Vuur
Tʼááłáhági átʼéego:Templates	Categorie:Wikipedia:Sjablonen
Dloziłchííʼ	Eekhoorn (zoogdier)
Tʼááłáhági átʼéego:Bideeʼtsʼinígíí	Categorie:Holhoornige
Tiníléítsoh	Komodovaraan
Chʼosh bijáád neeznánígíí	Tienpotigen
Aymara bizaad	Aymara (taal)
Łeeyiʼ chʼoshtsoh binááʼ hólónígíí	Wormsalamanders
Tʼááłáhági átʼéego:Dééł dóó Tóidoozohii	Categorie:Kraanvogelachtige
Médíwííyin Sii	Middellandse Zee
Jóojah (Ałtsʼáʼáztiin)	Georgia
Alóós	Rijst
Tsídii	Vogels
Kéłánii bikágí yilzhólígíí	Fluweelwormen
Kéchwa bizaad	Quechua (taal)
Ínsadoobíídiiya	Encyclopedie
Íiyisíí Naaltsoos	Hoofdpagina
Dziłgaiitsoh Honeezkʼazii	Himalaya
Tʼááłáhági átʼéego:Candidates for speedy deletion	Categorie:Wikipedia:Nuweg
Chʼil ahwééh	Thee (drank)
Kéyah Sahééwa Eʼeʼaahjí Siʼánígíí	Westelijke Sahara
1801 – 1850	1815
Łį́į́ʼ Bideeʼłáaʼii	Eenhoorn (fabeldier)
Hastiin Hernán Cortés	Hernán Cortés
Tsʼíʼii daʼaneezí	Steekmuggen
Dibé	Schaap (dier)
Łóóʼ hashkéhé	Haaien
Ghą́ą́ʼaskʼidii	Kamelen
Bidił Daazdoígíí dóó Daʼałtʼoʼígíí	Zoogdieren
Bíchį́į́h yee adilohii	Olifanten
Mágí dóó Mágí Ndahalinígíí	Primaten
(*wálá-)	Mieren
Tsísʼná	Bijen
Naayízítsʼósí	Courgette
Jiłtʼoʼí	Rabarber
Sęęschʼil	Bloemkool
Ayęęzhii yiltʼąąʼí	Aubergine (plant)
Naalʼeełí	Anatidae
Yas	Sneeuw
Jádí dághaaʼígíí	Gnoes
1851 – 1900	1865
Biʼééʼ Łichííʼí bizaad	Russisch
1751 – 1800	1784
Bááh	Brood
Bee Hazʼą́ą Ił Chʼétʼaah	Universele verklaring van de rechten van de mens
Kéyah haʼdéísná	Aardbeving
Tó nitéél nitságoʼ atságáá	Tsunami
Níyoltsoh	Tornado (wervelwind)
Saad bee alʼį́į́hni	Schrift
Tʼááłáhági átʼéego:Dáághahii	Categorie:Frankrijk
Mąʼii łitsooí	Vos (dier)
Naaltéʼ	Slavernij
Ahwééh	Koffie
Abeʼ	Melk (drank)
Dził	Berg (landvorm)
Doo Nidahałtingóó	Woestijn
Cryptographic	Cryptografie
Guadalajara	Guadalajara (Jalisco)
Tsídii naʼałkʼaiʼí	Pinguïns
Kolíya Dineʼé bizaad	Koreaans
Tó niteel	Oceaan
Hodíłchʼil Níłtsánígíí	Regenwoud
HiTSʼezh	IPod
Hazéí	Eekhoorns
Hazéí naatʼáʼii	Vliegende eekhoorns
Ééʼ néíshoodí	Rooms-katholieke Kerk
Kwį́į́n Elizabeth II	Elizabeth II van het Verenigd Koninkrijk
Hastiin alą́ąjįʼ dahsidáhígíí Ronald Reagan	Ronald Reagan
Hastiin Emperor Yongle	Yongle
Naʼashjéʼiitsoh	Wolfspinnen
Naaldlooshii dadichʼízhii	Reptielen
Tsin Deigházhígíí	Knaagdieren
Hasbídí	Duiven (vogels)
Tééh hóyáanii	Bruinvissen
Biyáázh Tsʼǫʼasánígíí (Táyiʼ dóó Niʼkáágóó Ndaakaaígíí)	Amfibieën
Géeso	Kaas
Chʼil naʼatłʼoʼii (chʼiyáán)	Druif
Tsísʼná bitłʼizh	Honing
Atsįʼ	Vlees
Naʼashjéʼii tsiizisí	Trilspinnen
Nímasii	Aardappel
Áshįįh łikan	Tafelsuiker
Haʼałtsédii	Noot (botanisch)
Wááshindoon bisiláołtsooí	United States Armed Forces
Naʼiiniʼ bá Hooghantsoh	World Trade Center (New York)
Áshįįh	Keukenzout
Wááshindoondi bee hazʼáanii ádeiłʼíní	Amerikaans Congres
Tsin naaʼeeł	Schip (transportmiddel)
Nidaʼąnyéézh	Irrigatie
Naadą́ą́ʼ	Mais
Naʼashchʼąąʼ	Schilderkunst
Wótáahgoo ałnaaʼáłtʼahiʼ	Ruimtevaarder
Azhish	Dans
Naʼashjéʼii nahachaʼígíí	Springspinnen
Kéyah Daʼnaaznilígíí	Lijst van landen in 2015
Shash	Beren
Hastiin alą́ąjįʼ dahsidáhígíí John Adams	John Adams (politicus)
Hastiin alą́ąjįʼ dahsidáhígíí Thomas Jefferson	Thomas Jefferson
Hastiin alą́ąjįʼ dahsidáhígíí Andrew Jackson	Andrew Jackson
Ńdíshchííʼ	Den (geslacht)
Tłʼoh naadą́ą́ʼ	Tarwe
Naałniih yichʼą́ą́h naabaahígíí bąąh dahooʼaahgo	Aids
Jéíʼádįįh	Tuberculose
Łóódtsoh	Pokken
Zelda bahaneʼ	The Legend of Zelda (computerspelserie)
Naakáí dinéʼiʼ biempire Méhigodi	Azteken
Łéétsoh bee atsiniltłʼish álʼį́	Kernenergie
Łéétsoh beeʼeldǫǫhtsoh beeʼalį́į́h	Kernwapen
Chidí naaʼnaʼí beeʼeldǫǫh bikááʼ dah naaznilígíí	Tank (voertuig)
Jalisco Hahoodzo	Jalisco
Dzidzé łikaní dinilchííʼígíí	Framboos
Mágí bichʼiyąʼ	Kokospalm
Dzidzétsoh	Perzik
Chʼil łitsxooí	Sinaasappel
Chʼil dishooí	Kiwi (fruit)
Chʼil dootłʼizhí díkʼǫ́zhígíí	Limoen
Abeʼ yistiní	Roomijs
Méhigo bizaad	Nahuatl
Diné bizaad	Navajo (taal)
Jeeʼiighááh	Oorwormen
Tenochtitlan	Tenochtitlan
Ásáí Bizaad	Arabisch
Honeezílígi	Subtropisch klimaat
Atʼaʼ yiltʼąąʼí	Palmenfamilie
Niłchiis	Veelvraat (zoogdier)
Tsin yilátah ayání	Giraffe (dier)
Naalʼeełídaaʼí	Vogelbekdier
Naʼashǫ́ʼii	Hagedissen
Béésh bee akʼeʼelchí áłtsisígíí	Personal computer
Wikiibíídiiya:Naaltsoos nizhónígo ádaalyaaígíí	Wikipedia:Etalage
Bee álnééhí:Link FA	Sjabloon:Link FA
Bimááʼ Hahoodzo	Vermont
Hoozdoh	Phoenix (Arizona)
Tʼáyaałchííʼ	Gouden grondspecht
Táłkááʼ tsʼin bíchį́į́hnézí	Gaviaal
Tsin naaʼeeł chidí naatʼaʼí bee nágéhéʼ	Vliegdekschip
Tsídiitsoh	Struisvogel
Kolíya bikéyah (Ałtsʼáʼáztiin)	Korea
Mąʼiitsoh	Wolf
Chʼídeeldlóohiitsoh	Schoenbekooievaar
Hodíłchʼilgi dlǫ́ʼiitsoh	Loewak
Tóidoozohii bidaaʼ łichííʼígíí	Waterhoen
Táłtłʼááh yilcháazhii	Sponsdieren
Tónteel naʼashjéʼii	Zeespinnen
Séigoʼ bíláshgaanézí	Zweepspinnen
Naʼashjéʼii jáádnézí	Hooiwagens
Séigoʼchilí bitseeʼ ádinígíí	Bastaardschorpioenen
Séigoʼ	Schorpioenen (orde)
Zahalchíʼii	Rolspinnen
Hastiin Emperor Qianlong	Qianlong
Séigoʼ bitseeʼ áłtsʼózígíí	Zweepstaartschorpioenen
Yaaʼ doo yitʼíinii	Acarina
Tsídii doo ndaatʼáʼii	Loopvogels
Hodíłchʼilgi naaʼahóóhai	Tinamoes
Tłʼiishkʼosí (tsídii)	Slangenhalsvogels
Télii	Ezel (dier)
Náshdóítsoh noodǫ́zígíí	Tijger
Kʼíneeshbízhiinééz	Spaghetti
Chʼosh yoołgai bitsʼaʼígíí	Ostreidae
Tábąąhgi łeeyiʼ chʼosh	Zeepier
Azeeʼ hókániitsoh	Speerdistel
Táłkáaʼgi Tsídii	Eendvogels
Tązhii dóó Naaʼahóóhai Ndahalinígíí	Hoendervogels
Naalʼeełii keelóól	Futen
Tsídii Deílʼésígíí	Ooievaarachtigen
Daʼałtʼoʼígíí Biyęęzhii Deiłchíhígíí	Cloacadieren
Adijiłii bíchį́į́hnézí	Mierenegels
Biyázhí neiyéhé	Opossums
Hazéítsʼósii	Wangzakeekhoorns
Chidí bikʼah	Aardolie
Chéłchaaʼ	Kevers
Łį́į́ʼ ałchiní	Przewalskipaard
Dlǫ́ʼii yił aheełtʼéhii noodǫ́zígíí	Zebramangoeste
Naʼastsʼǫǫsíʼniiʼí	Echte buideldassen
Shash naʼazísí	Wombats
Nahatʼeʼiitsohchilí	Kangoeroeratten
Náʼagéédí łichíiʼii	Goudmollen
Bįįh Danilínígíí	Hertachtigen
Tin	IJs (water)
Tłʼohchin díchʼííʼí	Knoflook
Taʼneeskʼání áłtsʼóózígíí	Cucumis sativus
Tłʼohchin (chʼil daadánígíí)	Ui (plant)
Chʼil łichxíʼí	Tomaat
Béésh Łichíiʼii Bikéyah Náhookǫsjígo Siʼanígíí	Noord-Cyprus
Naʼazhǫǫsh Hátsoh	Las Vegas (Nevada)
Náshdóí dilwoʼí	Jachtluipaard
Tsékǫʼ	Steenkool
Néʼéshjaaʼ	Uilen (orde)
Bíígháán Dahólónígíí	Gewervelden
Kʼishchííʼ	Berk
Ǫǫbǫʼii	Hop (vogel)
Náshdóí Ndahalinígíí	Katachtigen
Yádiłhił yiiyídíʼ nahosdzáán yináádáłiʼ	Internationaal ruimtestation ISS
Tó wónaanídę́ę́ʼ toohjįʼ noołnahii	Blauwe reiger
Hashkʼaan dijéʼé	Dadelpalm
Wááshindoon (Ałtsʼáʼáztiin)	Washington
Bidił Daazdoígíí dóó Daʼalghałígíí	Roofdieren
Chʼoshtsoh	Kakkerlakken
Dlǫ́ʼii yázhí	Wezel (dier)
Tsʼíʼii dóó Tséʼédǫ́ʼii	Tweevleugeligen
Biniiʼłigaii (néʼéshjaaʼ)	Kerkuil
Mąʼii Ndahalinígíí	Hondachtigen
Bijáád Ádaadinígíí	Weekdieren
Chʼosh łitsxooí dóó Chʼosh łichííʼí	Lieveheersbeestjes
Táłkááʼ naalzheehí	Visarend
Bizaʼazis Dahólónígíí	Buideldieren
Dlǫ́ʼiiłgaii	Hermelijn (dier)
Naalʼeełí bitsiiʼ dootłʼizhí	Wilde eend
Sǫʼ łóóʼ	Zeesterren
Giníłbáhí	Havik (vogel)
Tʼádootłʼizhii	Vlaamse gaai
Zhį́ʼii	Raaf (vogel)
Táłkááʼ tsʼin Danilínígíí	Krokodilachtigen
Chʼosh bikágí dantłʼizí	Kreeftachtigen
Dééł	Kraanvogels
Chʼosh bitsʼaʼígíí	Tweekleppigen
Atsá dóó Giní Ndahalinígíí	Falconiformes
Łóóʼ ooshgę́ęzhii	Kraakbeenvissen
Tániilʼáí	Libellen
Wóláchííʼ yildeełí bikágí ntłʼizí	Manis
Gah Danilínígíí	Haasachtigen
Tsísʼnátsoh	Hommels
Hazéí yiltseeʼí	Duizendblad (soort)
Chʼosh bikǫʼí	Glimwormen
Zéédzísgaii	Fazant
Dlǫ́ʼii Ndahalinígíí	Marterachtigen
Tsin yiłkaałii	Spechten
Bideeʼtsʼinígíí	Holhoornigen
Dééł dóó Tóidoozohii Ndahalinígíí	Kraanvogelachtigen
Gáagii dóó Joogii Ndahalinígíí	Kraaien
Chʼiltaatʼagii	Blauwe kiekendief
Tsin naaʼeeł diné bee nágéhéʼ	Veerboot
Gad	Jeneverbes (geslacht)
Jááłánii	Duizendpotigen
Biishchʼid Dahólónígíí	Placentadieren
Chʼosh Deildeełii	Insecteneters
Tó wónaanídę́ę́ʼ naalʼeełítsoh łibáhígíí	Grauwe gans
Tónteel dóó Tábąąhgi Tsídii	Steltloperachtigen
Ńdíshchíitah dlǫ́ʼii	Boommarter
Biyaatsʼiin Dahólónígíí	Gnathostomata (Vertebrata)
Tooh łéʼétsoh	Muskusrat
Chaatʼíní	Veldzuring
Łóóʼ hashkéhé dootłʼizhígíí	Grote blauwe haai
Wóʼatsʼǫǫsii Ádaatʼéhígíí	Halfvleugeligen
Atsáłgaii	Ruigpootbuizerd
Béégashiiʼilí	Jak
Tó wónaanídę́ę́ʼ dlǫ́ʼii	Bunzing
Tsxį́į́łnaalkʼįhii	Gierzwaluwen
Dziłditłʼoii Bił Hahoodzo	San Juan County (Utah)
Hakʼaz naalʼeełí	Eider (vogel)
Naalʼeełítsoh bitsiiʼ halzhinígíí	Grote Canadese gans
Chʼó	Spar
Łóóʼtsoh łizhin dóó łigaígíí	Orka (dier)
Jáádtsʼósí	Kluten (vogels)
Téél dzítsooii dóó Tsétah chʼosh	Loopkevers
Naalʼeełítsoh diłhiłígíí	Rotgans
Tábąąh dlǫ́ʼii	Amerikaanse nerts
Dlǫ́ʼii bitéél halgaií	Steenmarter
Tábąąstííntsoh łibáhígíí	Grijze zeehond
Naakaii Łizhiní Bikéyahdi Hadahóólįįdígíí	Afrotheria
Diné Nááhódlóonii bizaad	Athabaskische talen
Łį́į́ʼ bitsísʼná	Horzels
Tónteel tsídii	Meeuwen (vogels)
Ałtį́į́ jikʼáshí (chʼil)	Paardenstaart (geslacht)
Hazaʼaleehtsoh (dííshjį́ ááłjiní)	Selderij
Kʼaalógii dóó Iichʼąhii	Vlinders
Díłdánii yił aheełtʼéhii	Kwartel
Chʼałdą́ą́ʼ / Jádí nátʼoh (chʼil daadánígíí)	Asperge
Tséʼédǫ́ʼii dootłʼizhí	Bromvliegen
Jaaʼabaní Danilínígíí	Vleermuizen
Wóónałchídii	Kniptorren
Tsídii bidaanézí	Ooievaars
Dlǫ́ʼii	Kleine marters
Lókʼaaʼ	Riet
Tsídiiłbáhí	Mussen
Biłʼeʼeliníʼ	Bakpoeder
Táłtłʼááh chʼoshchilí	Krill
Tsiiʼyiishbizhí Dinéʼiʼ Bikéyah	China
Naalʼeełí binááʼ łitsooígíí	Brilduiker
Tábąąstíín	Otter (dier)
Náshdóíłgaii łikizhígíí	Sneeuwpanter
Tábąąstííntsoh Danilínígíí	Zeeroofdieren
Dlǫ́ǫ́ʼ	Prairiehonden
Náshdóí bijaałizhiní	Caracal (dier)
Chʼóhojilyééh	Doornappel
Chʼah Diʼilii Bikéyahdę́ę́ʼ naalʼeełítsoh	Zwaangans
Tsídii yáłtiʼí	Papegaaiachtigen
Tééh łį́į́ʼ	Zebra (dier)
Náshdóí łikizhígíí	Ocelot
Dííłdzid jeeshóóʼ	Aasgier
Tʼáadoo leʼé danílʼį́ bił hazʼą́	Museum
Shash łizhin dóó łigaígíí	Reuzenpanda
Shash łigaígíí	IJsbeer
Gaantsʼosí	Zeelelies
Hastiin alą́ąjįʼ dahsidáhígíí Theodore Roosevelt	Theodore Roosevelt
Neeshchʼííłgai	Kasjoeboom
Dilní bee Nidaʼanéhígíí	Muziekinstrument
Dééłgai	Cygnus (geslacht)
Bikááʼ náʼoobałí	Helikopter
Dziʼizítsoh	Motorfiets
Tééhoołtsódii	Nijlpaard
Séí	Zand
Naakaii Łizhiní Bikéyahdę́ę́ʼ náshdóítsoh łikizhígíí	Luipaard
Déélgééd	Neushoorns
Beeʼeldííl Dahsinil	Albuquerque
Hashkʼaan dootłʼizhí (babáayah)	Papaja
Chʼil łigaii (atʼééké bijish)	Wittekool
Náshdóítsoh	Poema
Ásáí dinéʼiʼ	Arabieren
Deeteel	Eland
Shádiʼááhdę́ę́ʼ náshdóítsoh łikizhígíí	Jaguar
Lókʼaatsoh	Bamboe
Káango (Ałtsʼáʼáztiin)	Congo
Kʼaiʼ	Wilg
Shash bizaʼazis hólóní	Koala
Náshdóí kʼos bee naashchʼąąʼígíí	Nevelpanter
Shashtsoh	Bruine beer
Łéʼétsoh	Rattus
Akʼáán	Meel
Mágítsoh	Gorilla's
Bitsįʼ yishtłizhii	Indianen
Chʼil akʼahí	Avocado
Neeshchʼííłbáhí	Pinda
Dzidzétsoh díkʼǫ́ǫzhii	Abrikoos
Naʼashǫ́ʼii łahgo ánééhé	Kameleons
Yootó	Santa Fe (New Mexico)
Łééchąąłgaii	Greyhound (hond)
Nahatʼeʼiitsoh Bikéyahdę́ę́ʼ łééchąąʼí ałchiní	Dingo
Chʼééhjiyáán	Watermeloen
Teide	El Teide
Naʼastsʼǫǫsí	Mus (geslacht)
Hakʼaz bįįh	Rendier
Chʼosh doo yitʼínii	Micro-organisme
Táshchozhii	Zwaluwen (zangvogels)
Neeshchʼííʼ hááheeshchiiʼí	Amandelboom
Łóóʼ bigaan tseebíí	Octopoda
Chʼosh bikágí ntłʼizí	Krabben
Tábąąstííntsoh bideeʼ hólónígíí	Walrus
Mágí diʼilí	Orang-oetans
Atsátsoh	Steenarend
Łóóʼtʼą́hí atsiniltłʼish ííłʼínígíí	Torpediniformes
Chʼil łitsxooí ntsxaaígíí	Grapefruit
Kʼíníjíłʼahí (dííshjį́ ááłjiní)	Kruisbes
Kʼaalógiiłgaígíí	Witjes (vlinders)
Naʼastsʼǫǫsí binááʼ áłtsʼíísígíí	Spitsmuizen
Dzaanééz	Muildier/muilezel
Tsinlátah shash łichíʼígíí	Kleine panda
Tsídii jáádnézí	Phoenicopterus
Tééh łééchąąʼí	Hyena's
Łóóʼtsoh dootłʼizhígíí	Blauwe vinvis
Sóól	Esdoorn (geslacht)
Aghaaʼ	Wol
Deesdoigi	Tropen (geografie)
Shádiʼááhdę́ę́ʼ tłʼízí	Lama (dier)
Mósíʼilí	Pers (kattenras)
Lókʼaatah mósí ałchiní	Moeraskat
Náátsʼózídę́ę́ʼ mósíłkizhii ałchinígíí	Bengaalse tijgerkat
Náshdóítʼą́ʼí łikizhígíí	Serval (katachtige)
Tábąąh béégashii	Waterbuffel
Béégashiitsoh naʼałkǫ́ǫ́ʼígíí	Lamantijnen
Hastiin Leiw Éíwiksson	Leif Eriksson
Akágí yitsʼǫǫsii	Bloedzuigers
Anáʼálwoʼ:TʼAN (FAQ)	Help:Veelgestelde vragen
Táłkááʼ tsʼin	Krokodillen
Chidítsoh	Vrachtauto
Gáagii	Corvus (geslacht)
Tó wónaanídę́ę́ʼ náshdóí	Euraziatische lynx
Jááłánii (bitsiitsʼiin nteelígíí)	Duizendpoten
Giní	Falco (geslacht)
Dahiitį́hii	Kolibries
Tsídii biyęęzhtsohígíí	Apteryx
Tązhii	Meleagris
Chʼosh (Bíígháán Ádaadinígíí)	Ongewervelden
Gáagii naashchʼąąʼígíí	Scharrelaars
Mąʼii	Coyote
Dah Naatʼaʼí Sǫʼ bił Sinil	The Star-Spangled Banner
Akʼah sisíʼí tsin	Eucalyptus
Mááya dinéʼiʼ	Maya's
Gahtsoh	Echte hazen
Bisóodi bíchį́į́h nineezí	Aardvarken
Sonora Hahoodzo	Sonora (staat)
Nahakʼízii	Krekels
Chaaʼ	Bevers (geslacht)
Chʼilzooł	Broccoli
Kááʼtsʼiní	Gordeldieren
Atsʼiis naałdzid	Longkanker
Béésh náábałí atsiniltłʼish ííłʼínígíí	Windturbine
Méhigo tééh	Vallei van Mexico
Shą́ą́ʼnahalghałí (naaldeehii)	Klipdasachtigen
Nahatʼeʼiitsoh łichíiʼii	Rode reuzenkangoeroe
Azeeniłchin	Lipbloemenfamilie
Chʼał	Kikkers
Tsxilghááh	Salamanders
Shádiʼááhdę́ę́ʼ atsátsoh	Harpij (roofvogel)
Shádiʼááhdę́ę́ʼ chʼał kʼaasdáhígíí	Pijlgifkikkers
Chʼał niłtólí	Glaskikkers
Chʼał dichʼízhí	Padden
Tónteel tsídiitsoh	Albatrossen
Chidí nadlééh	Cabriolet
Chʼał atʼąąʼ nahalinii	Megophryidae
Naashgalí	Mescalero (volk)
Bisóodi ałchiní	Wild zwijn
Naʼastsʼǫǫsí dóó Łéʼétsoh Danilínígíí	Muroidea
Mariner 10	Mariner 10
Sǫʼ łóóʼ bigaanézí	Slangsterren
Dághaałóóʼ	Meervalachtigen
Łóóʼtʼą́hí	Platvissen
Toohjįʼ ndiigaii	Amerikaanse kleine zilverreiger
Kʼaalógii bitseeʼ hólóní	Pages (vlinders)
Tó wónaanídę́ę́ʼ dlǫ́ʼiiłkizhii	Gevlekte bunzing
Díłdánii	Odontophoridae
Táłtłʼááh łį́į́ʼ	Zeepaardjes
Łóóʼ bíígháántsiighąąʼ ádaadinígíí	Slijmprikken
Béésh Sinil	Winslow (Arizona)
Achʼįʼ Náhiłtį́į́	Safford
Tó wónaanídę́ę́ʼ dzeeh	Edelhert
Tsézhin Deezʼáhí	St. Johns (Arizona)
Béésh Bá Hooghan	Globe (Arizona)
Kinłání (Hoozdoh Hahoodzo)	Flagstaff (Arizona)
Michoacán Hahoodzo	Michoacán de Ocampo
Tʼiisyaakin	Holbrook (Arizona)
Naʼníʼá Hótsaa	Page (Arizona)
Táłtłʼááh chʼosh daadánígíí	Garnalen
Mágíshzhin	Chimpansees
Łóóʼntsxaaí łikizhígíí	Walvishaai
Dlǫ́ʼii yił Aheedaałtʼéhígíí	Mangoesten
Béésh Bichʼahníí Bikéyahdę́ę́ʼ ayání	Wisent
Łóóʼtsoh bitsiiʼ dikʼání	Potvis
Waaʼ (dííshjį́ ááłjiní)	Spinazie
Néʼéshjaatsoh	Amerikaanse oehoe
Shádiʼááhdę́ę́ʼ tłʼízíʼilí	Alpaca (zoogdier)
Chʼosh ditłʼooí	Rups
Łóóʼ bigaan neeznání	Pijlinktvissen
Bijáád noodǫ́ǫzii	Okapi
Méhigo Hahoodzo	Mexico (staat)
Ayání	Amerikaanse bizon
Mąʼiiłgaii	Poolvos
Táłtłʼááh chʼosh chʼééh digháhii bideetsohígíí	Zeehazen
Gólízhii Danilínígíí	Stinkdieren
Táłtłʼááh adijiłii	Zee-egels
Nahachagii	Caelifera
Wóóneeshchʼįįdii (nahachaʼígíí)	Treksprinkhaan
Tsídiitsoh ditsʼozígíí	Emoe
Ałhaʼdeetʼaah	Overeenkomst (contract)
Naayééʼ tsídii	Archaeopteryx (dier)
Tsísʼná (bitłʼizh ííłʼínígíí)	Honingbijen
Chééwokii dinéʼiʼ	Cherokee (volk)
Tsin naaʼeeł hééł bee nágéhéʼ	Vrachtschip
Ałtį́į́ jikʼáshí áłtsʼózígíí (chʼil)	Heermoes
Yéigo ałhoshii	Slaapmuizen
Naʼashjéʼii bijéí dah łichíiʼii	Zwarte weduwe (spin)
Mágí dághaaʼígíí	Keizertamarin
Didzéłchííʼ	Ilex
Naałání	Comanche (volk)
Oozéí / Ayahkinii	Hopi (volk)
Toohjįʼ noołnahiitsoh	Reuzenreiger
Bidááʼ Haʼaztʼiʼ Tsékooh	Grand Canyon
Táłtłʼááh naʼashjéʼii	Waterspin
Táłtłʼááh tsisteełtsoh	Lederschildpad
Tsídii yáłtiʼí yázhí	Grasparkiet
Tábąąh mąʼii	Gewone wasbeer
Hołchʼíʼí	Brandnetel
Tsįdláád	Baardmos
Dáághahii dinéʼiʼ	Fransen
Shash łizhinígíí	Amerikaanse zwarte beer
Náshdóí bizaʼazis hólóní	Buidelwolf
Łeeyiʼ chʼosh	Lumbricina
Shash bitéélgaígíí	Aziatische zwarte beer
Chʼoshtʼą́hí	Platwormen
Hashtłʼish jeeshóóʼ	Lammergier
Jádí bíchį́į́htsohígíí	Saiga
Táłtłʼááh chʼoshtsoh chʼééh digháhii	Zeekomkommers
Chidí naatʼaʼí dilwoʼí	Jachtvliegtuig
Bíchį́į́h naatsʼǫǫdí	Tapirs
Tó wónaanídę́ę́ʼ mąʼii	Gewone jakhals
Chʼóshgai (tsin)	Witte spar
Łóóʼ Bigaan Dahólónígíí	Inktvissen
Naʼashǫ́ʼii łóóʼ	Palingachtigen
Dahbaʼ (tsin)	Fraxinus
Łóóʼ hashkéhétsoh	Witte haai
Neeshchʼííłchííʼ	Kastanje
Chį́į́hnézí nahatʼeʼígíí	Springspitsmuizen
Táłtłʼááh ayání	Doejong
Dibé Diníí Bikéyahdę́ę́ʼ náshdóí	Pardellynx
Maadíséloo	Monticello (Utah)
Kʼaiʼ Bił Hahazteel	Kanab
Toohjįʼ ndiigaiitsoh	Grote zilverreiger
Wóóneeshchʼįįdii	Zangcicaden
Dééshzhiin	Zwarte zwaan
Naakaii náásééł	Bidsprinkhanen
Dlǫ́ǫ́ʼ ntsxaaígíí	Capibara
Mąʼii bijaaʼtsohí	Fennek (vos)
Dilchaʼ	Marmotten
Náshdóí łibáhígíí	Rode lynx
Chʼilhaatʼaʼii	Smelleken
Tééh hóyáaniitsoh	Witte dolfijn
Jádí bideeʼ yisdizígíí	Impala
Náátsʼózídę́ę́ʼ mąʼiiłchííʼ	Aziatische wilde hond
Łóóʼtsoh bighą́ą́ʼ yílkʼidígíí	Bultrug
Ghą́ą́ʼnaakiskʼidii	Kameel
Tábąąh mąʼiiniiʼí	Wasbeerhond
Naʼazhǫǫsh (ndajiné dóó adazhdikaʼgi)	Casino (gokken)
Ndikʼąʼ	Behaarde katoen
Dlǫ́tʼą́ʼí	Stokstaartje
Azeeʼ hókániitsoh (chʼil daadánígíí)	Artisjok
Kéchwa dinéʼiʼ	Quichua (volk)
Mąʼii bizaʼazis hólóní	Tasmaanse duivel
Shash bítááʼłgaígíí	Brilbeer
Jádítsoh	Grote koedoe
Naatʼáanii Moctezuma II	Motecuhzoma II
Biwooʼ Ádaałtsʼíísígíí	Luiaards en miereneters
Ásáí dinéʼiʼ bikéyah	Arabische wereld
Shash yázhí	Maleise beer
Shash ndilnaʼii	Lippenbeer
Teeł	Lisdodde
Chʼódeenínii	Blauwspar
Łéʼétsoh yiljaaʼí	Boterbloem
Hakʼaz náshdóí	Canadese lynx
Mąʼii yił Ałhidanoolinígíí Yázhí	Kleine beren
Béésh Bichʼahii beʼakétłʼóól dijoolí	Koolrabi
Tłʼoh waaʼí nahalinígíí	Witte klaver
Tséʼésgízii	Gele ribes
Tábąąstííntsoh dághaaʼígíí	Baardrob
Atʼééké bijish yázhí	Spruitkool
Tsékooh	Kloof
Noodah	Agave (geslacht)
Łeeʼdoolʼeezí	Bremraapfamilie
Kinteel Bił Hahoodzo	San Juan County (New Mexico)
Beeʼeldííl Dahsinil Bił Hahoodzo	Bernalillo County
Aniłtʼánii	Netvleugeligen
Kʼaalógii bijáád dį́įʼii	Nymphalidae
Nímasii yiyání	Coloradokever
Awééʼchíʼí (chʼil)	Klokje
Taʼaghálii	Astragalus (geslacht)
Naaʼołí yiltʼąąʼí	Lathyrus
Azeeʼ ndootʼeezhí łibáhígíí	Malrove
Hastóí tsiiyéélí	Clematis
Chʼilátah atsʼos	Basterdwederik
Kʼish	Witte els
Dééłjáád	Krulzuring
Shį́náldzidí (chʼil bilátah hózhóón)	Leeuwenbek
Kʼįįʼ	Sumak (geslacht)
Naaztání	Valse christusdoorn
Táłkááʼbéésh	Sagittaria
Tsinyaa tłʼoh	Beemdgras
Tłʼééʼ yiigáhii	Teunisbloem
Tłʼoh deeskʼidí	Papegaaienkruid
Ndootʼeezhí	Bergamot (kruid)
Wóóseekʼidii	Pijlstaarten
Dzílí bíláshgaan	Reigersbek
Díkʼǫ́ǫ́zhí (chʼil)	Melde
Tʼąąʼdoolghasí	Zilverschoon
Teełikaní	Schorrenzoutgras
Láʼashdlaʼ	Vijfbladige wingerd
Tséghániłchʼi	Postelein
Zééʼiilwoʼii	Vossenstaart
Chéchʼil ntłʼizí yiltʼąąʼí	Mahonie (plant)
Tólchiintsoh	Moerasandoorn
Tséyaa hataałí	Koolraap
Tłʼohtsʼózí	Rus (geslacht)
Tłʼoh dichʼíízh	Zegge
Shashdą́ą́ʼ	Berberis
Tłʼoh waaʼítsoh	Witte honingklaver
Díkʼǫ́ǫ́zhí yiltʼąąʼí	Melganzenvoet
Bįįh yildeeʼí	Lampionplant
Kʼaalógii bitʼaʼ ndikʼąʼ nahalinígíí	Lycaenidae
Hosh niteelí	Opuntia
Chʼał nineezí	Amerikaanse brulkikker
Tééh hóyáanii bíchį́į́htsahí	Narwal
Mágí bíchį́į́htsohígíí	Bavianen
Bįįh łikizhígíí (Béésh Bichʼahníí Bikéyahdę́ę́ʼígíí)	Damhert
Tábąąh ayání	Kafferbuffel
Nátʼostsoh	Koningskaars
Teeł náyizí	Noordse rus
Tólchiin (chʼil)	Akkermunt
Dibé diníí dinéʼiʼ	Spanjaarden
Binaʼadaałtzózí	Japanners
Chʼil awoshí	Stekend loogkruid
Chʼil naamaasii	Witte amarant
Ahaditʼáán	Goudzuring
Yéʼiibeʼetsʼos	Zwenkdravik
Naazkaadí	Nerfamarant
Ostseʼ yiltʼąąʼí	Sofiekruid
Ostseʼ	Hongaarse raket
Azeediilchʼílii	Blauwe lupine
Bikétłʼóól názbąs	Beklierde basterdwederik
Łóóʼ bíchį́į́h nineezí	Zwaardvis
Łį́į́ʼ Ndahalinígíí	Paardachtigen
Binááʼ Ádaałtsʼózí bichʼil łigaií	Chinese kool
Azeedíchʼííʼ	Chilipeper
Kolíya Tááʼ Bikéyahą́ą	Drie koninkrijken van Korea
Łeehdoolʼeez łichííʼí	Rode biet
Hashkʼaantsoh yiltʼeesígíí	Bakbanaan
Iiʼnótʼį́į́	Infectie
Chʼah Diʼilii Bikéyahdę́ę́ʼ mósí ałchinígíí	Manoel
Tááʼyaʼniiltʼóshiiłbáhígíí	Grijze kardinaal
Jááłánii (bikágí ntłʼizígíí)	Miljoenpoten
Iichʼąhii ntsxaaígíí	Atlasvlinder
Łóóʼ ńdídzihígíí	Longvissen
Chʼíshiibeezhii	Mezen (vogels)
Giní jáádnézí	Secretarisvogel
Hakʼaz néʼéshjaaʼ	Sneeuwuil
Shádiʼááhdę́ę́ʼ jeeshóóʼ	Andescondor
Chidí naatʼaʼítsoh beeʼeldǫǫh bikǫʼ neiyéhé	Bommenwerper
Shash bighą́ąʼgi hadzíbáhí	Grizzlybeer
Kǫʼ naʼałbąąsii	Stoomlocomotief
Ndíyíliitsoh	Zonnebloem
Naaʼahóóhaiłkizhígíí	Parelhoenders
Tłʼiish yighání	Honingdas
Dadilhóni aheltłʼidígíí	Handgranaat
Naakaii Łizhiní Bikéyahdę́ę́ʼ łééchąąʼí ałchiní	Afrikaanse wilde hond
Aniłtʼánii (tʼááłaʼajínígoʼígíí)	Haften
Ayánítsoh bighą́ą́ʼaskʼidígíí	Gaur (rund)
Niinahnízaad	Nenahnezad
Máaz yikááʼ nandahí Spirit	Spirit (MER)
Hakʼaz giníłgaii	Giervalk
Tsétah jeeshóóʼ łibáhí	Vale gier
Tééh łééchąąʼí łikizhígíí	Gevlekte hyena
Tłʼízí ałchiní	Bezoargeit
Yaaʼ dóó chʼosh bíchį́į́h dadichʼízhí	Haakwormen
Beeʼeldǫǫh	Musket
Chʼosh bitsʼaʼígíí bigaan dahólónígíí	Armpotigen
Tʼąąʼdoolghasí (daadánígíí)	Andijvie
Dlǫ́ʼii (bílaʼashdlaʼii bilį́į́ʼ)	Fret (dier)
Łóóʼtsoh łibáhígíí	Grijze walvis
Chʼah Diʼilii Bikéyahdę́ę́ʼ atsátsoh	Steppearend
Yiisnááh	Krijgsgevangene
Dzeeh	Wapiti
Tsinlátahgi tsídii nahatʼeʼígíí	Muisvogels
Nátʼoh (chʼil)	Gewone tabaksplant
Tsé Nitsaa Deezʼáhí	Rock Point
Tsin naaʼeeł bee daʼahijighánígíí	Slagschip
Tsísʼná yiyání	Bijeneters
Bisóodi bizęęs dį́įʼii	Knobbelzwijn
Dlǫ́ʼiitsoh naalzheehígíí	Fretkat
Nahachagii biyázhí	Bladluizen
Naalkʼįhiitsoh	Huidvliegers
Łóóʼ naatʼaʼí	Vliegende vissen
Hakʼaz ayání	Muskusos
Tsétah gah	Fluithazen
Mąʼiitsoh bikʼos bineʼdę́ę́ʼ łizhinígíí	Manenwolf
Iichʼąhiitsʼósí	Schietmotten
Kéyah Dańlínídę́ę́ʼ atsátsoh	Apenarend
Tábąąstííntsoh bíchį́į́htsohígíí	Zeeolifanten
Łóóʼntsxaaí díníchʼahii	Reuzenhaai
Chʼosh yighání	Aardwolf
Mágí bitseeʼ noodǫ́zígíí	Ringstaartmaki
Táyiʼ chʼoshnézí	Snoerwormen
Dlǫ́tsʼósí łibáhígíí	Smalstreepmangoest
Tó naagoʼ	Druppel
Dlǫ́ʼiitsoh Danilínígíí	Civetkatachtigen
Mágí bigaanézí	Gibbons (mensaap)
Bílaneezii	Vingerdier
Séí mąʼii	Steppevos
Naalʼeełítsoh bitéél halchíʼí	Roodhalsgans
Tłʼízí bideeʼ yisdizígíí	Schroefhoorngeit
Jádí	Gaffelbok
Wónikǫsí	Phasmatodea
Tééh łééchąąʼí noodǫ́zígíí	Gestreepte hyena
Tsídiiłchxoní	Hoatzin (soort)
Táłtłʼááh chʼoshtʼą́hí bikááʼtsʼinígíí	Keverslakken
Mąʼii bighą́ąʼgi hadzíjiní	Zadeljakhals
Naakaii Łizhiní Bikéyahdę́ę́ʼ mąʼiiłchííʼ	Ethiopische wolf
Tsétah dibé	Dikhoornschaap
Dibé dóó Tłʼízí Ndahalinígíí	Bokken
Mágí bíchį́į́h dootłʼizhígíí	Mandril
Tó wónaanídę́ę́ʼ dibé ałchiní	Moeflon
Tsiighájíłchí	Cuscuta
Bįįhyázhí biwooʼnézí	Siberisch muskushert
Dzeeh łikizhígíí	Sikahert
Tábąąh mósí ałchiní	Vissende kat
Chį́į́h yee achʼiishíhii	Zaagvissen
Shádiʼááhdę́ę́ʼ hodíłchʼil mąʼii	Boshond
Hakʼaz mágí	Japanse makaak
Tsé Biiʼ Ndzisgaii	Monument Valley
Mágí bíchį́į́h niilyoolígíí	Neusaap
Shádiʼááhdę́ę́ʼ tsídiitsoh	Nandoe
Dáádílí łibáhígí	Bruine tandbaars
Náátsʼózídę́ę́ʼ mósíłtsxooí ałchinígíí	Aziatische goudkat
Łóóʼnteeltsoh	Maanvis (Mola)
Gaanłáníchilí dóó Gaanłání doo yitʼíinii	Zoetwaterpoliepen
Atłʼóóh	Weven
Chʼoshkʼaaʼ	Pijlwormen
Tábąąh bįįh	Chinese waterree
Hodíłchʼil jeeshóóʼ	Koningsgier
Dlǫ́ǫ́ʼ bitseetłʼooígíí	Chinchilla's
Achʼąąʼ adáʼatsʼiʼ	Inenting
Néʼéshjaaʼ bíńdáhii	Sperweruil
Bitseeʼ yee adiłhałii	Amerikaanse alligator
Jádítsoh noodǫ́zígíí	Bongo (antilope)
Níyolgi naatʼaʼígíí (tónteel tsídii)	Stormvogeltjes
Tádídíín yiyání	Bladhaantjes
Tsídiidaashiyishí	Ibissen
Yílnoodii (łóóʼ)	Sphyraena
Shádiʼááhdę́ę́ʼ łéʼétsoh bitseeʼ ádinígíí	Agoeti's
Chʼosh bitsʼaʼłáaʼii	Monoplacophora
Naʼashǫ́ʼii łóóʼ hashkéhé	Franjehaai
Jeeshóóʼ	Californische condor
Táłkááʼ chʼó	Kleine watereppe
Chʼosh dilwoʼígíí	Zandloopkevers (onderfamilie)
Chʼosh doo yitʼíinii bee nílʼíní	Microscoop
Tsin ditʼinii	Spermophilus
Joogii	Blauwe gaai
Łeeyiʼ nahakʼízii	Veenmollen
Náátsʼózídę́ę́ʼ naalʼeełí	Mandarijneend
Mąʼii bijaaʼabanígíí	Grootoorvos
Tsídiitsoh bikʼos dootłʼizhí	Casuarius
Atsiniltłʼish ííłʼíinii (naʼashǫ́ʼii łóóʼ)	Sidderaal
Dįʼ	Ruigpoothoenders
Niicháadii (łóóʼ)	Kogelvissen
Tééhoołtsódiichilí	Dwergnijlpaard
Kʼiiznoodǫ́ǫzii (tsin yigházhígíí)	Paca's
Wóláchííʼ yildeełítsoh	Reuzenmiereneter
Dibéʼniiʼí	Says phoebe
Bináʼadaałtsózí bitsin naaʼeeł	Jonk
Níłtsą́goʼ (bideeneezígíí)	Boktorren
Tséʼédǫ́ʼii bitsiinézí	Schorpioenvliegen (orde)
Tłʼohtahgi díłdánii yił aheełtʼéhii	Vechtkwartels
Łóóʼyiniʼįįhí (tónteel tsídii)	Jagers
Shádiʼááhdę́ę́ʼ tó hóyáanii	Orinocodolfijn
Naʼashǫ́ʼiitsoh	Iguana
Binaʼadaałtsózí dinéʼi	Oosten
Łóóʼ adishishí	Pijlstaartroggen
Tsin yąąh dzootʼihí	Boomklevers
Atʼaʼ yiltʼąąʼí dah sidáhígíí (chʼosh ntsxaaígíí)	Kokoskrab
Yółeehii	Vinarmigen
Tiníléí	Gilamonster
Dijádídlǫ́ʼí	Strandleeuwerik
Tłʼoh	Gazon (grasveld)
Dinas	Berendruif
Mąʼii bikʼiizgi hadzíjiní	Gestreepte jakhals
Yadiizį́įgo ayání	Gerenoek
Télii bijáád noodǫ́zí	Wilde ezel
Bitsʼáá bidaʼhodiʼniil	Tactiek van de verschroeide aarde
Mágíłchííʼ	Gouden leeuwaapje
Dááʼadeeʼii	Platalea
Łóóʼ hashkéhé bitsiiʼ dikʼání	Hamerhaaien
Taahilnoodii	Genten (vogels)
Kʼíneedlíshii adiłhashígíí	Vliegende herten
Łééh yidi tóʼígíí	Aquifer
Naʼashǫ́ʼiitsoh naʼałkǫ́ʼígíí	Zeeleguaan
Tsídiisháshii	Bombycilla
Yaaʼ bitsʼaʼígíí	Schildluizen
Daateel	Schuitbekreiger
Tééh łééchąąʼí ditsʼozígíí	Bruine hyena
Tsétaʼ łį́į́ʼ	Mustang (paard)
Kénézí	Jacana's
Neeshchʼííʼ	Pijnboompit
Naalʼeełítsoh yił aheełtʼéhii łizhin dóó łigaiígíí	Ekstergans
Mąʼii chʼil	Guldenroede
Yaadaaʼnézí (tónteel tsídii)	Rynchops
Tsídii disxǫsígíí	Glansvogels
Náátsʼózídę́ę́ʼ mósíłchíiʼii ałchinígíí	Borneogoudkat
Shádiʼááhdę́ę́ʼ tsétah mósí ałchinígíí	Bergkat
Tsinlátahgi dlǫ́ʼiitsoh	Beermarter
Jeeshóóʼ łizhinígíí	Zwarte gier
Naałʼashí	Vogelspinnen
Dééłdą́ą́ʼ	Adelaarsvaren
Hashkʼaan yildeełígíí (tsídii)	Toerako's
Łį́į́chilí	Shetlandpony
Daakʼį́į́ʼ	Numenius
Mąʼiiłtsooí łibáhígíí	Grijze vos
Naʼashǫ́ʼiitsoh dootłʼizhígíí	Groene leguaan
Chidí bikéíjį́ʼ adeizʼááhígíí	Pick-up (autotype)
Bįįh bitseełgaiígíí	Witstaarthert
Wónitłʼizí	Landpissebedden
Díʼdikii (jádí)	Dikdiks
Hakʼaz mąʼiitsoh	Poolwolf
Ndikʼąʼ biyaʼ	Katoensnuitkever
Tłʼoh naadą́ą́ʼ biyaʼ	Graanklander
Łeeyiʼ jááłániichilí	Pauropoda
Aniłtʼánii (bikʼosnézí)	Kameelhalsvliegen
Dlóóʼ binaalniih	Builenpest
Ááhooshtʼįįh	Capitulatie
Tséʼédǫ́ʼii dishooí	Zweefvliegen (dieren)
Tsáʼásziʼ dóó Noodah	Agavaceae
Tééh tsisteeł	Chelonioidea
Bichʼah Dootłʼizhii	Vredesoperatie
Dlǫ́ʼii łizhin dóó łitsooígíí	Maleise bonte marter
Chʼosh ałchozhii (chéłchaaʼ)	Spekkevers
Łeʼesoołii (bitseeʼ naakiígíí)	Dipluren
Dlǫ́ʼátsoh	Bosmarmot
Chʼééh digháhii dóó Tsisteeł	Schildpadden
Tááʼyaʼniiltʼóshii	Kardinaalachtigen
Łóóʼ bigaanłánígo bitsʼaʼígíí	Nautilidae
Łeʼesoołii (bitseeʼ tááʼígíí)	Franjestaarten
Tłʼézhii	Dazen
Tániilʼáítsʼóóz	Juffers
Aniłtʼániitsʼóóz	Mierenleeuwen
Tó wónaanídę́ę́ʼ hazéí bíchį́į́hnézí	Toepaja's
Hakʼaz gah	Poolhaas
Bįįh łikizhígíí (Naakaii Dootłʼizhii Bikéyahdę́ę́ʼígíí)	Axishert
Nahashchʼidí (naaldeehii)	Zilverdas
Bisóodi bideeʼ názhahígíí	Babiroessa's
Tsídii bichʼahtsooígíí	Dubbelhoornige neushoornvogel
Shádiʼááhdę́ę́ʼ bisóodi diʼilígíí	Pekari's
Náʼagéédí bizaʼazis hólóní	Buidelmollen
Bilagáana	Blanken
Tłʼézhiiłbáhí	Sluipvliegen
Jádítsoh diłhiłígíí	Nyala (antilope)
Jádítsoh bideeʼ shiyishígíí	Sabelantilope
Dlǫ́ʼiitsoh łikizhígíí	Afrikaanse civetkat
Tsinaʼayąʼii yildeełí	Numbat
Tsétah tłʼízí	Sneeuwgeit
Jááłániichilí bighádzígaiígíí	Symphyla
Gahchilí	Dwergkonijn
Tsiishgaii	Dwergboomklever
Dééłgai bitsiiʼ halzhinígíí	Zwarthalszwaan
Chʼosh nahachagii	Dwergcicaden
Hóółtseiigi naʼastsʼǫǫsí	Woestijnratten
Gaanłání	Ceriantharia
Tádídíín yiyání łichíʼígíí	Leliehaantje
Laanaa Yáʼátʼéehgo Késhmish	We wish you a merry Christmas
Naʼazǫ́ǫzii	Mierwespen
Jáád neishoodí (naʼashjéʼii haalzheehígíí)	Spinnendoders
Naalʼeełí bidaatsʼózí	Mergus
Naalʼeełí łizhinígíí	Melanitta
Nahatʼeʼiitsoh Bikéyahdę́ę́ʼ naalʼeełítsoh łibáhígíí	Hoendergans
Dahsánítsoh	Gewoon stekelvarken
Naʼastsʼǫǫsí bitseeʼ dichʼízhí	Stekelmuizen
Tsétah nahatʼeʼiitsoh	Rotskangoeroes
Táłkááʼ dilwoʼí	Schaatsenrijders
Akáshtʼóózh biyaʼ	Stofluizen
Łeʼesoołii (bideeʼ ádinígíí)	Proturen
Ąąʼąʼii	Pica (geslacht)
Jádí bideeʼ dį́įʼii	Vierhoornantilope
Táłtłʼááh chʼosh ntsxaaígíí	Japanse reuzenkrab
Mósí ałchiní bitsiiʼtʼąhígíí	Platkopkat
Naakaii Łizhiní Bikéyahdę́ę́ʼ naalʼeełítsoh dibéłchíʼígíí	Nijlgans
Hosh aditsahiitsoh	Saguaro (cactus)
Tʼáá łichíʼígo náʼagéédí	Naakte molrat
Tsisteeł łizhinígíí	Kolenbranderschildpad
Tééh jeeshóóʼ	Witruggier
Iichʼąhii noodǫ́zí	Hyles lineata
Atʼąąʼ nahalinii	Phylliidae
Ghą́ą́ʼnoodǫ́ǫzii (tsin yigházhígíí)	Pacarana
Łéʼétsoh beeniʼíhoniitaahígíí	Cavia's
Naʼashǫ́ʼii dichʼízhii	Padhagedissen
Chéłchaaʼ bikʼosnézí	Trachelophorus giraffa
Ásaaʼ neiyéhii	Oliekevers
Naʼashǫ́ʼiitsoh łitsooígíí	Galapagoslandleguaan
Shádiʼááhdę́ę́ʼ tiníléí	Mexicaanse korsthagedis
Sahdii Bisí (Tsé Nástánii)	Petrified Forest National Park
Tsé Bighánílíní	Antelope Canyon
Naakaii Dootłʼizhii bimósí ałchinígíí	Roestkat
Naʼashǫ́ʼiiłchííʼ dootłʼizhígíí	Agama mwanzae
Kʼaabizhii	Mammillaria
Dahiitį́hídą́ą́ʼtsoh	Castilleja
Dlǫ́ʼbéʼézhóóʼ	Aristida
Dáʼághálii	Crotalaria
Chʼał bikʼos ádinígíí	Nasikabatrachus
Jéí náyoogisii	Echinocereus
Tłʼohtah náshdóí	Pampakat
Tsídii naʼałkǫ́ʼígíí	Papegaaiduikers
Tsisteeł diyogí	Matamata (schildpad)
Łóóʼ adishishí ntsxaaígíí	Reuzenmanta
Tónteel bibąąh hóyáanii	Indische bruinvis
Naakaii Łizhiní Bikéyahdę́ę́ʼ tsétah dibé	Manenschaap
Náhookǫsdę́ę́ʼ dlǫ́ʼii	Amerikaanse marter
Naalʼeełí naashchʼąąʼígíí	Carolina-eend
Tsinlátah nahatʼeʼiitsoh	Boomkangoeroes
Tsin naaʼeeł łóó beeʼháʼhaalʼééłiʼ	Trawler
Chʼosh biyaʼ	Waaiervleugeligen
Táłtłʼááh chʼosh	Waterroofkevers
Shádiʼááhdę́ę́ʼ tábąąstííntsoh	Manenrob
Táłtłʼááh álééh	Amerikaanse blauwe reiger
Tsísʼnáłtsooítsoh	Hoornaars
Táłtłʼááh naakaii náásééł yił aheełtʼéhii	Bidsprinkhaankreeften
Náátsʼózídę́ę́ʼ tsiiłtsooí	Goudfazant
Bisóodi Danilínígíí	Varkenachtigen
Gólízhii noodǫ́zígíí	Gestreepte skunk
Tsinlátah naʼashǫ́ʼiitsoh	Antilliaanse groene leguaan
Tó bichʼosh (séigoʼ nahalinígíí)	Waterschorpioen
Naʼastsʼǫǫsí bijaaʼntsxaaígíí	Grote langoorbuideldas
Tsʼání	Pinyongaai
Chʼééh digháhii bitsʼaʼ yilzhólí	Weekschildpadden
Chį́į́shghą́ʼiiłgaii	Witborstboomklever
Hastiin Diego de Landa	Diego de Landa
Tábąąstííntsoh (Akééháshį́į́dę́ę́ʼígíí)	Californische zeeleeuw
Mósí bizaʼazis hólóní	Buidelmarters
Tségad	Selaginella
Naaʼołí	Boon
Tsįyaalzhahí	Amerikaanse sperwer
Hashtłʼishdi chʼééh digháhii	Modder- en muskusschildpadden
Yaaʼ nahachagiígíí	Vlooien
Kéʼ łizhiní	Blackfoot (volk)
Tábąąsdísí áłtsʼíísí	Amerikaanse oeverloper
Náátsʼózídę́ę́ʼ toohjįʼ ndiigaii	Chinese zilverreiger
Łóóʼtsoh (Ałtsʼáʼáztiin)	Walvis
Dlǫ́ʼii łizhiní	Zwartvoetbunzing
Wóláchííʼ yildeełí łizhin dóó łigaígíí	Boommiereneters
Lókʼaatah bisóodi	Boszwijn
Hodíłchʼil tłʼízí	Sumatraanse bosgems
Hakʼaz Dineʼé Bikéyahdę́ę́ʼ tábąąstííntsoh	Stellerzeeleeuw
Dziłtah dlǫ́ʼii	Bergwezel
Naayééʼ tsídiitsoh	Moa
Atseełtsoii	Roodstaartbuizerd
Tóniłhę́ęshii (dééł)	Trompetkraanvogel
Naaltsoos Mormon Wolyéhígíí	Boek van Mormon
Téél halchíʼí	Roodborstlijster
Dlǫ́ʼátah néʼéshjaaʼ	Holenuil
Naʼashǫ́ʼii bijáád ádinígíí	Wormhagedissen
Naʼatłʼoʼii (chʼosh)	Webspinners
Dííłdzid yiyání	Kortschildkevers
Yáhashjool yázhí	Amerikaanse woudaap
Tłʼéeʼgo mágí	Nachtaapjes
Náʼagéédíchilí	Amerikaanse spitsmuismol
Tsʼíʼii jáádnézí	Langpootmuggen
Chʼil ditsʼozíłchííʼ	Ramboetan
Mágíłtsooí bináázhiní	Grijsgroen doodshoofdaapje
Tsídiiłtsooí bitʼaʼ łizhinígíí	Goudsijs
Tsʼíʼii noodǫ́zí	Tijgermug
Bitseeʼ yee adiłhałii yázhí	Kaaimannen
Anaasází	Pueblo (volk)
Chʼééh digháhiitsoh	Galapagosreuzenschildpad
Tsineeshbízhii	Amerikaanse boomkruiper
Yeenaʼałkǫ́ʼíłániichilí	Remipedia
Naʼnízhoozhí Bił Hahoodzo	McKinley County
Mąʼii Deeshgiizh Bił Hahoodzo	Sandoval County
Naatoohí Bił Hahoodzo	Cibola County
Tábąąstííntsoh łikizhígíí	Larghazeehond
Ooljééʼ yiikááʼ nandahí	Maanlanding
Toohjįʼ noołnahii yázhí	Groene reiger
Báshdo	Barstow (Californië)
Łóóʼ hashkéhé bíchį́į́hnézí	Koboldhaai
Tłʼiishtsiiʼí (łóóʼ)	Slangekopvissen
Chéłchaaʼ bideeneezígíí	Herculeskever
Déłí	Canadese kraanvogel
Ąąʼąʼiiłbáhí	Aziatische blauwe ekster
Tsétah chaaʼ	Stompstaarteekhoorn
Sighóla	Socorro (New Mexico)
Chéłchaaʼ disxǫsígíí	Prachtkevers
Naalʼeełí dootłʼizhí	Blauwvleugeltaling
Béíyózhin	Paiute
Tsin naabąąs	Huifkar
Tó Hasłeeh	Mancos
Dlǫ́tsʼósí łichííʼígíí	Ringstaartmangoest
Jádídlǫ́ʼii	Noordelijke huiswinterkoning
Yaayááhalzhiin	Zwartkeelgors
Tłʼohchintó	Hotevilla-Bacavi
Tséʼédǫ́ʼii	Echte vliegen
Chʼagiitsoh	Geelkoptroepiaal
Dahsání dah Yikahjí Tsin Deigházhígíí	Hystricomorpha
Níyolgi naʼałkǫ́ʼígíí (tónteel tsídii)	Alkstormvogeltjes
Tsinaʼayąʼii biyázhí	Zoraptera
Tseekʼi nástánii	Antilopegrondeekhoorns
Tłʼízíʼilí	Angorageit
Naatooh Sikʼaiʼí	Grants
Tsooʼtsʼiní (łóóʼ)	Arowana's
Tsinaʼayąʼii	Termieten
Náʼagéédí bíchį́į́h sǫʼ nahalinígíí	Stermol
Naaléełchííʼ	Araparkiet
Naaʼahóóhai disxǫsígíí	Lophophorus
Tsįyaatsiiłchííʼ	Rode tiran
Náhookǫsdę́ę́ʼ tsétah dibé	Dalls schaap
Níłtsą́goʼ łichííʼígíí (chʼil abeʼé bichʼosh)	Tetraopes tetrophthalmus
Naʼnízhoozhí	Gallup (New Mexico)
Łóóʼ binááʼtsohí	Grootoogbaarzen
Tsisteeł bikʼosneezígíí	Slangenhalsschildpadden
Kilim	Kelim
Táłtłʼááh wónitłʼizí	Waterezeltje
Chąąneiłhizii	Spiegelkevers
Tʼáyaałtso	Californische grondspecht
Nákʼeʼnáʼijiní	Canadese boomklever
Wáláchíʼétah nahachagiichilí	Mierenkrekels
Yáhashjool yił aheełtʼéhii	Zonneral
Tsintah bisóoditsoh	Reuzenboszwijn
Zééjíjinii	Kuifhoenderkoet
Naʼashǫ́ʼii hááʼáchʼiidí	Luipaardleguanen
Naʼníʼá Hayázhí	Cameron (Arizona)
Naalkʼįhíchilí (bizaʼazis hólónígíí)	Vliegende buidelmuis
Dlǫ́ʼii yił aheełtʼéhii łibáhígíí	Indische ichneumon
Adijiłii yił aheełtʼéhí	Kleine egeltenrek
Łóóʼ hashkéhé bitseeneezígíí	Voshaai
Chį́į́shłigaií dóó Naalʼeełítsoh	Anserinae
Jádí biniiʼtsʼózí	Hartenbeest
Tábąąh jádí	Waterbok
Jádí binááʼ dį́įʼii	Hirola
Tó wónaanídę́ę́ʼ dlǫ́ʼáyázhí	Siesel
Ásáí Dineʼé Bikéyahdę́ę́ʼ mąʼiitsoh	Arabische wolf
Dlǫ́iitsoh bíchį́į́hdzísgaiígíí	Witsnorpalmroller
Aniłtʼánii yázhí	Bladvlooien
Chʼał mágí nahalinii	Phyllomedusa sauvagii
Sǫʼ tsisteeł	Stralenschildpad
Nahatʼeʼiitsoh Bikéyahdę́ę́ʼ tązhii	Boskalkoen
Mąʼii dootłʼizhí	Noord-Amerikaanse katfret
Táłkááʼ dilwoʼítsʼóóz	Hydrometridae
Łeʼesoołii (nahachaʼígíí)	Microcoryphia
Tóidoozohii bidaaʼ łigaiígíí	Koeten
Kʼaalógiitsoh disxǫsígíí	Morpho
Mąʼii Deeshgiizh	Jemez Springs
Tsisteeł hashkéhé	Bijtschildpadden
Tsilhazésii	Grijskeeltiran
Naʼastsʼǫǫsí bizaʼazis hólóní	Breedvoetbuidelmuizen
Wáláchííʼ	Gewone steekmier
Tsídiidą́ą́ʼ	Vlambloem
Wóniłchxoní	Schildwantsen
Tsiikʼánii (tsídii)	Hamerkop
Nahatʼeʼii niłchxoní	Muskuskangoeroerat
Náátsʼózídę́ę́ʼ tsiidootłʼizhii	Argusfazant
Ábishjaaʼ (daadánígíí)	Lijst van eetbare paddenstoelen
Tábąąh bisóodiłchíiʼii	Penseelzwijn
Kéyah Dańlínídę́ę́ʼ naalʼeełí	Filipijnse eend
Tiníléítsoh naʼałkǫ́ʼígíí	Watervaraan
Kézhoozhʼilí (tsin yigházhígíí)	Goendi's
Jádí bideeneezígíí	Oryxen
Dáádílí łikizhígíí	Panterbaars
Tsísʼná náʼagéédígíí	Anthophorini
Mágíłbáhí	Diadeemmeerkat
Jaaʼditłʼoʼí naalkʼįhígíí (bizaʼazis hólónígíí)	Reuzenkoeskoes
Nahatʼeʼiitsoh yázhí	Pademelons
Séí tiníléítsoh	Goulds varaan
Dlǫ́ʼii yił aheełtʼéhítsʼózí	Slanke mangoeste
Tółání	Laguna (New Mexico)
Łóóʼ bigháhootʼíní	Aziatische glasbaarzen
Tʼiis	Italiaanse populier
Tónhidigaii	Silverton (Colorado)
Chʼosh áłtʼą́ą́ʼígíí	Grondwantsen
Dééłtsoh	Koritrap
Shádiʼááhdę́ę́ʼ dahsání	Grijpstaartstekelvarken
Dlǫ́ʼii bitseenézí	Langstaartwezel
Tsénáhádzoh	Twin Lakes (New Mexico)
Kéyahígíí nidineesdzaʼ	Dust Bowl
Nahachagii dootłʼizhí	Sabelsprinkhanen
Tsé Bíyah Aniiʼáhí	Chaco-cultuur
Nahatʼeʼiitsoh Bikéyahdę́ę́ʼ biyázhí neiyéhé	Voskoesoe
Naaʼahóóhaiłbáhí	Perdix
Tsísʼnádą́ą́ʼ	Gaillardia
Jeeshóóʼ ałchozhígíí	Palmgier
Łóóʼ adiłdoní	Toxotes
Dlǫ́ʼii yił aheełtʼéhii łitsxooígíí	Vosmangoest
Naakaii Łizhiní Bikéyahdę́ę́ʼ nahatʼeʼii	Springhaas
Táłtłʼááh chʼosh chʼééh digháhii bitsʼaʼ ádinígíí	Nudibranchia
Tiníléítsoh noodǫ́zígíí	Nijlvaraan
Naʼashǫ́ʼii bideewozhii	Doornstaartagamen
Chʼał ntsxaaígíí	Goliathkikker
Tééh naaʼahóóhaitʼą́ʼí	Frankolijnen
Yáhashjool	Noord-Amerikaanse roerdomp
Dlǫ́ʼii yił aheełtʼéhii yázhí	Dwergmangoest
Halchíítah (Áshįįh Biiʼtó Hahoodzo)	Halchita
Nahatʼeʼiitsoh Bikéyahdę́ę́ʼ tábąąstííntsoh	Australische zeeleeuw
Mąʼiiłtsooí yázhí	Grootoorkitvos
Naʼazísí Toʼí	Cuba (New Mexico)
Tsékááʼgóó naagháhii (chʼosh)	Mantophasmatodea
Tłʼohtahilzhahí	Seriema's
Táłtłʼááh tsxilghááhtsoh	Reuzensalamanders
Dibé dághaaʼígíí	Japanse bosgems
Chʼééh digháhii bitsiiʼntsxaaígíí	Grootkopschildpad
Tsékʼi naʼałkǫ́ʼii	Pyrenese desman
Naʼastsʼǫǫsítsoh (chʼosh yildeełígíí)	Agouta
Tsídiiłtsooí	Mangrovezanger
Chʼagii	Epauletspreeuw
Łéʼétsoh diwozhí	Grote haaregel
Łéʼétsoh bizaʼazis hólóní	Kamstaartbuidelrat
Dlǫ́ʼiitsoh noodǫ́zígíí	Gewone bandcivetkat
Tábąąstííntsoh łizhin dóó łigaiígíí	Bandrob
Jeeshóóʼ bitsiiłgaiígíí	Witkopgier
Tábąądijádí	Killdeerplevier
Naʼazísí	Goffers
Łeeyiʼ chʼał dichʼízhí	Mexicaanse gravende pad
Táłtłʼááh naatʼáʼii	Vliegende knorhanen
Naakaii Dootłʼizhí Dabikéyah	Zuid-Azië
Sháńdíín bitsʼą́ą́dę́ę́ʼ atsiniltłʼish álʼį́	Zonnepaneel
Tsé noolchʼóshii	Kloofwinterkoning
Naaʼahóóhai bikeetsohígíí	Megapodius
Naʼashǫ́ʼii kááʼtsʼinígíí	Pantsergordelstaarthagedis
Diltʼóshii	Baeolophus
Kinteel (Yootó Hahoodzo)	Aztec (New Mexico)
Néʼétsah azeeʼ	Canadese fijnstraal
Atsá diłhiłígíí	Indische zwarte arend
Ąąʼąʼii dootłʼizhígíí	Groene kitta
Bisóodi dághaaʼígíí	Baardzwijn
Iichʼąhii biyázhí	Witte vliegen
Dólii	Bergsialia
Kin Noodǫ́ǫ́z	Bernalillo
Tsiikʼánii (łóóʼ ooshgę́ęzhii)	Vioolroggen
Biniiʼdootłʼizh	Glaucidium
Mágí biniiłgaígíí	Witgezichtsaki
Wónaʼałtéhii	Roofvliegen
Tłʼoh azihii	Ephedra
Kʼaalógii bitʼaʼ disxǫsgo łikizhígíí	Prachtvlinders
Tiníléítsoh bikʼosnézí	Woestijnvaraan
Łéʼétsoh bitseetłʼooígíí	Rotsrat
Tsídii bizééʼ naashchʼąąʼí	Tragopan
Tábąąsdísíłbáí	Limnodromus
Dilzhę́ʼii	Stellers gaai
Mágí naashchʼąąʼígíí	Roodscheendoek
Chʼosh naʼałkǫ́ʼí	Waterkevers
Tééh jádítsoh	Taurotragus
Łeeyiʼ bitiiní	Woelmuizen
Atsáłbáí	Prairievalk
Dáádílítsoh	Donkere reuzentandbaars
Tsétah bįįhchilí	Poedoe
Tsʼánídílzhiʼí	Westelijke struikgaai
Iichʼąh	Convulsie
Kiisʼáanii	Pueblo (cultuur)
Jeeshóóʼ bitsiiłtsooí	Kleine geelkopgier
Dlǫ́ʼii noodǫ́zígíí	Witnekwezel
Tiníléítsoh dootłʼizhígíí	Smaragdvaraan
Yáázhłání (naaldlooshii)	Gewone tenrek
Łéʼétsoh yił aheełtʼéhii	Schijnratten
Tábąąh łéʼétsoh	Australische beverrat
Ghą́ą́ʼdiʼilii (tsin yigházhígíí)	Manenrat
Lókʼaaʼ yigházhígíí	Rietratten
Tsídii bitʼaʼ dah adadootłʼizhígíí	Polyplectron
Dilchʼóshii	Junco
Chį́į́hʼadeeʼii (łóóʼ)	Lepelsteuren
Kéyah Dańlínídę́ę́ʼ bisóodi bizęęs hastání	Visayawrattenzwijn
Chąąneiłmaasii	Mestkevers
Dzílí	Coopers sperwer
Tó bichʼosh (tsiiyaago naʼałkǫ́ʼígíí)	Bootsmannetjes
Tónteel táshchozhii	Sterns
Naʼastsʼǫǫsí noodǫ́zígíí	Lemniscomys
Tówoł	Taos (New Mexico)
Díchʼíító	Bitter Springs
Kʼish biyaʼ dootłʼizhígíí	Elzenhaantje
Dóliiłchííʼ	Blauwkeelsialia
Łóóʼ binááʼ ádiní	Blinde baarszalmen
Naabiʼání	Bloomfield (New Mexico)
Tséłgaii Deezʼáhí	Bluff (Utah)
Aniłtʼánii (nahakʼízígíí)	Oecanthinae
Aniłtʼánii łizhinígíí	Elzenvliegen
Mágí bichį́į́łgaígíí	Roodstaartmeerkat
Naakaii Bikéyahdę́ę́ʼ bįįh yázhí	Spiesherten
Naʼashǫ́ʼii dootłʼizhí (naaldeehii)	Halsbandleguaan
Naʼashǫ́ʼiiłbáhí	Woestijnleguaan
Dlǫ́tsʼósí noodǫ́zígíí	Grandidiermangoest
Łéʼétsoh gahjaaʼígíí	Madagaskarreuzenrat
Chʼoshtsoh bíláshgaanʼilí	Kiwa hirsuta
Anáʼálwoʼ:Bee hadítʼéhígíí	Portaal:Hulp en beheer
Deinihootso	Dennehotso
Táłtłʼááh chʼoshtsoh bideeneezí	Langoest
Táshchozhiizhiin	Zwarte phoebe
Moháábii dinéʼiʼ	Mojave (volk)
Hodíílid	Dolores (Colorado)
Néʼéshjaaʼkálii	Cactusuil
Chaaʼ Bitoʼ	McNary (Arizona)
Tsídii bitʼaʼ hózhóón	Paradisaea
Tiníléítsoh łikizhígíí	Reuzenvaraan
Tiníléítsoh bíchį́į́h dikʼání	Witkeelvaraan
Tsé noolchʼóshiiłbáhí	Amerikaanse rotswinterkoning
Chʼiyíítʼogii	Tyrannus
Dloziłgaii	Tamiasciurus
Tsísʼná dootłʼizhí	Goudwespen
Halchíítah	Painted Desert
Wóósitsʼílí	Bedwants
Tsé Nikání	Round Rock (Arizona)
Tsʼahgi naalnoodí	Sceloporus graciosus
Biizhii	Amerikaanse nachtzwaluw
Tsidiłdǫǫhii	Megascops
Dághaaʼ Łichííʼ	Kirtland (New Mexico)
Kǫʼ naʼałbąąsii hééł bee nágéhéʼ	Goederentrein
Dlǫ́ʼiitsoh bizééʼ noodǫ́zí	Maleise civetkat
Jaaʼabaní	Microchiroptera
Chʼosh chʼééh digháhii bideeʼ dį́įʼii	Stylommatophora
Wóláchííʼ yildeełí	Miereneters
Tséʼédǫ́ʼii łibáhígíí	Dambordvliegen
Dlozishzhiin	Witstaarteekhoorn
Tó Sido Háálį́	Pagosa Springs
Aniłtʼánii (naakaii náásééł nahalinígíí)	Mantispidae
Tsisteeł naʼazísí	Gopherschildpadden
Tó Diłhił Biih Yílį́	Snowflake (Arizona)
Yoołgai (Hoozdoh Hahoodzo)	Superior (Arizona)
Tsé Noodǫ́ǫ́z	Springerville
Kin Łání (Dibé Nitsaa Hahoodzo)	Durango (Colorado)
Tségháhoodzání	Window Rock
Tsé Yaatóhí	Cortez (Colorado)
Tótaʼ	Farmington (New Mexico)
Tó Naneesdizí	Tuba City
Tséhootsooí	Fort Defiance
Chʼínílį́	Chinle
Lókʼaaʼdeeshjin	Keams Canyon
Tséyiʼ (Chʼínílį́įgiʼígíí)	Canyon de Chelly National Monument
Chʼoshtsoh bíláshgaantsohí (tónteelgiʼígíí)	Zeekreeften
Tábąąstííntsoh bighaaʼ díłchʼilígíí	Zeeberen
Kʼaiʼbisii	Veery
Dlǫ́ʼiiłtsooí	Japanse marter
Tsʼímah	Chama (New Mexico)
Táshchozhii dootłʼizhí	Purperzwaluw
Nihookááʼ tsídii bichʼahígíí	Bucorvus
Tsísʼnáłtsooí	Kortkopwespen
Azeeʼ hókánii łibáhígíí	Gekroesde melkdistel
Jélii łóóʼ daʼhólzhaʼígíí	Salpidae
Gólízhii binághah dah łigaiígíí	Gekraagde skunk
Dloziłbáhí	Westelijke grijze eekhoorn
Tsiiʼnteelí (łóóʼ)	Platkopvissen
Tsiiłchin Biiʼ Tó	Chilchinbito
Bikétłʼááh Hoolzhólígíí	Tylopoda
Deeschííʼ Bikooh	Cibecue
Chíshii Kʼíneeshbizhii	Lucy's zanger
Tǫ́ʼgaaʼ	Cochiti
Táłtłʼááh séigoʼ bitsʼaʼígíí	Atlantische degenkrab
Nááʼnoodǫ́ǫzii	Boerenkers
Tóidoozohii dootłʼizhígíí	Porphyrio
Chʼagiiłbáhí	Molothrus
Jáád neishoodítsʼóóz	Gewone sluipwespen
Bitsiichįįshgahí	Grijze notenkraker
Naʼashǫ́ʼii naatʼaʼí	Vliegende draakjes
Gólízhii bíchį́į́h tʼáá łichíiʼii	Varkenssnuitskunks
Iichʼąhii naashchʼąąʼígíí	Chrysiridia rhipheus
Wóóseetsʼiniiniłhiní	Grottensprinkhanen
Ałchʼįʼ beʼastłʼóní	Tamale (voedsel)
Gólízhii yistłʼinígíí	Gevlekte skunks
Biniiʼnoodǫ́zí (tsin yigázhígíí)	Viscacha
Aniłtʼánii (bideeneezígíí)	Vlinderhaften
Zábąąhnteelii (łóóʼ ooshgę́ęzhii)	Rhina ancylostoma
Sílátsoh (chʼil)	Slipbladige rudbeckia
Tłʼiish kʼaaʼ	Racer
Tsézhin Dilkǫǫh	Dilkon
Naaldlooshii Bikéshgaan Dahólónígíí	Hoefdieren
Tółání Biyáázh	North Acomita Village
Tó Dínéeshzheeʼ	Kayenta
Beehai (Kintah)	Dulce (New Mexico)
Néʼézhiin	Roodneksapspecht
Ginítsoh diłhiłí	Zwarte buizerd
Hoshdódii	Whippoorwill
Hasbídí Áshįįhí	East Fork
Chʼééh digháhii bitsʼaʼ dah deezʼáhí	Graptemys
Dlǫ́ʼii yił aheełtʼéhii diłhiłígíí	Herpestes pulverulentus
Chʼosh bitsʼaʼ doolghasígíí	Pectinidae
Chaatʼíní bichʼosh	Groen zuringhaantje
Ndilkal biyaʼ noodǫ́zígíí	Acalymma vittatum
Iichʼąhii bitʼaʼ ahéédiníʼáhí	Eumorpha achemon
Tádídíín yiyání łizhinígíí	Timarcha
Chʼałdą́ą́ʼ bichʼosh	Crioceris
Tsékʼi Naʼasdzooí (Yootó Hahoodzo)	El Morro National Monument
Tsídii bidaatsoh naashchʼąąʼí	Toekans
Kʼaiʼbiiʼtó	Kaibito
Chʼał bikéshgaan hólóní	Xenopus
Tó wónaanídę́ę́ʼ nahashchʼidí	Meles
Bidił Daazdoígíí dóó Daʼałtʼoʼígíí ałkééʼ daasdzoh	Lijst van zoogdieren
Dáánézí (łóóʼ)	Snipmesvissen
Tłʼiish bichóhí	Hoornratelslang
Tsékʼi yaʼiiʼáhii	Tabakspijlstaart
Táłkááʼ sikaadí	Akkerhoornbloem
Táłtłʼááh chʼosh chʼééh digháhii bitsiiʼ dikʼání	Cephalaspidea
Dahtooʼ yinooghałii	Moeraswinterkoning
Atʼaʼ éljołí nahalinígíí (táłtłʼááh chʼosh)	Sabellidae
Tʼááłáhági átʼéego:Bééshbichʼahí	Categorie:Duitsland
Tʼááłáhági átʼéego:Wááshindoon bikéyah ałhidadiidzooígíí	Categorie:Verenigde Staten
Táłtłʼááh kʼaaʼ (łóóʼ)	Fluitbekvissen
Tʼááłáhági átʼéego:Dibé diníí bikéyah	Categorie:Spanje
Tʼááłáhági átʼéego:Naakaii Bikéyah	Categorie:Mexico
Naalkʼįhí bizaʼazis hólóní	Suikereekhoorns
Wóódeʼełchíhii	Randwantsen
Naʼashǫ́ʼii diwozhígíí	Reuzengordelstaarthagedis
Choozhghalii	Icterus (geslacht)
Tsinlátah mąʼii	Slankberen
Tsiiyah wozhii	Sturnella
Chʼóyáázh nahalinígíí (táłtłʼááh chʼosh)	Kerstboomworm
Chʼosh dichiłí bitsʼaʼígíí	Mytiloida
Naatsédlózii	Renkoekoeken
Tʼááłáhági átʼéego:Bidił daazdoígíí dóó daʼałtʼoʼígíí	Categorie:Zoogdier
Tʼááłáhági átʼéego:Naaldlooshii dadichʼízhii	Categorie:Reptiel
Tʼááłáhági átʼéego:Biyáázh Tsʼǫʼasánígíí	Categorie:Amfibie
Tʼááłáhági átʼéego:Tsídii	Categorie:Vogel
Tʼááłáhági átʼéego:Chʼosh doo yitʼíinii dláádí dóó Ábishjaaʼ	Categorie:Schimmel
Tʼááłáhági átʼéego:Chʼil	Categorie:Plant
Tʼááłáhági átʼéego:Nátʼą́ą́ʼ náháneʼ	Categorie:Geschiedenis
Tʼááłáhági átʼéego:Naʼalkaah	Categorie:Wetenschap
Béégashii bideetsohí	Watusirund
Tséchʼízhí	Rough Rock
Tsétaʼkin	San Ildefonso Pueblo
Niʼiijíhí	Navajo (New Mexico)
Lókʼaahnteel	Ganado (Arizona)
Łóóʼtsoh bizábąąh shiyishí	Noordkapers
Tʼiis Názbąs	Teec Nos Pos
Díwózhii Biiʼ Tó	Greasewood
Kiisʼáanii Naakáí yikʼéʼ daʼdéísdlį́į́h	Pueblo-opstand
Tó hájiiloh	Santo Domingo Pueblo
Naashashí (Yootó Hahoodzo)	Santa Clara Pueblo
Táshchozhii ndiilkʼísii	Amerikaanse klifzwaluw
Tsídiiłtsooiiłkizhígíí	Bairds gors
Ndilkal biyaʼ łikizhígíí	Diabrotica undecimpunctata
Jiłhazhí bichʼosh (níłtsą́goʼ)	Desmocerus californicus
Hosh yiyání (níłtsą́goʼ)	Moneilema
Hanáádlį́	Huerfano
Tséʼałnáoztʼiʼí	Sanostee
Gad yił aheełtʼéhígíí bichʼosh	Diorhabda carinulata
Jádító	Jeddito
Iichʼąhii	Nachtvlinder (dier)
Chʼoshtsoh yázhí bíláshgaantsohí	Springkrabben
Roman dinéʼiʼ	Oude Rome
Tóyééʼ	Steamboat
Naadą́ą́ʼ bichʼosh	Maïswortelboorder
Chʼil deenínii	Zacht loogkruid
Dził Bílátah Łitsooí	Sunset Crater Volcano National Monument
Tsééhílį́	Tsaile
Shádiʼááhdę́ę́ʼ tsékʼi dlǫ́ǫ́ʼ	Rotsmoko
Chʼílwozh	Whiteriver
Shą́ą́ʼtóhí	Shonto
Tó Nehelį́į́h	Tonalea
Kin Náztʼįʼ	Shongopovi
Tó Hałtsooí	Sheep Springs
Lókʼaʼchʼégai	Lukachukai
Tsé Binííʼtóhí	Tse Bonito
Tsiizizii	Leupp
Yaʼniilzhiin	Torreon (New Mexico)
Náhodeeshgiizh Chʼínílíní	Pueblo Pintado
Ooljééʼ Tó dóó Tsé Deelghasii	Oljato-Monument Valley (Arizona)
Dáʼákʼeh Halání	Many Farms
Názlíní	Nazlini
Niʼiijííh Hasání	Sawmill
Tséʼnaa Naʼníʼáhí	Rainbow Bridge National Monument
Tsé Łichííʼ Dahazkání (Hoozdoh Hahoodzo)	Red Mesa
Maʼiitoʼí	Houck
Tó Niłtsʼílí	Crystal (New Mexico)
Tábąąh béégashii ałchiní	Bubalus arnee
Dáádílí ntsxaaígíí	Itajara
Naakaii Chʼah	Mexican Hat
Chʼosh ałchozhii (iichʼąhii)	Klerenmot
Bitátʼahkin	Navajo National Monument
Tʼááłáhági átʼéego:Ałtsʼáʼáztiin	Categorie:Wikipedia:Doorverwijspagina
Bis Deezʼáhí	Newcomb (New Mexico)
Tsintah bįįhchilí	Echte dwergherten
Yiikʼiʼdaʼ hiiznáʼ	Offensief (militair)
Tʼiistsʼóóz	Smalbladige populier
Naatʼáanii Nééz	Shiprock (New Mexico)
Tsékʼi naʼazólii	Sauromalus
Juan de Oñate	Juan de Oñate
Kʼish Chʼínítʼiʼ	Paguate
Sǫʼtsoh nátʼoh	Smalbladige wilg
Yaaʼííʼáhí (Bidááʼ Haʼaztʼiʼ Tsékooh)	Desert View Watchtower
Sengaa	San Carlos (Arizona)
Ńdíshchííʼ Dah Shizhóód	Pinehill
Naatoohó (Kintah)	Isleta Village Proper
Atsá	Arend (roofvogel)
Naʼashǫ́ʼiinteeltsxooí	Keizerrotshagedis
Séíbéʼézhóóʼ	Muhlenbergia
Tsʼíhootso	St. Michaels (Arizona)
Tłʼoh Łikizhí	Tesuque
Dibé łizhiní dinéʼiʼ	San Felipe Pueblo
Maʼii Tééh Yitłizhí	Brimhall Nizhoni
Tsé Chʼééchiiʼ	Mesita
Doo Alkʼahii	Upper Fruitland
Łichíiʼii	Lechee
Tsé Bitʼaʼí	Shiprock (rotsformatie)
Tʼiistsʼóóz Ńdeeshgizh	Crownpoint
Naashtʼézhí (Yootó Hahoodzo)	Zuni Pueblo
Ndilnaʼii	Luiaards
Hashtłʼish Tó	Claypool (Arizona)
Tsísʼnáyázhí	Halictidae
Oozéí Hayázhí	Moenkopi
Bíina	Ignacio
Tsé Dootłʼizh (Hoozdoh Hahoodzo)	Peridot (Arizona)
Chʼałtʼą́hí	Pipa's
Dą́ʼáchaan	Ustilago
Kinłitsosinil	Church Rock
Iichʼąhiiłgai bitʼaʼnézí	Thysania agrippina
Tsézhįįh Deezlį́	Black Rock (New Mexico)
Séí nahachagiichilí (chʼosh bikágí ntłʼizí)	Strandvlooien
Naakaii Bitoʼ	Nakaibito
Báshdodi kǫʼ naʼałbąąsii ninádaaltłiʼígi	Casa del Desierto
Dólii Dził	Los Cerrillos
Tłʼohchiní	Ramah (New Mexico)
Beʼekʼid Baa Ahoodzání	Pinon (Arizona)
Kin Dootłʼizhí	Towaoc
Íijeehí	Lappula
Chéchʼízhí	Rock Springs (New Mexico)
Naayízí (Yootó Hahoodzo)	Nageezi
Tó Haachʼiʼ	Tohatchi
Biʼééʼ dootłʼizhgo disxǫsígíí	Pharomachrus
Tʼáá Bííchʼį́įdii (Áshįįh Biiʼtó Hahoodzo)	Aneth (Utah)
Aniłtʼániitsoh	Corydalinae
Kʼaiʼ Chʼíneeltłʼǫ́	La Jara (New Mexico)
Dlǫ́ʼí Yázhí (Yootó Hahoodzo)	Thoreau (New Mexico)
Tʼááłáhági átʼéego:Stubs	Categorie:Wikipedia:Beginnetje
Tʼááłáhági átʼéego:Chidí naatʼaʼí	Categorie:Luchtvaartuig
Bitłʼááh Bitoʼ	Beclabito
Siil	Stoom
Bee álnééhí:User uk-2	Sjabloon:Gebruiker uk-2
Kin Łichííʼ (Yootó Hahoodzo)	San Juan (New Mexico)
Tʼiistsoh	Alamo (New Mexico)
Nahashchʼidí (Yootó Hahoodzo)	Naschitti
Tʼáá Bííchʼį́įdii (Yootó Hahoodzo)	Yah-ta-hey
Łóóʼ biyaʼ (chʼosh bikágí ntłʼizí)	Visluizen (familie)
Tʼááłáhági átʼéego:Wikipedia bots	Categorie:Wikipedia:Bots
Tónteel zhį́ʼii	Aalscholvers
Niłtsínii bikétłʼóól dijoolí (daadánígíí)	Knolraap
Tsídii bitseeʼ naashchʼąąʼí	Pauwen
Bee álnééhí:Tl	Sjabloon:Tl
Tʼááłáhági átʼéego:Bee Hazʼáanii	Categorie:Recht
Tʼááłáhági átʼéego:Kéyah daʼnaaznilígíí dóó kéyah biłhaʼdaʼhaasdzoígíí	Categorie:Land
Wikiibíídiiya:Dahwéetʼaahígíí	Wikipedia:Moderator
Wikiibíídiiya:Botígíí beehazʼą́ąnii	Wikipedia:Bots
Tłʼézhiiłtsxooí	Adejeania
Ííjip	Egypte (land)
Bee álnééhí:Bot	Sjabloon:Bot
Deeteel Bikéyah	Canada
Tʼááłáhági átʼéego:Béésh bichʼahníí bikéyah	Categorie:Land in Europa
Tʼááłáhági átʼéego:Choyoołʼįįhí Bizaad	Categorie:Wikipedia:Babel
Tséłnííʼjí (chʼil)	Echt venushaar
Bee álnééhí:Softredirect	Sjabloon:Softredirect
Haʼałtsédii bichʼosh (níłtsą́goʼ)	Knulliana cincta
Chʼosh chʼééh digháhii	Slakken
Tʼááłáhági átʼéego:Saad	Categorie:Taal
Wikiibíídiiya:General disclaimer	Wikipedia:Vrijwaringsclausule
Tʼááłáhági átʼéego:Noindexed pages	Categorie:Wikipedia:Niet te indexeren pagina's
Wikiibíídiiya:Statistics	Wikipedia:Statistieken
Tʼiis bichʼosh (níłtsą́goʼ)	Plectrodera scalator
Níłtsą́goʼtsoh	Derobrachus geminatus
Łóóʼ hashkéhéchilí	Draakvissen
Tʼááłáhági átʼéego:Béésh bee akʼeʼelchíhí tʼáá bí nitsékeesígíí	Categorie:Toegepaste informatica
Naayízí (chʼil)	Kalebas
Bee álnééhí:Bots	Sjabloon:Bots
Tʼááłáhági átʼéego:Naaltsoos	Categorie:Boek
Bee álnééhí:Wikisource	Sjabloon:Wikisource
Bee álnééhí:Babel	Sjabloon:Babel
Bee álnééhí:Commons	Sjabloon:Commons
Bee álnééhí:Reflist	Sjabloon:References
Bee álnééhí:Stub	Sjabloon:Beginnetje
Bee álnééhí:User af-1	Sjabloon:Gebruiker af-1
Bee álnééhí:User als-1	Sjabloon:Gebruiker als-1
Bee álnééhí:User ar-1	Sjabloon:Gebruiker ar-1
Bee álnééhí:User az	Sjabloon:Gebruiker az
Bee álnééhí:User bar-1	Sjabloon:Gebruiker bar-1
Bee álnééhí:User eo-1	Sjabloon:Gebruiker eo-1
Bee álnééhí:See also	Sjabloon:Zie ook
Bee álnééhí:User da-2	Sjabloon:Gebruiker da-2
Bee álnééhí:User da	Sjabloon:Gebruiker da
Bee álnééhí:User ca-1	Sjabloon:Gebruiker ca-1
Bee álnééhí:User be-2	Sjabloon:Gebruiker be-2
Bee álnééhí:User da-1	Sjabloon:Gebruiker da-1
Bee álnééhí:User cs-1	Sjabloon:Gebruiker cs-1
Bee álnééhí:User bg-1	Sjabloon:Gebruiker bg-1
Bee álnééhí:User eo-3	Sjabloon:Gebruiker eo-3
Bee álnééhí:User de	Sjabloon:Gebruiker de
Bee álnééhí:User de-1	Sjabloon:Gebruiker de-1
Bee álnééhí:User eu-4	Sjabloon:Gebruiker eu-4
Bee álnééhí:User eu	Sjabloon:Gebruiker eu
Bee álnééhí:User et-1	Sjabloon:Gebruiker et-1
Bee álnééhí:User el	Sjabloon:Gebruiker el
Bee álnééhí:User es	Sjabloon:Gebruiker es
Bee álnééhí:User de-3	Sjabloon:Gebruiker de-3
Bee álnééhí:User en-3	Sjabloon:Gebruiker en-3
Bee álnééhí:User el-1	Sjabloon:Gebruiker el-1
Bee álnééhí:User en-1	Sjabloon:Gebruiker en-1
Bee álnééhí:User en-2	Sjabloon:Gebruiker en-2
Bee álnééhí:User fa-1	Sjabloon:Gebruiker fa-1
Bee álnééhí:User eo-2	Sjabloon:Gebruiker eo-2
Bee álnééhí:User en-4	Sjabloon:Gebruiker en-4
Bee álnééhí:User fi	Sjabloon:Gebruiker fi
Bee álnééhí:User es-4	Sjabloon:Gebruiker es-4
Bee álnééhí:User en	Sjabloon:Gebruiker en
Bee álnééhí:User de-2	Sjabloon:Gebruiker de-2
Bee álnééhí:User es-1	Sjabloon:Gebruiker es-1
Bee álnééhí:User fa	Sjabloon:Gebruiker fa
Bee álnééhí:User fi-1	Sjabloon:Gebruiker fi-1
Bee álnééhí:User fr-1	Sjabloon:Gebruiker fr-1
Bee álnééhí:User ia-2	Sjabloon:Gebruiker ia-2
Bee álnééhí:User hi-1	Sjabloon:Gebruiker hi-1
Bee álnééhí:User hr	Sjabloon:Gebruiker hr
Bee álnééhí:User he-2	Sjabloon:Gebruiker he-2
Bee álnééhí:User he-1	Sjabloon:Gebruiker he-1
Bee álnééhí:User hu	Sjabloon:Gebruiker hu
Bee álnééhí:User id-3	Sjabloon:Gebruiker id-3
Bee álnééhí:User io-3	Sjabloon:Gebruiker io-3
Bee álnééhí:User it-3	Sjabloon:Gebruiker it-3
Bee álnééhí:User grc-1	Sjabloon:Gebruiker grc-1
Bee álnééhí:User ja-4	Sjabloon:Gebruiker ja-4
Bee álnééhí:User sk	Sjabloon:Gebruiker sk
Bee álnééhí:User tr-2	Sjabloon:Gebruiker tr-2
Bee álnééhí:User fr-2	Sjabloon:Gebruiker fr-2
Bee álnééhí:User tr	Sjabloon:Gebruiker tr
Bee álnééhí:User ja	Sjabloon:Gebruiker ja
Bee álnééhí:User ja-1	Sjabloon:Gebruiker ja-1
Bee álnééhí:User it-1	Sjabloon:Gebruiker it-1
Bee álnééhí:User hr-1	Sjabloon:Gebruiker hr-1
Bee álnééhí:User fr	Sjabloon:Gebruiker fr
Bee álnééhí:User he	Sjabloon:Gebruiker he
Tʼááłáhági átʼéego:Chʼosh bijáád hastánígíí	Categorie:Insect
Tʼááłáhági átʼéego:Choyoołʼįįhí uk	Categorie:Wikipedia:Gebruiker uk
Tʼááłáhági átʼéego:Choyoołʼįįhí uk-N	Categorie:Wikipedia:Gebruiker uk-M
Tʼááłáhági átʼéego:Chʼiyáán	Categorie:Voedsel
Bee álnééhí:User sv	Sjabloon:Gebruiker sv
Bee álnééhí:User it	Sjabloon:Gebruiker it
Bee álnééhí:User uk	Sjabloon:Gebruiker uk
Bee álnééhí:User es-2	Sjabloon:Gebruiker es-2
Tʼááłáhági átʼéego:Choyoołʼįįhí ms	Categorie:Wikipedia:Gebruiker ms
Tʼááłáhági átʼéego:Choyoołʼįįhí fr-1	Categorie:Wikipedia:Gebruiker fr-1
Bee álnééhí:Image label	Sjabloon:Afbeelding label
Bee álnééhí:User ms	Sjabloon:Gebruiker ms
Tʼááłáhági átʼéego:Atsá dóó Giní Ndahalinígíí	Categorie:Falconiformes
Bee álnééhí:User hi-3	Sjabloon:Gebruiker hi-3
Tʼááłáhági átʼéego:Choyoołʼįįhí en-4	Categorie:Wikipedia:Gebruiker en-4
Tʼááłáhági átʼéego:Choyoołʼįįhí en	Categorie:Wikipedia:Gebruiker en
Tʼááłáhági átʼéego:Choyoołʼįįhí zh	Categorie:Wikipedia:Gebruiker zh
Tʼááłáhági átʼéego:Choyoołʼįįhí zh-N	Categorie:Wikipedia:Gebruiker zh-M
Tʼááłáhági átʼéego:Choyoołʼįįhí en-2	Categorie:Wikipedia:Gebruiker en-2
Bee álnééhí:User eo	Sjabloon:Gebruiker eo
Bee álnééhí:User zh	Sjabloon:Gebruiker zh
Bee álnééhí:User ru-4	Sjabloon:Gebruiker ru-4
Bee álnééhí:User sr	Sjabloon:Gebruiker sr
Bee álnééhí:GeoTemplate	Sjabloon:GeoTemplate
Bee álnééhí:User nl-1	Sjabloon:Gebruiker nl-1
Bee álnééhí:User nl-2	Sjabloon:Gebruiker nl-2
Tʼááłáhági átʼéego:Néʼéshjaaʼ	Categorie:Uil (vogel)
Tʼááłáhági átʼéego:Choyoołʼįįhí hi	Categorie:Wikipedia:Gebruiker hi
Tʼááłáhági átʼéego:Choyoołʼįįhí ms-N	Categorie:Wikipedia:Gebruiker ms-M
Tʼááłáhági átʼéego:Dził	Categorie:Berg
Bee álnééhí:User ru	Sjabloon:Gebruiker ru
Tʼááłáhági átʼéego:Kéyah dah siʼánígíí	Categorie:Amerika
Tʼááłáhági átʼéego:Choyoołʼįįhí bizaad-Templates	Categorie:Wikipedia:Sjablonen babel
Bee álnééhí:Archive	Sjabloon:Archief
Bee álnééhí:User eo-4	Sjabloon:Gebruiker eo-4
Tʼááłáhági átʼéego:Siláołtsooí	Categorie:Krijgswezen
Tʼááłáhági átʼéego:Naʼashǫ́ʼii	Categorie:Hagedis
Bee álnééhí:User pt-1	Sjabloon:Gebruiker pt-1
Bee álnééhí:User oc-4	Sjabloon:Gebruiker oc-4
Bee álnééhí:User pl	Sjabloon:Gebruiker pl
Bee álnééhí:User nl	Sjabloon:Gebruiker nl
Bee álnééhí:User no-2	Sjabloon:Gebruiker no-2
Bee álnééhí:Image label end	Sjabloon:Afbeelding label eind
Bee álnééhí:Userpage	Sjabloon:Gebruikerspagina
Bee álnééhí:Emergency-bot-shutoff	Sjabloon:Noodrem
Bee álnééhí:User pl-1	Sjabloon:Gebruiker pl-1
Bee álnééhí:Image label small	Sjabloon:Afbeelding label klein
Bee álnééhí:User fr-3	Sjabloon:Gebruiker fr-3
Bee álnééhí:User lt	Sjabloon:Gebruiker lt
Bee álnééhí:User nds-1	Sjabloon:Gebruiker nds-1
Tʼááłáhági átʼéego:Hosh	Categorie:Cactaceae
Bee álnééhí:User tr-4	Sjabloon:Gebruiker tr-4
Bee álnééhí:User is-1	Sjabloon:Gebruiker is-1
Bee álnééhí:User is-2	Sjabloon:Gebruiker is-2
Bee álnééhí:User ar-2	Sjabloon:Gebruiker ar-2
Bee álnééhí:User ar-3	Sjabloon:Gebruiker ar-3
Bee álnééhí:User is	Sjabloon:Gebruiker is
Bee álnééhí:User ar	Sjabloon:Gebruiker ar
Bee álnééhí:User az-3	Sjabloon:Gebruiker az-3
Bee álnééhí:User en-5	Sjabloon:Gebruiker en-5
Tʼááłáhági átʼéego:Choyoołʼįįhí ja-N	Categorie:Wikipedia:Gebruiker ja-M
Bee álnééhí:User als	Sjabloon:Gebruiker als
Bee álnééhí:@	Sjabloon:@
Tʼááłáhági átʼéego:Tłʼoh	Categorie:Poaceae
Bee álnééhí:Ałtsʼáʼáztiin	Sjabloon:Dp
Bee álnééhí:User no-3	Sjabloon:Gebruiker no-3
Bee álnééhí:User ksh	Sjabloon:Gebruiker ksh
Bee álnééhí:User no	Sjabloon:Gebruiker no
Bee álnééhí:User yue-1	Sjabloon:Gebruiker yue-1
Bee álnééhí:User sv-2	Sjabloon:Gebruiker sv-2
Bee álnééhí:User it-2	Sjabloon:Gebruiker it-2
Tʼááłáhági átʼéego:Ásáí Bikéyah	Categorie:Lidstaat van de Arabische Liga
Tʼááłáhági átʼéego:Kǫʼ naʼałbąąsii	Categorie:Spoorweg
Bee álnééhí:User pt-3	Sjabloon:Gebruiker pt-3
Bee álnééhí:User pt-2	Sjabloon:Gebruiker pt-2
Bee álnééhí:User th-1	Sjabloon:Gebruiker th-1
Bee álnééhí:User lb-1	Sjabloon:Gebruiker lb-1
Bee álnééhí:User ro-4	Sjabloon:Gebruiker ro-4
Bee álnééhí:User ro	Sjabloon:Gebruiker ro
Bee álnééhí:User fr-4	Sjabloon:Gebruiker fr-4
Bee álnééhí:User lv	Sjabloon:Gebruiker lv
Bee álnééhí:User bg	Sjabloon:Gebruiker bg
Tʼááłáhági átʼéego:Choyoołʼįįhí vi-3	Categorie:Wikipedia:Gebruiker vi-3
Bee álnééhí:User la-1	Sjabloon:Gebruiker la-1
Tʼááłáhági átʼéego:Templates/doc	Categorie:Wikipedia:Sjablonen sjabloondocumentatie
Tʼááłáhági átʼéego:Choyoołʼįįhí yue	Categorie:Wikipedia:Gebruiker yue
Tʼááłáhági átʼéego:Choyoołʼįįhí pdc	Categorie:Wikipedia:Gebruiker pdc
Tʼááłáhági átʼéego:Choyoołʼįįhí mzn	Categorie:Wikipedia:Gebruiker mzn
Tʼááłáhági átʼéego:Choyoołʼįįhí az	Categorie:Wikipedia:Gebruiker az
Tʼááłáhági átʼéego:Choyoołʼįįhí be	Categorie:Wikipedia:Gebruiker be
Tʼááłáhági átʼéego:Choyoołʼįįhí bs	Categorie:Wikipedia:Gebruiker bs
Tʼááłáhági átʼéego:Choyoołʼįįhí hr	Categorie:Wikipedia:Gebruiker hr
Tʼááłáhági átʼéego:Choyoołʼįįhí sk	Categorie:Wikipedia:Gebruiker sk
Tʼááłáhági átʼéego:Choyoołʼįįhí sl	Categorie:Wikipedia:Gebruiker sl
Tʼááłáhági átʼéego:Choyoołʼįįhí eo	Categorie:Wikipedia:Gebruiker eo
Tʼááłáhági átʼéego:Choyoołʼįįhí et	Categorie:Wikipedia:Gebruiker et
Tʼááłáhági átʼéego:Choyoołʼįįhí fr	Categorie:Wikipedia:Gebruiker fr
Tʼááłáhági átʼéego:Choyoołʼįįhí gl	Categorie:Wikipedia:Gebruiker gl
Tʼááłáhági átʼéego:Choyoołʼįįhí cy	Categorie:Wikipedia:Gebruiker cy
Tʼááłáhági átʼéego:Choyoołʼįįhí hu-N	Categorie:Wikipedia:Gebruiker hu-M
Tʼááłáhági átʼéego:Choyoołʼįįhí id	Categorie:Wikipedia:Gebruiker id
Tʼááłáhági átʼéego:Choyoołʼįįhí ia	Categorie:Wikipedia:Gebruiker ia
Tʼááłáhági átʼéego:Choyoołʼįįhí ga	Categorie:Wikipedia:Gebruiker ga
Tʼááłáhági átʼéego:Choyoołʼįįhí ja	Categorie:Wikipedia:Gebruiker ja
Tʼááłáhági átʼéego:Choyoołʼįįhí rn	Categorie:Wikipedia:Gebruiker rn
Tʼááłáhági átʼéego:Choyoołʼįįhí la	Categorie:Wikipedia:Gebruiker la
Tʼááłáhági átʼéego:Choyoołʼįįhí li	Categorie:Wikipedia:Gebruiker li
Tʼááłáhági átʼéego:Choyoołʼįįhí lt	Categorie:Wikipedia:Gebruiker lt
Tʼááłáhági átʼéego:Choyoołʼįįhí mk	Categorie:Wikipedia:Gebruiker mk
Tʼááłáhági átʼéego:Choyoołʼįįhí mg	Categorie:Wikipedia:Gebruiker mg
Tʼááłáhági átʼéego:Choyoołʼįįhí mwl	Categorie:Wikipedia:Gebruiker mwl
Tʼááłáhági átʼéego:Choyoołʼįįhí mn	Categorie:Wikipedia:Gebruiker mn
Tʼááłáhági átʼéego:Choyoołʼįįhí nn	Categorie:Wikipedia:Gebruiker nn
Tʼááłáhági átʼéego:Choyoołʼįįhí nah	Categorie:Wikipedia:Gebruiker nah
Tʼááłáhági átʼéego:Choyoołʼįįhí oc	Categorie:Wikipedia:Gebruiker oc
Tʼááłáhági átʼéego:Choyoołʼįįhí pt	Categorie:Wikipedia:Gebruiker pt
Tʼááłáhági átʼéego:Choyoołʼįįhí ro	Categorie:Wikipedia:Gebruiker ro
Tʼááłáhági átʼéego:Choyoołʼįįhí sc	Categorie:Wikipedia:Gebruiker sc
Tʼááłáhági átʼéego:Choyoołʼįįhí sh	Categorie:Wikipedia:Gebruiker sh
Tʼááłáhági átʼéego:Choyoołʼįįhí sv	Categorie:Wikipedia:Gebruiker sv
Tʼááłáhági átʼéego:Choyoołʼįįhí sw	Categorie:Wikipedia:Gebruiker sw
Tʼááłáhági átʼéego:Choyoołʼįįhí sa	Categorie:Wikipedia:Gebruiker sa
Tʼááłáhági átʼéego:Choyoołʼįįhí th	Categorie:Wikipedia:Gebruiker th
Tʼááłáhági átʼéego:Choyoołʼįįhí ta	Categorie:Wikipedia:Gebruiker ta
Tʼááłáhági átʼéego:Choyoołʼįįhí vo	Categorie:Wikipedia:Gebruiker vo
Tʼááłáhági átʼéego:Choyoołʼįįhí bar-3	Categorie:Wikipedia:Gebruiker bar-3
Tʼááłáhági átʼéego:Choyoołʼįįhí az-3	Categorie:Wikipedia:Gebruiker az-3
Tʼááłáhági átʼéego:Choyoołʼįįhí be-3	Categorie:Wikipedia:Gebruiker be-3
Tʼááłáhági átʼéego:Choyoołʼįįhí cs-3	Categorie:Wikipedia:Gebruiker cs-3
Tʼááłáhági átʼéego:Choyoołʼįįhí sl-3	Categorie:Wikipedia:Gebruiker sl-3
Tʼááłáhági átʼéego:Choyoołʼįįhí et-3	Categorie:Wikipedia:Gebruiker et-3
Tʼááłáhági átʼéego:Choyoołʼįįhí fr-3	Categorie:Wikipedia:Gebruiker fr-3
Tʼááłáhági átʼéego:Choyoołʼįįhí hi-3	Categorie:Wikipedia:Gebruiker hi-3
Tʼááłáhági átʼéego:Choyoołʼįįhí it-3	Categorie:Wikipedia:Gebruiker it-3
Tʼááłáhági átʼéego:Choyoołʼįįhí ja-3	Categorie:Wikipedia:Gebruiker ja-3
Tʼááłáhági átʼéego:Choyoołʼįįhí li-3	Categorie:Wikipedia:Gebruiker li-3
Tʼááłáhági átʼéego:Choyoołʼįįhí lt-3	Categorie:Wikipedia:Gebruiker lt-3
Tʼááłáhági átʼéego:Choyoołʼįįhí nl-3	Categorie:Wikipedia:Gebruiker nl-3
Tʼááłáhági átʼéego:Choyoołʼįįhí no-3	Categorie:Wikipedia:Gebruiker no-3
Tʼááłáhági átʼéego:Choyoołʼįįhí pl-3	Categorie:Wikipedia:Gebruiker pl-3
Tʼááłáhági átʼéego:Choyoołʼįįhí sw-3	Categorie:Wikipedia:Gebruiker sw-3
Tʼááłáhági átʼéego:Choyoołʼįįhí tr-3	Categorie:Wikipedia:Gebruiker tr-3
Tʼááłáhági átʼéego:Choyoołʼįįhí ar-3	Categorie:Wikipedia:Gebruiker ar-3
Tʼááłáhági átʼéego:Choyoołʼįįhí pdc-1	Categorie:Wikipedia:Gebruiker pdc-1
Tʼááłáhági átʼéego:Choyoołʼįįhí an-1	Categorie:Wikipedia:Gebruiker an-1
Tʼááłáhági átʼéego:Choyoołʼįįhí be-1	Categorie:Wikipedia:Gebruiker be-1
Tʼááłáhági átʼéego:Choyoołʼįįhí cs-1	Categorie:Wikipedia:Gebruiker cs-1
Tʼááłáhági átʼéego:Choyoołʼįįhí da-1	Categorie:Wikipedia:Gebruiker da-1
Tʼááłáhági átʼéego:Choyoołʼįįhí sl-1	Categorie:Wikipedia:Gebruiker sl-1
Tʼááłáhági átʼéego:Choyoołʼįįhí et-1	Categorie:Wikipedia:Gebruiker et-1
Tʼááłáhági átʼéego:Choyoołʼįįhí fi-1	Categorie:Wikipedia:Gebruiker fi-1
Tʼááłáhági átʼéego:Choyoołʼįįhí cy-1	Categorie:Wikipedia:Gebruiker cy-1
Tʼááłáhági átʼéego:Choyoołʼįįhí hi-1	Categorie:Wikipedia:Gebruiker hi-1
Tʼááłáhági átʼéego:Choyoołʼįįhí ia-1	Categorie:Wikipedia:Gebruiker ia-1
Tʼááłáhági átʼéego:Choyoołʼįįhí ga-1	Categorie:Wikipedia:Gebruiker ga-1
Tʼááłáhági átʼéego:Choyoołʼįįhí jv-1	Categorie:Wikipedia:Gebruiker jv-1
Tʼááłáhági átʼéego:Choyoołʼįįhí lv-1	Categorie:Wikipedia:Gebruiker lv-1
Tʼááłáhági átʼéego:Choyoołʼįįhí li-1	Categorie:Wikipedia:Gebruiker li-1
Tʼááłáhági átʼéego:Choyoołʼįįhí lt-1	Categorie:Wikipedia:Gebruiker lt-1
Tʼááłáhági átʼéego:Choyoołʼįįhí mk-1	Categorie:Wikipedia:Gebruiker mk-1
Tʼááłáhági átʼéego:Choyoołʼįįhí nl-1	Categorie:Wikipedia:Gebruiker nl-1
Tʼááłáhági átʼéego:Choyoołʼįįhí nah-1	Categorie:Wikipedia:Gebruiker nah-1
Tʼááłáhági átʼéego:Choyoołʼįįhí oc-1	Categorie:Wikipedia:Gebruiker oc-1
Tʼááłáhági átʼéego:Choyoołʼįįhí pl-1	Categorie:Wikipedia:Gebruiker pl-1
Tʼááłáhági átʼéego:Choyoołʼįįhí ro-1	Categorie:Wikipedia:Gebruiker ro-1
Tʼááłáhági átʼéego:Choyoołʼįįhí sc-1	Categorie:Wikipedia:Gebruiker sc-1
Tʼááłáhági átʼéego:Choyoołʼįįhí sh-1	Categorie:Wikipedia:Gebruiker sh-1
Tʼááłáhági átʼéego:Choyoołʼįįhí sw-1	Categorie:Wikipedia:Gebruiker sw-1
Tʼááłáhági átʼéego:Choyoołʼįįhí sa-1	Categorie:Wikipedia:Gebruiker sa-1
Tʼááłáhági átʼéego:Choyoołʼįįhí tr-1	Categorie:Wikipedia:Gebruiker tr-1
Tʼááłáhági átʼéego:Choyoołʼįįhí vo-1	Categorie:Wikipedia:Gebruiker vo-1
Tʼááłáhági átʼéego:Choyoołʼįįhí ar-1	Categorie:Wikipedia:Gebruiker ar-1
Tʼááłáhági átʼéego:Choyoołʼįįhí be-4	Categorie:Wikipedia:Gebruiker be-4
Tʼááłáhági átʼéego:Choyoołʼįįhí fr-4	Categorie:Wikipedia:Gebruiker fr-4
Tʼááłáhági átʼéego:Choyoołʼįįhí hi-4	Categorie:Wikipedia:Gebruiker hi-4
Tʼááłáhági átʼéego:Choyoołʼįįhí id-4	Categorie:Wikipedia:Gebruiker id-4
Tʼááłáhági átʼéego:Choyoołʼįįhí ia-4	Categorie:Wikipedia:Gebruiker ia-4
Tʼááłáhági átʼéego:Choyoołʼįįhí it-4	Categorie:Wikipedia:Gebruiker it-4
Tʼááłáhági átʼéego:Choyoołʼįįhí li-4	Categorie:Wikipedia:Gebruiker li-4
Tʼááłáhági átʼéego:Choyoołʼįįhí lt-4	Categorie:Wikipedia:Gebruiker lt-4
Tʼááłáhági átʼéego:Choyoołʼįįhí oc-4	Categorie:Wikipedia:Gebruiker oc-4
Tʼááłáhági átʼéego:Choyoołʼįįhí pl-4	Categorie:Wikipedia:Gebruiker pl-4
Tʼááłáhági átʼéego:Choyoołʼįįhí sh-4	Categorie:Wikipedia:Gebruiker sh-4
Tʼááłáhági átʼéego:Choyoołʼįįhí ar-4	Categorie:Wikipedia:Gebruiker ar-4
Tʼááłáhági átʼéego:Choyoołʼįįhí als-2	Categorie:Wikipedia:Gebruiker als-2
Tʼááłáhági átʼéego:Choyoołʼįįhí mzn-2	Categorie:Wikipedia:Gebruiker mzn-2
Tʼááłáhági átʼéego:Choyoołʼįįhí be-2	Categorie:Wikipedia:Gebruiker be-2
Tʼááłáhági átʼéego:Choyoołʼįįhí bs-2	Categorie:Wikipedia:Gebruiker bs-2
Tʼááłáhági átʼéego:Choyoołʼįįhí cs-2	Categorie:Wikipedia:Gebruiker cs-2
Tʼááłáhági átʼéego:Choyoołʼįįhí da-2	Categorie:Wikipedia:Gebruiker da-2
Tʼááłáhági átʼéego:Choyoołʼįįhí sk-2	Categorie:Wikipedia:Gebruiker sk-2
Tʼááłáhági átʼéego:Choyoołʼįįhí sl-2	Categorie:Wikipedia:Gebruiker sl-2
Tʼááłáhági átʼéego:Choyoołʼįįhí et-2	Categorie:Wikipedia:Gebruiker et-2
Tʼááłáhági átʼéego:Choyoołʼįįhí fr-2	Categorie:Wikipedia:Gebruiker fr-2
Tʼááłáhági átʼéego:Choyoołʼįįhí cy-2	Categorie:Wikipedia:Gebruiker cy-2
Tʼááłáhági átʼéego:Choyoołʼįįhí hi-2	Categorie:Wikipedia:Gebruiker hi-2
Tʼááłáhági átʼéego:Choyoołʼįįhí hu-2	Categorie:Wikipedia:Gebruiker hu-2
Tʼááłáhági átʼéego:Choyoołʼįįhí ia-2	Categorie:Wikipedia:Gebruiker ia-2
Tʼááłáhági átʼéego:Choyoołʼįįhí it-2	Categorie:Wikipedia:Gebruiker it-2
Tʼááłáhági átʼéego:Choyoołʼįįhí ja-2	Categorie:Wikipedia:Gebruiker ja-2
Tʼááłáhági átʼéego:Choyoołʼįįhí rn-2	Categorie:Wikipedia:Gebruiker rn-2
Tʼááłáhági átʼéego:Choyoołʼįįhí la-2	Categorie:Wikipedia:Gebruiker la-2
Tʼááłáhági átʼéego:Choyoołʼįįhí li-2	Categorie:Wikipedia:Gebruiker li-2
Tʼááłáhági átʼéego:Choyoołʼįįhí lt-2	Categorie:Wikipedia:Gebruiker lt-2
Tʼááłáhági átʼéego:Choyoołʼįįhí mk-2	Categorie:Wikipedia:Gebruiker mk-2
Tʼááłáhági átʼéego:Choyoołʼįįhí mwl-2	Categorie:Wikipedia:Gebruiker mwl-2
Tʼááłáhági átʼéego:Choyoołʼįįhí nl-2	Categorie:Wikipedia:Gebruiker nl-2
Tʼááłáhági átʼéego:Choyoołʼįįhí oc-2	Categorie:Wikipedia:Gebruiker oc-2
Tʼááłáhági átʼéego:Choyoołʼįįhí pl-2	Categorie:Wikipedia:Gebruiker pl-2
Tʼááłáhági átʼéego:Choyoołʼįįhí sh-2	Categorie:Wikipedia:Gebruiker sh-2
Tʼááłáhági átʼéego:Choyoołʼįįhí sv-2	Categorie:Wikipedia:Gebruiker sv-2
Tʼááłáhági átʼéego:Choyoołʼįįhí sw-2	Categorie:Wikipedia:Gebruiker sw-2
Tʼááłáhági átʼéego:Choyoołʼįįhí sa-2	Categorie:Wikipedia:Gebruiker sa-2
Tʼááłáhági átʼéego:Choyoołʼįįhí tr-2	Categorie:Wikipedia:Gebruiker tr-2
Tʼááłáhági átʼéego:Choyoołʼįįhí ar-2	Categorie:Wikipedia:Gebruiker ar-2
Tʼááłáhági átʼéego:Choyoołʼįįhí hy-N	Categorie:Wikipedia:Gebruiker hy-M
Tʼááłáhági átʼéego:Choyoołʼįįhí ast-N	Categorie:Wikipedia:Gebruiker ast-M
Tʼááłáhági átʼéego:Choyoołʼįįhí be-N	Categorie:Wikipedia:Gebruiker be-M
Tʼááłáhági átʼéego:Choyoołʼįįhí cs-N	Categorie:Wikipedia:Gebruiker cs-M
Tʼááłáhági átʼéego:Choyoołʼįįhí ko-N	Categorie:Wikipedia:Gebruiker ko-M
Tʼááłáhági átʼéego:Choyoołʼįįhí hr-N	Categorie:Wikipedia:Gebruiker hr-M
Tʼááłáhági átʼéego:Choyoołʼįįhí sl-N	Categorie:Wikipedia:Gebruiker sl-M
Tʼááłáhági átʼéego:Choyoołʼįįhí et-N	Categorie:Wikipedia:Gebruiker et-M
Tʼááłáhági átʼéego:Choyoołʼįįhí fr-N	Categorie:Wikipedia:Gebruiker fr-M
Tʼááłáhági átʼéego:Choyoołʼįįhí fy-N	Categorie:Wikipedia:Gebruiker fy-M
Tʼááłáhági átʼéego:Choyoołʼįįhí gl-N	Categorie:Wikipedia:Gebruiker gl-M
Tʼááłáhági átʼéego:Choyoołʼįįhí cy-N	Categorie:Wikipedia:Gebruiker cy-M
Tʼááłáhági átʼéego:Choyoołʼįįhí hi-N	Categorie:Wikipedia:Gebruiker hi-M
Tʼááłáhági átʼéego:Choyoołʼįįhí id-N	Categorie:Wikipedia:Gebruiker id-M
Tʼááłáhági átʼéego:Choyoołʼįįhí is-N	Categorie:Wikipedia:Gebruiker is-M
Tʼááłáhági átʼéego:Choyoołʼįįhí it-N	Categorie:Wikipedia:Gebruiker it-M
Tʼááłáhági átʼéego:Choyoołʼįįhí jv-N	Categorie:Wikipedia:Gebruiker jv-M
Tʼááłáhági átʼéego:Choyoołʼįįhí ku-N	Categorie:Wikipedia:Gebruiker ku-M
Tʼááłáhági átʼéego:Choyoołʼįįhí lv-N	Categorie:Wikipedia:Gebruiker lv-M
Tʼááłáhági átʼéego:Choyoołʼįįhí li-N	Categorie:Wikipedia:Gebruiker li-M
Tʼááłáhági átʼéego:Choyoołʼįįhí lt-N	Categorie:Wikipedia:Gebruiker lt-M
Tʼááłáhági átʼéego:Choyoołʼįįhí lb-N	Categorie:Wikipedia:Gebruiker lb-M
Tʼááłáhági átʼéego:Choyoołʼįįhí mk-N	Categorie:Wikipedia:Gebruiker mk-M
Tʼááłáhági átʼéego:Choyoołʼįįhí mg-N	Categorie:Wikipedia:Gebruiker mg-M
Tʼááłáhági átʼéego:Choyoołʼįįhí nl-N	Categorie:Wikipedia:Gebruiker nl-M
Tʼááłáhági átʼéego:Choyoołʼįįhí no-N	Categorie:Wikipedia:Gebruiker no-M
Tʼááłáhági átʼéego:Choyoołʼįįhí nn-N	Categorie:Wikipedia:Gebruiker nn-M
Tʼááłáhági átʼéego:Choyoołʼįįhí or-N	Categorie:Wikipedia:Gebruiker or-M
Tʼááłáhági átʼéego:Choyoołʼįįhí ru-N	Categorie:Wikipedia:Gebruiker ru-M
Tʼááłáhági átʼéego:Choyoołʼįįhí sw-N	Categorie:Wikipedia:Gebruiker sw-M
Tʼááłáhági átʼéego:Choyoołʼįįhí ta-N	Categorie:Wikipedia:Gebruiker ta-M
Tʼááłáhági átʼéego:Choyoołʼįįhí ar-N	Categorie:Wikipedia:Gebruiker ar-M
Bee álnééhí:User yue	Sjabloon:Gebruiker yue
Bee álnééhí:User pdc-1	Sjabloon:Gebruiker pdc-1
Tʼááłáhági átʼéego:Choyoołʼįįhí eu-3	Categorie:Wikipedia:Gebruiker eu-3
Tʼááłáhági átʼéego:Choyoołʼįįhí eu-N	Categorie:Wikipedia:Gebruiker eu-M
Tʼááłáhági átʼéego:Choyoołʼįįhí af	Categorie:Wikipedia:Gebruiker af
Tʼááłáhági átʼéego:Choyoołʼįįhí af-1	Categorie:Wikipedia:Gebruiker af-1
Tʼááłáhági átʼéego:Choyoołʼįįhí af-2	Categorie:Wikipedia:Gebruiker af-2
Tʼááłáhági átʼéego:Choyoołʼįįhí af-3	Categorie:Wikipedia:Gebruiker af-3
Tʼááłáhági átʼéego:Choyoołʼįįhí af-4	Categorie:Wikipedia:Gebruiker af-4
Tʼááłáhági átʼéego:Choyoołʼįįhí af-N	Categorie:Wikipedia:Gebruiker af-M
Tʼááłáhági átʼéego:Choyoołʼįįhí als	Categorie:Wikipedia:Gebruiker als
Tʼááłáhági átʼéego:Choyoołʼįįhí als-1	Categorie:Wikipedia:Gebruiker als-1
Tʼááłáhági átʼéego:Choyoołʼįįhí an	Categorie:Wikipedia:Gebruiker an
Tʼááłáhági átʼéego:Choyoołʼįįhí ar	Categorie:Wikipedia:Gebruiker ar
Tʼááłáhági átʼéego:Choyoołʼįįhí as	Categorie:Wikipedia:Gebruiker as
Tʼááłáhági átʼéego:Choyoołʼįįhí as-N	Categorie:Wikipedia:Gebruiker as-M
Tʼááłáhági átʼéego:Choyoołʼįįhí ast	Categorie:Wikipedia:Gebruiker ast
Tʼááłáhági átʼéego:Choyoołʼįįhí az-1	Categorie:Wikipedia:Gebruiker az-1
Tʼááłáhági átʼéego:Choyoołʼįįhí az-2	Categorie:Wikipedia:Gebruiker az-2
Tʼááłáhági átʼéego:Choyoołʼįįhí az-4	Categorie:Wikipedia:Gebruiker az-4
Tʼááłáhági átʼéego:Choyoołʼįįhí az-N	Categorie:Wikipedia:Gebruiker az-M
Tʼááłáhági átʼéego:Choyoołʼįįhí bar	Categorie:Wikipedia:Gebruiker bar
Tʼááłáhági átʼéego:Choyoołʼįįhí bar-1	Categorie:Wikipedia:Gebruiker bar-1
Tʼááłáhági átʼéego:Choyoołʼįįhí bar-2	Categorie:Wikipedia:Gebruiker bar-2
Tʼááłáhági átʼéego:Choyoołʼįįhí bar-N	Categorie:Wikipedia:Gebruiker bar-M
Tʼááłáhági átʼéego:Choyoołʼįįhí bg	Categorie:Wikipedia:Gebruiker bg
Tʼááłáhági átʼéego:Choyoołʼįįhí bg-1	Categorie:Wikipedia:Gebruiker bg-1
Tʼááłáhági átʼéego:Choyoołʼįįhí bg-2	Categorie:Wikipedia:Gebruiker bg-2
Tʼááłáhági átʼéego:Choyoołʼįįhí bg-3	Categorie:Wikipedia:Gebruiker bg-3
Tʼááłáhági átʼéego:Choyoołʼįįhí bg-4	Categorie:Wikipedia:Gebruiker bg-4
Tʼááłáhági átʼéego:Choyoołʼįįhí bg-N	Categorie:Wikipedia:Gebruiker bg-M
Tʼááłáhági átʼéego:Choyoołʼįįhí bn	Categorie:Wikipedia:Gebruiker bn
Tʼááłáhági átʼéego:Choyoołʼįįhí bn-N	Categorie:Wikipedia:Gebruiker bn-M
Tʼááłáhági átʼéego:Choyoołʼįįhí ca	Categorie:Wikipedia:Gebruiker ca
Tʼááłáhági átʼéego:Choyoołʼįįhí ca-1	Categorie:Wikipedia:Gebruiker ca-1
Tʼááłáhági átʼéego:Choyoołʼįįhí ca-2	Categorie:Wikipedia:Gebruiker ca-2
Tʼááłáhági átʼéego:Tádídíín deiyání	Categorie:Bladhaantje
Tʼááłáhági átʼéego:Choyoołʼįįhí ca-3	Categorie:Wikipedia:Gebruiker ca-3
Tʼááłáhági átʼéego:Choyoołʼįįhí ca-N	Categorie:Wikipedia:Gebruiker ca-M
Tʼááłáhági átʼéego:Choyoołʼįįhí cs	Categorie:Wikipedia:Gebruiker cs
Tʼááłáhági átʼéego:Choyoołʼįįhí csb	Categorie:Wikipedia:Gebruiker csb
Tʼááłáhági átʼéego:Choyoołʼįįhí csb-1	Categorie:Wikipedia:Gebruiker csb-1
Tʼááłáhági átʼéego:Choyoołʼįįhí da	Categorie:Wikipedia:Gebruiker da
Tʼááłáhági átʼéego:Choyoołʼįįhí sk-N	Categorie:Wikipedia:Gebruiker sk-M
Tʼááłáhági átʼéego:Choyoołʼįįhí da-3	Categorie:Wikipedia:Gebruiker da-3
Tʼááłáhági átʼéego:Choyoołʼįįhí da-4	Categorie:Wikipedia:Gebruiker da-4
Tʼááłáhági átʼéego:Choyoołʼįįhí de	Categorie:Wikipedia:Gebruiker de
Tʼááłáhági átʼéego:Choyoołʼįįhí de-2	Categorie:Wikipedia:Gebruiker de-2
Tʼááłáhági átʼéego:Choyoołʼįįhí de-3	Categorie:Wikipedia:Gebruiker de-3
Tʼááłáhági átʼéego:Choyoołʼįįhí de-4	Categorie:Wikipedia:Gebruiker de-4
Tʼááłáhági átʼéego:Choyoołʼįįhí de-N	Categorie:Wikipedia:Gebruiker de-M
Tʼááłáhági átʼéego:Choyoołʼįįhí dsb	Categorie:Wikipedia:Gebruiker dsb
Tʼááłáhági átʼéego:Choyoołʼįįhí dsb-1	Categorie:Wikipedia:Gebruiker dsb-1
Tʼááłáhági átʼéego:Choyoołʼįįhí el	Categorie:Wikipedia:Gebruiker el
Tʼááłáhági átʼéego:Choyoołʼįįhí el-1	Categorie:Wikipedia:Gebruiker el-1
Tʼááłáhági átʼéego:Choyoołʼįįhí el-2	Categorie:Wikipedia:Gebruiker el-2
Tʼááłáhági átʼéego:Choyoołʼįįhí el-3	Categorie:Wikipedia:Gebruiker el-3
Tʼááłáhági átʼéego:Choyoołʼįįhí el-4	Categorie:Wikipedia:Gebruiker el-4
Tʼááłáhági átʼéego:Choyoołʼįįhí el-N	Categorie:Wikipedia:Gebruiker el-M
Tʼááłáhági átʼéego:Choyoołʼįįhí en-3	Categorie:Wikipedia:Gebruiker en-3
Tʼááłáhági átʼéego:Choyoołʼįįhí en-5	Categorie:Wikipedia:Gebruiker en-5
Tʼááłáhági átʼéego:Choyoołʼįįhí en-N	Categorie:Wikipedia:Gebruiker en-M
Tʼááłáhági átʼéego:Choyoołʼįįhí eo-1	Categorie:Wikipedia:Gebruiker eo-1
Tʼááłáhági átʼéego:Choyoołʼįįhí eo-2	Categorie:Wikipedia:Gebruiker eo-2
Tʼááłáhági átʼéego:Choyoołʼįįhí eo-3	Categorie:Wikipedia:Gebruiker eo-3
Tʼááłáhági átʼéego:Choyoołʼįįhí eo-4	Categorie:Wikipedia:Gebruiker eo-4
Tʼááłáhági átʼéego:Choyoołʼįįhí eo-N	Categorie:Wikipedia:Gebruiker eo-M
Tʼááłáhági átʼéego:Choyoołʼįįhí es	Categorie:Wikipedia:Gebruiker es
Tʼááłáhági átʼéego:Choyoołʼįįhí es-1	Categorie:Wikipedia:Gebruiker es-1
Tʼááłáhági átʼéego:Choyoołʼįįhí es-2	Categorie:Wikipedia:Gebruiker es-2
Tʼááłáhági átʼéego:Choyoołʼįįhí es-3	Categorie:Wikipedia:Gebruiker es-3
Tʼááłáhági átʼéego:Choyoołʼįįhí es-4	Categorie:Wikipedia:Gebruiker es-4
Tʼááłáhági átʼéego:Choyoołʼįįhí es-N	Categorie:Wikipedia:Gebruiker es-M
Tʼááłáhági átʼéego:Choyoołʼįįhí eu	Categorie:Wikipedia:Gebruiker eu
Tʼááłáhági átʼéego:Choyoołʼįįhí eu-1	Categorie:Wikipedia:Gebruiker eu-1
Tʼááłáhági átʼéego:Choyoołʼįįhí eu-2	Categorie:Wikipedia:Gebruiker eu-2
Tʼááłáhági átʼéego:Choyoołʼįįhí eu-4	Categorie:Wikipedia:Gebruiker eu-4
Tʼááłáhági átʼéego:Choyoołʼįįhí fa	Categorie:Wikipedia:Gebruiker fa
Tʼááłáhági átʼéego:Choyoołʼįįhí fa-1	Categorie:Wikipedia:Gebruiker fa-1
Tʼááłáhági átʼéego:Choyoołʼįįhí fa-2	Categorie:Wikipedia:Gebruiker fa-2
Tʼááłáhági átʼéego:Choyoołʼįįhí fa-3	Categorie:Wikipedia:Gebruiker fa-3
Tʼááłáhági átʼéego:Choyoołʼįįhí fa-N	Categorie:Wikipedia:Gebruiker fa-M
Tʼááłáhági átʼéego:Choyoołʼįįhí fi	Categorie:Wikipedia:Gebruiker fi
Tʼááłáhági átʼéego:Choyoołʼįįhí fi-2	Categorie:Wikipedia:Gebruiker fi-2
Tʼááłáhági átʼéego:Gólízhii	Categorie:Stinkdier
Tʼááłáhági átʼéego:Choyoołʼįįhí fi-3	Categorie:Wikipedia:Gebruiker fi-3
Tʼááłáhági átʼéego:Choyoołʼįįhí fi-4	Categorie:Wikipedia:Gebruiker fi-4
Tʼááłáhági átʼéego:Choyoołʼįįhí fi-N	Categorie:Wikipedia:Gebruiker fi-M
Tʼááłáhági átʼéego:Choyoołʼįįhí fy	Categorie:Wikipedia:Gebruiker fy
Tʼááłáhági átʼéego:Choyoołʼįįhí fy-1	Categorie:Wikipedia:Gebruiker fy-1
Tʼááłáhági átʼéego:Choyoołʼįįhí ga-2	Categorie:Wikipedia:Gebruiker ga-2
Tʼááłáhági átʼéego:Choyoołʼįįhí ga-3	Categorie:Wikipedia:Gebruiker ga-3
Tʼááłáhági átʼéego:Choyoołʼįįhí grc	Categorie:Wikipedia:Gebruiker grc
Tʼááłáhági átʼéego:Choyoołʼįįhí grc-1	Categorie:Wikipedia:Gebruiker grc-1
Tʼááłáhági átʼéego:Choyoołʼįįhí grc-2	Categorie:Wikipedia:Gebruiker grc-2
Tʼááłáhági átʼéego:Choyoołʼįįhí grc-3	Categorie:Wikipedia:Gebruiker grc-3
Tʼááłáhági átʼéego:Choyoołʼįįhí he	Categorie:Wikipedia:Gebruiker he
Tʼááłáhági átʼéego:Choyoołʼįįhí he-1	Categorie:Wikipedia:Gebruiker he-1
Tʼááłáhági átʼéego:Choyoołʼįįhí he-2	Categorie:Wikipedia:Gebruiker he-2
Tʼááłáhági átʼéego:Choyoołʼįįhí he-3	Categorie:Wikipedia:Gebruiker he-3
Tʼááłáhági átʼéego:Choyoołʼįįhí he-4	Categorie:Wikipedia:Gebruiker he-4
Tʼááłáhági átʼéego:Choyoołʼįįhí he-N	Categorie:Wikipedia:Gebruiker he-M
Tʼááłáhági átʼéego:Choyoołʼįįhí hr-1	Categorie:Wikipedia:Gebruiker hr-1
Tʼááłáhági átʼéego:Choyoołʼįįhí hr-2	Categorie:Wikipedia:Gebruiker hr-2
Tʼááłáhági átʼéego:Choyoołʼįįhí hr-3	Categorie:Wikipedia:Gebruiker hr-3
Tʼááłáhági átʼéego:Choyoołʼįįhí hr-4	Categorie:Wikipedia:Gebruiker hr-4
Tʼááłáhági átʼéego:Choyoołʼįįhí hsb	Categorie:Wikipedia:Gebruiker hsb
Tʼááłáhági átʼéego:Choyoołʼįįhí hsb-1	Categorie:Wikipedia:Gebruiker hsb-1
Tʼááłáhági átʼéego:Choyoołʼįįhí hsb-2	Categorie:Wikipedia:Gebruiker hsb-2
Tʼááłáhági átʼéego:Choyoołʼįįhí hu	Categorie:Wikipedia:Gebruiker hu
Tʼááłáhági átʼéego:Choyoołʼįįhí hu-1	Categorie:Wikipedia:Gebruiker hu-1
Tʼááłáhági átʼéego:Choyoołʼįįhí hu-3	Categorie:Wikipedia:Gebruiker hu-3
Tʼááłáhági átʼéego:Choyoołʼįįhí hy	Categorie:Wikipedia:Gebruiker hy
Tʼááłáhági átʼéego:Choyoołʼįįhí id-1	Categorie:Wikipedia:Gebruiker id-1
Tʼááłáhági átʼéego:Choyoołʼįįhí id-2	Categorie:Wikipedia:Gebruiker id-2
Tʼááłáhági átʼéego:Choyoołʼįįhí id-3	Categorie:Wikipedia:Gebruiker id-3
Tʼááłáhági átʼéego:Choyoołʼįįhí io	Categorie:Wikipedia:Gebruiker io
Tʼááłáhági átʼéego:Choyoołʼįįhí io-1	Categorie:Wikipedia:Gebruiker io-1
Tʼááłáhági átʼéego:Choyoołʼįįhí io-3	Categorie:Wikipedia:Gebruiker io-3
Tʼááłáhági átʼéego:Choyoołʼįįhí is	Categorie:Wikipedia:Gebruiker is
Tʼááłáhági átʼéego:Choyoołʼįįhí is-1	Categorie:Wikipedia:Gebruiker is-1
Tʼááłáhági átʼéego:Choyoołʼįįhí is-2	Categorie:Wikipedia:Gebruiker is-2
Tʼááłáhági átʼéego:Choyoołʼįįhí is-3	Categorie:Wikipedia:Gebruiker is-3
Tʼááłáhági átʼéego:Choyoołʼįįhí is-4	Categorie:Wikipedia:Gebruiker is-4
Tʼááłáhági átʼéego:Choyoołʼįįhí als-N	Categorie:Wikipedia:Gebruiker als-M
Bee álnééhí:User la-3	Sjabloon:Gebruiker la-3
Tʼááłáhági átʼéego:Choyoołʼįįhí pt-3	Categorie:Wikipedia:Gebruiker pt-3
Tʼááłáhági átʼéego:Choyoołʼįįhí pl-N	Categorie:Wikipedia:Gebruiker pl-M
Tʼááłáhági átʼéego:Choyoołʼįįhí pt-1	Categorie:Wikipedia:Gebruiker pt-1
Tʼááłáhági átʼéego:Choyoołʼįįhí ka-1	Categorie:Wikipedia:Gebruiker ka-1
Tʼááłáhági átʼéego:Choyoołʼįįhí it	Categorie:Wikipedia:Gebruiker it
Tʼááłáhági átʼéego:Choyoołʼįįhí it-1	Categorie:Wikipedia:Gebruiker it-1
Tʼááłáhági átʼéego:Choyoołʼįįhí ja-1	Categorie:Wikipedia:Gebruiker ja-1
Tʼááłáhági átʼéego:Choyoołʼįįhí jv	Categorie:Wikipedia:Gebruiker jv
Tʼááłáhági átʼéego:Choyoołʼįįhí jv-2	Categorie:Wikipedia:Gebruiker jv-2
Tʼááłáhági átʼéego:Choyoołʼįįhí jv-3	Categorie:Wikipedia:Gebruiker jv-3
Tʼááłáhági átʼéego:Choyoołʼįįhí ka	Categorie:Wikipedia:Gebruiker ka
Tʼááłáhági átʼéego:Choyoołʼįįhí ka-N	Categorie:Wikipedia:Gebruiker ka-M
Tʼááłáhági átʼéego:Choyoołʼįįhí kg	Categorie:Wikipedia:Gebruiker kg
Tʼááłáhági átʼéego:Choyoołʼįįhí kn	Categorie:Wikipedia:Gebruiker kn
Tʼááłáhági átʼéego:Choyoołʼįįhí kn-1	Categorie:Wikipedia:Gebruiker kn-1
Tʼááłáhági átʼéego:Choyoołʼįįhí ko	Categorie:Wikipedia:Gebruiker ko
Tʼááłáhági átʼéego:Wááshindoon bikéyah bił haʼdaʼhaasdzoígíí	Categorie:Staat van de Verenigde Staten
Tʼááłáhági átʼéego:Choyoołʼįįhí ko-1	Categorie:Wikipedia:Gebruiker ko-1
Tʼááłáhági átʼéego:Choyoołʼįįhí ko-2	Categorie:Wikipedia:Gebruiker ko-2
Tʼááłáhági átʼéego:Choyoołʼįįhí ko-3	Categorie:Wikipedia:Gebruiker ko-3
Tʼááłáhági átʼéego:Choyoołʼįįhí ksh	Categorie:Wikipedia:Gebruiker ksh
Tʼááłáhági átʼéego:Choyoołʼįįhí ksh-1	Categorie:Wikipedia:Gebruiker ksh-1
Tʼááłáhági átʼéego:Choyoołʼįįhí ksh-N	Categorie:Wikipedia:Gebruiker ksh-M
Tʼááłáhági átʼéego:Choyoołʼįįhí ku	Categorie:Wikipedia:Gebruiker ku
Tʼááłáhági átʼéego:Choyoołʼįįhí la-1	Categorie:Wikipedia:Gebruiker la-1
Tʼááłáhági átʼéego:Choyoołʼįįhí la-3	Categorie:Wikipedia:Gebruiker la-3
Tʼááłáhági átʼéego:Choyoołʼįįhí la-4	Categorie:Wikipedia:Gebruiker la-4
Tʼááłáhági átʼéego:Choyoołʼįįhí lb	Categorie:Wikipedia:Gebruiker lb
Tʼááłáhági átʼéego:Choyoołʼįįhí lb-1	Categorie:Wikipedia:Gebruiker lb-1
Tʼááłáhági átʼéego:Choyoołʼįįhí lb-2	Categorie:Wikipedia:Gebruiker lb-2
Tʼááłáhági átʼéego:Choyoołʼįįhí lb-3	Categorie:Wikipedia:Gebruiker lb-3
Tʼááłáhági átʼéego:Dibé Nitsaa Hahoodzodi kin naaznilígíí	Categorie:Plaats in Colorado
Tʼááłáhági átʼéego:Choyoołʼįįhí nn-2	Categorie:Wikipedia:Gebruiker nn-2
Bee álnééhí:User gl	Sjabloon:Gebruiker gl
Tʼááłáhági átʼéego:Choyoołʼįįhí ru-1	Categorie:Wikipedia:Gebruiker ru-1
Bee álnééhí:User af-4	Sjabloon:Gebruiker af-4
Yaaʼ bijáád hastánígíí	Dierluizen
Bee álnééhí:User sv-1	Sjabloon:Gebruiker sv-1
Tʼááłáhági átʼéego:Chʼil bikétłʼóól daadánígíí	Categorie:Wortelgroente
Tʼááłáhági átʼéego:Choyoołʼįįhí lv	Categorie:Wikipedia:Gebruiker lv
Tʼááłáhági átʼéego:Choyoołʼįįhí mn-1	Categorie:Wikipedia:Gebruiker mn-1
Tʼááłáhági átʼéego:Choyoołʼįįhí mn-3	Categorie:Wikipedia:Gebruiker mn-3
Tʼááłáhági átʼéego:Choyoołʼįįhí mn-N	Categorie:Wikipedia:Gebruiker mn-M
Tʼááłáhági átʼéego:Choyoołʼįįhí ms-1	Categorie:Wikipedia:Gebruiker ms-1
Nahasdzáán bimagnetic field	Aardmagnetisch veld
Tʼááłáhági átʼéego:Choyoołʼįįhí als-3	Categorie:Wikipedia:Gebruiker als-3
Bee álnééhí:User jv	Sjabloon:Gebruiker jv
Bee álnééhí:User id	Sjabloon:Gebruiker id
Tʼááłáhági átʼéego:Choyoołʼįįhí nds	Categorie:Wikipedia:Gebruiker nds
Tʼááłáhági átʼéego:Choyoołʼįįhí nds-1	Categorie:Wikipedia:Gebruiker nds-1
Tʼááłáhági átʼéego:Choyoołʼįįhí nds-2	Categorie:Wikipedia:Gebruiker nds-2
Tʼááłáhági átʼéego:Choyoołʼįįhí nds-3	Categorie:Wikipedia:Gebruiker nds-3
Tʼááłáhági átʼéego:Choyoołʼįįhí nds-4	Categorie:Wikipedia:Gebruiker nds-4
Tʼááłáhági átʼéego:Choyoołʼįįhí nds-N	Categorie:Wikipedia:Gebruiker nds-M
Tʼááłáhági átʼéego:Choyoołʼįįhí nds-nl	Categorie:Wikipedia:Gebruiker nds-nl
Bee álnééhí:User oc-1	Sjabloon:Gebruiker oc-1
Tʼááłáhági átʼéego:Kéyah Ałhidadiidzooígíí dóó Ahiih Yikaígíí	Categorie:Internationale organisatie
Tʼááłáhági átʼéego:Chʼosh bijáád dahólónígíí	Categorie:Geleedpotige
Tʼááłáhági átʼéego:Tó	Categorie:Water
Tʼááłáhági átʼéego:Bidił daazdoígíí dóó daʼalghałígíí	Categorie:Roofdier
Tʼááłáhági átʼéego:Choyoołʼįįhí tt-N	Categorie:Wikipedia:Gebruiker tt-M
Tʼááłáhági átʼéego:Choyoołʼįįhí nn-1	Categorie:Wikipedia:Gebruiker nn-1
Bee álnééhí:User sw-1	Sjabloon:Gebruiker sw-1
Bee álnééhí:User ka-1	Sjabloon:Gebruiker ka-1
Bee álnééhí:User af	Sjabloon:Gebruiker af
Tʼááłáhági átʼéego:Naakaii Łizhiní Bikéyah	Categorie:Land in Afrika
Bee álnééhí:User da-3	Sjabloon:Gebruiker da-3
Bee álnééhí:User pt-4	Sjabloon:Gebruiker pt-4
Bee álnééhí:User sl-3	Sjabloon:Gebruiker sl-3
Bee álnééhí:User ja-2	Sjabloon:Gebruiker ja-2
Bee álnééhí:User ko-2	Sjabloon:Gebruiker ko-2
Bee álnééhí:User ko-1	Sjabloon:Gebruiker ko-1
Bee álnééhí:User cs	Sjabloon:Gebruiker cs
Bee álnééhí:User ru-2	Sjabloon:Gebruiker ru-2
Bee álnééhí:User es-3	Sjabloon:Gebruiker es-3
Bee álnééhí:User ja-3	Sjabloon:Gebruiker ja-3
Bee álnééhí:User eu-1	Sjabloon:Gebruiker eu-1
Bee álnééhí:User ko-3	Sjabloon:Gebruiker ko-3
Tʼááłáhági átʼéego:Tsin bineestʼąʼ dadíkʼǫ́zhígíí	Categorie:Citrus
Tʼááłáhági átʼéego:Choyoołʼįįhí pt-2	Categorie:Wikipedia:Gebruiker pt-2
Tʼááłáhági átʼéego:Choyoołʼįįhí pt-4	Categorie:Wikipedia:Gebruiker pt-4
Tʼááłáhági átʼéego:Choyoołʼįįhí pt-N	Categorie:Wikipedia:Gebruiker pt-M
Tʼááłáhági átʼéego:Choyoołʼįįhí qu	Categorie:Wikipedia:Gebruiker qu
Tʼááłáhági átʼéego:Choyoołʼįįhí qu-1	Categorie:Wikipedia:Gebruiker qu-1
Tʼááłáhági átʼéego:Choyoołʼįįhí qu-3	Categorie:Wikipedia:Gebruiker qu-3
Tʼááłáhági átʼéego:Choyoołʼįįhí ro-2	Categorie:Wikipedia:Gebruiker ro-2
Tʼááłáhági átʼéego:Choyoołʼįįhí ro-3	Categorie:Wikipedia:Gebruiker ro-3
Tʼááłáhági átʼéego:Choyoołʼįįhí ro-4	Categorie:Wikipedia:Gebruiker ro-4
Tʼááłáhági átʼéego:Choyoołʼįįhí ro-N	Categorie:Wikipedia:Gebruiker ro-M
Tʼááłáhági átʼéego:Choyoołʼįįhí ru	Categorie:Wikipedia:Gebruiker ru
Tʼááłáhági átʼéego:Choyoołʼįįhí ru-2	Categorie:Wikipedia:Gebruiker ru-2
Tʼááłáhági átʼéego:Choyoołʼįįhí ru-3	Categorie:Wikipedia:Gebruiker ru-3
Tʼááłáhági átʼéego:Choyoołʼįįhí ru-4	Categorie:Wikipedia:Gebruiker ru-4
Tʼááłáhági átʼéego:Choyoołʼįįhí sk-1	Categorie:Wikipedia:Gebruiker sk-1
Tʼááłáhági átʼéego:Choyoołʼįįhí sk-3	Categorie:Wikipedia:Gebruiker sk-3
Tʼááłáhági átʼéego:Choyoołʼįįhí sk-4	Categorie:Wikipedia:Gebruiker sk-4
Tʼááłáhági átʼéego:Choyoołʼįįhí sr	Categorie:Wikipedia:Gebruiker sr
Tʼááłáhági átʼéego:Choyoołʼįįhí sr-1	Categorie:Wikipedia:Gebruiker sr-1
Tʼááłáhági átʼéego:Choyoołʼįįhí sr-2	Categorie:Wikipedia:Gebruiker sr-2
Tʼááłáhági átʼéego:Choyoołʼįįhí sr-3	Categorie:Wikipedia:Gebruiker sr-3
Tʼááłáhági átʼéego:Choyoołʼįįhí sr-4	Categorie:Wikipedia:Gebruiker sr-4
Tʼááłáhági átʼéego:Choyoołʼįįhí sr-N	Categorie:Wikipedia:Gebruiker sr-M
Tʼááłáhági átʼéego:Choyoołʼįįhí stq	Categorie:Wikipedia:Gebruiker stq
Tʼááłáhági átʼéego:Choyoołʼįįhí stq-1	Categorie:Wikipedia:Gebruiker stq-1
Tʼááłáhági átʼéego:Choyoołʼįįhí sv-1	Categorie:Wikipedia:Gebruiker sv-1
Tʼááłáhági átʼéego:Choyoołʼįįhí sv-3	Categorie:Wikipedia:Gebruiker sv-3
Tʼááłáhági átʼéego:Choyoołʼįįhí sv-4	Categorie:Wikipedia:Gebruiker sv-4
Tʼááłáhági átʼéego:Choyoołʼįįhí sv-N	Categorie:Wikipedia:Gebruiker sv-M
Tʼááłáhági átʼéego:Choyoołʼįįhí sxu	Categorie:Wikipedia:Gebruiker sxu
Tʼááłáhági átʼéego:Choyoołʼįįhí sxu-1	Categorie:Wikipedia:Gebruiker sxu-1
Tʼááłáhági átʼéego:Choyoołʼįįhí th-1	Categorie:Wikipedia:Gebruiker th-1
Tʼááłáhági átʼéego:Choyoołʼįįhí th-2	Categorie:Wikipedia:Gebruiker th-2
Tʼááłáhági átʼéego:Choyoołʼįįhí th-N	Categorie:Wikipedia:Gebruiker th-M
Tʼááłáhági átʼéego:Choyoołʼįįhí tr	Categorie:Wikipedia:Gebruiker tr
Tʼááłáhági átʼéego:Choyoołʼįįhí tr-4	Categorie:Wikipedia:Gebruiker tr-4
Tʼááłáhági átʼéego:Choyoołʼįįhí tr-N	Categorie:Wikipedia:Gebruiker tr-M
Tʼááłáhági átʼéego:Choyoołʼįįhí tt	Categorie:Wikipedia:Gebruiker tt
Tʼááłáhági átʼéego:Choyoołʼįįhí tt-1	Categorie:Wikipedia:Gebruiker tt-1
Tʼááłáhági átʼéego:Choyoołʼįįhí uk-1	Categorie:Wikipedia:Gebruiker uk-1
Tʼááłáhági átʼéego:Choyoołʼįįhí uk-2	Categorie:Wikipedia:Gebruiker uk-2
Tʼááłáhági átʼéego:Choyoołʼįįhí uk-3	Categorie:Wikipedia:Gebruiker uk-3
Tʼááłáhági átʼéego:Choyoołʼįįhí uk-4	Categorie:Wikipedia:Gebruiker uk-4
Tʼááłáhági átʼéego:Choyoołʼįįhí vi	Categorie:Wikipedia:Gebruiker vi
Tʼááłáhági átʼéego:Choyoołʼįįhí vi-1	Categorie:Wikipedia:Gebruiker vi-1
Tʼááłáhági átʼéego:Choyoołʼįįhí vi-2	Categorie:Wikipedia:Gebruiker vi-2
Tʼááłáhági átʼéego:Choyoołʼįįhí vi-4	Categorie:Wikipedia:Gebruiker vi-4
Tʼááłáhági átʼéego:Choyoołʼįįhí vi-N	Categorie:Wikipedia:Gebruiker vi-M
Tʼááłáhági átʼéego:Choyoołʼįįhí vls	Categorie:Wikipedia:Gebruiker vls
Tʼááłáhági átʼéego:Choyoołʼįįhí vls-1	Categorie:Wikipedia:Gebruiker vls-1
Tʼááłáhági átʼéego:Choyoołʼįįhí vls-2	Categorie:Wikipedia:Gebruiker vls-2
Tʼááłáhági átʼéego:Choyoołʼįįhí vls-3	Categorie:Wikipedia:Gebruiker vls-3
Tʼááłáhági átʼéego:Choyoołʼįįhí vls-N	Categorie:Wikipedia:Gebruiker vls-M
Tʼááłáhági átʼéego:Choyoołʼįįhí yue-1	Categorie:Wikipedia:Gebruiker yue-1
Tʼááłáhági átʼéego:Choyoołʼįįhí yue-N	Categorie:Wikipedia:Gebruiker yue-M
Bee álnééhí:User ro-1	Sjabloon:Gebruiker ro-1
Tʼááłáhági átʼéego:Tsin ííʼáhígíí	Categorie:Boom (plant)
Bee álnééhí:User th	Sjabloon:Gebruiker th
Bee álnééhí:User nds-2	Sjabloon:Gebruiker nds-2
Bee álnééhí:AtsáGiní	Sjabloon:Navigatie Accipitriformes
Bee álnééhí:User ca	Sjabloon:Gebruiker ca
Tʼááłáhági átʼéego:Mágí	Categorie:Primaat
Bee álnééhí:User sv-3	Sjabloon:Gebruiker sv-3
Bee álnééhí:User hsb-1	Sjabloon:Gebruiker hsb-1
Tʼááłáhági átʼéego:Naʼiiniʼ	Categorie:Handel
Bee álnééhí:User hsb-2	Sjabloon:Gebruiker hsb-2
Bee álnééhí:User af-3	Sjabloon:Gebruiker af-3
Tʼááłáhági átʼéego:Naaki góneʼ yéigo daʼahijoogą́ą́ʼ	Categorie:Tweede Wereldoorlog
Bee álnééhí:User ms-1	Sjabloon:Gebruiker ms-1
Tʼááłáhági átʼéego:Mósí dóó Náshdóí	Categorie:Katachtige
Bee álnééhí:User as	Sjabloon:Gebruiker as
Bee álnééhí:User nds	Sjabloon:Gebruiker nds
Tʼááłáhági átʼéego:Tó Kéyah Bináhaazyínígíí	Categorie:Eilandnatie
Bee álnééhí:User ar-4	Sjabloon:Gebruiker ar-4
Bee álnééhí:User az-2	Sjabloon:Gebruiker az-2
Bee álnééhí:User be	Sjabloon:Gebruiker be
Bee álnééhí:User ca-2	Sjabloon:Gebruiker ca-2
Bee álnééhí:User ca-3	Sjabloon:Gebruiker ca-3
Bee álnééhí:User cs-3	Sjabloon:Gebruiker cs-3
Bee álnééhí:User da-4	Sjabloon:Gebruiker da-4
Bee álnééhí:User el-2	Sjabloon:Gebruiker el-2
Bee álnééhí:User et-3	Sjabloon:Gebruiker et-3
Bee álnééhí:User fa-2	Sjabloon:Gebruiker fa-2
Bee álnééhí:User fa-3	Sjabloon:Gebruiker fa-3
Bee álnééhí:User fa-4	Sjabloon:Gebruiker fa-4
Bee álnééhí:User fi-2	Sjabloon:Gebruiker fi-2
Bee álnééhí:User fi-3	Sjabloon:Gebruiker fi-3
Bee álnééhí:User ga-2	Sjabloon:Gebruiker ga-2
Bee álnééhí:User he-3	Sjabloon:Gebruiker he-3
Bee álnééhí:User he-4	Sjabloon:Gebruiker he-4
Bee álnééhí:User hu-1	Sjabloon:Gebruiker hu-1
Bee álnééhí:User hy	Sjabloon:Gebruiker hy
Bee álnééhí:User jv-1	Sjabloon:Gebruiker jv-1
Bee álnééhí:User ka	Sjabloon:Gebruiker ka
Bee álnééhí:User ko	Sjabloon:Gebruiker ko
Bee álnééhí:User ku	Sjabloon:Gebruiker ku
Bee álnééhí:User la-2	Sjabloon:Gebruiker la-2
Bee álnééhí:User lb-2	Sjabloon:Gebruiker lb-2
Bee álnééhí:User li-1	Sjabloon:Gebruiker li-1
Bee álnééhí:User li-3	Sjabloon:Gebruiker li-3
Bee álnééhí:User mk-1	Sjabloon:Gebruiker mk-1
Bee álnééhí:User nn-2	Sjabloon:Gebruiker nn-2
Bee álnééhí:User no-1	Sjabloon:Gebruiker no-1
Bee álnééhí:User pl-2	Sjabloon:Gebruiker pl-2
Bee álnééhí:User pt	Sjabloon:Gebruiker pt
Bee álnééhí:User ro-2	Sjabloon:Gebruiker ro-2
Bee álnééhí:User ru-1	Sjabloon:Gebruiker ru-1
Bee álnééhí:User sa-1	Sjabloon:Gebruiker sa-1
Bee álnééhí:User sk-1	Sjabloon:Gebruiker sk-1
Bee álnééhí:User sk-2	Sjabloon:Gebruiker sk-2
Bee álnééhí:User sk-3	Sjabloon:Gebruiker sk-3
Bee álnééhí:User sr-1	Sjabloon:Gebruiker sr-1
Bee álnééhí:User sxu-1	Sjabloon:Gebruiker sxu-1
Bee álnééhí:User tr-1	Sjabloon:Gebruiker tr-1
Bee álnééhí:User tr-3	Sjabloon:Gebruiker tr-3
Bee álnééhí:User uk-1	Sjabloon:Gebruiker uk-1
Bee álnééhí:User uk-4	Sjabloon:Gebruiker uk-4
Bee álnééhí:User vo-1	Sjabloon:Gebruiker vo-1
Bee álnééhí:User zh-1	Sjabloon:Gebruiker zh-1
Bee álnééhí:User zh-2	Sjabloon:Gebruiker zh-2
Bee álnééhí:User zh-3	Sjabloon:Gebruiker zh-3
Bee álnééhí:User zh-4	Sjabloon:Gebruiker zh-4
Tʼááłáhági átʼéego:Choyoołʼįįhí nl	Categorie:Wikipedia:Gebruiker nl
Tʼááłáhági átʼéego:Choyoołʼįįhí nn-3	Categorie:Wikipedia:Gebruiker nn-3
Tʼááłáhági átʼéego:Choyoołʼįįhí no-1	Categorie:Wikipedia:Gebruiker no-1
Tʼááłáhági átʼéego:Choyoołʼįįhí no-2	Categorie:Wikipedia:Gebruiker no-2
Tʼááłáhági átʼéego:Choyoołʼįįhí no	Categorie:Wikipedia:Gebruiker no
Tʼááłáhági átʼéego:Choyoołʼįįhí pi-1	Categorie:Wikipedia:Gebruiker pi-1
Tʼááłáhági átʼéego:Choyoołʼįįhí nds-nl-1	Categorie:Wikipedia:Gebruiker nds-nl-1
Tʼááłáhági átʼéego:Choyoołʼįįhí zh-1	Categorie:Wikipedia:Gebruiker zh-1
Tʼááłáhági átʼéego:Choyoołʼįįhí zh-4	Categorie:Wikipedia:Gebruiker zh-4
Tʼááłáhági átʼéego:Choyoołʼįįhí zh-3	Categorie:Wikipedia:Gebruiker zh-3
Tʼááłáhági átʼéego:Choyoołʼįįhí zh-2	Categorie:Wikipedia:Gebruiker zh-2
Tʼááłáhági átʼéego:Chʼał	Categorie:Kikvorsachtige
Tʼááłáhági átʼéego:Mąʼii yił Ałhidanoolinígíí Yázhí	Categorie:Kleine beer
Tʼááłáhági átʼéego:Bitsįʼ yishtłizhii	Categorie:Indiaans volk
Tʼááłáhági átʼéego:Dlǫ́ʼiitsoh Danilínígíí	Categorie:Civetkatachtige
Tʼááłáhági átʼéego:Chéłchaaʼ	Categorie:Kever
Tʼááłáhági átʼéego:Naakáí dootłʼizhí dóó Bééshbichʼahii dabizaad ndahalinígíí	Categorie:Indo-Europese taalfamilie
Tʼááłáhági átʼéego:Hazéí	Categorie:Eekhoorn
Tʼááłáhági átʼéego:Chidí naatʼaʼí ńdinibįįhígi	Categorie:Vliegveld
Tʼááłáhági átʼéego:Áʼádaatʼéhígíí	Categorie:Chemisch element
Bee álnééhí:User pfl-1	Sjabloon:Gebruiker pfl-1
Bee álnééhí:User als-2	Sjabloon:Gebruiker als-2
Bee álnééhí:User als-4	Sjabloon:Gebruiker als-4
Bee álnééhí:User de-4	Sjabloon:Gebruiker de-4
Tʼááłáhági átʼéego:Abeʼ bitsʼą́ą́dóó ádaalyaaígíí	Categorie:Zuivel
Tʼááłáhági átʼéego:Tsin dóó chʼil bineestʼąʼ	Categorie:Fruit
Tʼááłáhági átʼéego:Kʼaalógii dóó Iichʼąhii	Categorie:Vlinder
Tʼááłáhági átʼéego:Chʼosh bijáád ádaadinígíí	Categorie:Weekdier
Tʼááłáhági átʼéego:Mąʼii dóó Łééchąąʼí	Categorie:Hondachtige
Tʼááłáhági átʼéego:Tó Wónaanídę́ę́ʼ Mágí	Categorie:Aap van de Oude Wereld
Tʼááłáhági átʼéego:Naayízí dóó taʼneeskʼání	Categorie:Cucurbitaceae
Tʼááłáhági átʼéego:Dlǫ́ʼii Ndahalinígíí	Categorie:Marterachtige
Tʼááłáhági átʼéego:Łóóʼtsoh biwooʼ dantłʼizígíí	Categorie:Tandwalvis
Tʼááłáhági átʼéego:Łóóʼtsoh biwooʼ daditsʼózígíí	Categorie:Baleinwalvis
Tʼááłáhági átʼéego:Naaldeehii	Categorie:Dierenrijk
Tʼááłáhági átʼéego:Bizaʼazis Dahólónígíí	Categorie:Buideldier
Tʼááłáhági átʼéego:Choyoołʼįįhí pfl-1	Categorie:Wikipedia:Gebruiker pfl-1
Tłʼiishdą́ą́ʼ	Driebloemige nachtschade
Tʼááłáhági átʼéego:Chʼosh chʼééh diikáhii	Categorie:Slak
Tʼááłáhági átʼéego:Chʼosh bitsʼaʼígíí	Categorie:Tweekleppige
Tʼááłáhági átʼéego:Gah	Categorie:Haasachtige
Tʼááłáhági átʼéego:Łóóʼtsoh dóó Tééh hóyáanii	Categorie:Walvisachtige
Bee álnééhí:User jv-2	Sjabloon:Gebruiker jv-2
Bee álnééhí:User fy-1	Sjabloon:Gebruiker fy-1
Bee álnééhí:User id-4	Sjabloon:Gebruiker id-4
Bee álnééhí:User uk-3	Sjabloon:Gebruiker uk-3
Tʼááłáhági átʼéego:Eʼeʼaahjí Tónteel bikáaʼgi Kéyah dah Ndaaʼeełígíí	Categorie:Eiland in de Grote Oceaan
Tʼááłáhági átʼéego:Łóóʼ Bigaan Dahólónígíí	Categorie:Inktvis
Tʼááłáhági átʼéego:Chʼééh digháhii dóó Tsisteeł	Categorie:Schildpad
Tʼááłáhági átʼéego:Béésh	Categorie:Metaal
Tʼááłáhági átʼéego:Naayééʼ	Categorie:Dinosauria
Tʼááłáhági átʼéego:Choyoołʼįįhí pi	Categorie:Wikipedia:Gebruiker pi
Tʼááłáhági átʼéego:Choyoołʼįįhí pl	Categorie:Wikipedia:Gebruiker pl
Tʼááłáhági átʼéego:Chʼosh bikágí dantłʼizí	Categorie:Kreeftachtige
Tʼááłáhági átʼéego:Jaaʼabaní	Categorie:Vleermuis
Tʼááłáhági átʼéego:Tłʼiish	Categorie:Slang
Tʼááłáhági átʼéego:Shádiʼááhjí kéyah yistinígíí	Categorie:Antarctica
Tʼááłáhági átʼéego:Beʼekʼid	Categorie:Meer
Kʼíshíshjį́į́zh	Gifsumak
Bee álnééhí:User sl	Sjabloon:Gebruiker sl
Tʼááłáhági átʼéego:Bįįh	Categorie:Hertachtige
Bee álnééhí:User sw-3	Sjabloon:Gebruiker sw-3
Tʼááłáhági átʼéego:Łóóʼ hashkéhé	Categorie:Haai
Tʼááłáhági átʼéego:Łóóʼ ooshgę́ęzhii	Categorie:Kraakbeenvis
Tʼááłáhági átʼéego:Chidí	Categorie:Auto
Bee álnééhí:User ga-1	Sjabloon:Gebruiker ga-1
Bee álnééhí:User lb	Sjabloon:Gebruiker lb
Bee álnééhí:User af-2	Sjabloon:Gebruiker af-2
Chąąshtʼezhiitsoh	Wortel (groente)
Tʼááłáhági átʼéego:Jeeshóóʼ	Categorie:Gier van de Nieuwe Wereld
Tʼááłáhági átʼéego:Kéyah bił haʼdaʼhaasdzoígíí	Categorie:Bestuurlijke indeling
Kʼish bichʼosh (níłtsą́goʼ)	Rosalia funebris
Tʼááłáhági átʼéego:Łį́į́ʼ Ndahalinígíí	Categorie:Paard
Tʼááłáhági átʼéego:Wóʼatsʼǫǫsii Ádaatʼéhígíí	Categorie:Halfvleugelige
Tʼááłáhági átʼéego:Tsin Deigházhígíí	Categorie:Knaagdier
Bee álnééhí:User hr-2	Sjabloon:Gebruiker hr-2
Bee álnééhí:User sl-1	Sjabloon:Gebruiker sl-1
Tʼááłáhági átʼéego:Choyoołʼįįhí ab	Categorie:Wikipedia:Gebruiker ab
Tʼááłáhági átʼéego:Choyoołʼįįhí ab-3	Categorie:Wikipedia:Gebruiker ab-3
Bee álnééhí:User pl-3	Sjabloon:Gebruiker pl-3
Bee álnééhí:User pl-4	Sjabloon:Gebruiker pl-4
Bee álnééhí:User an-1	Sjabloon:Gebruiker an-1
Bee álnééhí:User vls-3	Sjabloon:Gebruiker vls-3
Bee álnééhí:User vls-2	Sjabloon:Gebruiker vls-2
Bee álnééhí:User vls	Sjabloon:Gebruiker vls
Bee álnééhí:User vi-4	Sjabloon:Gebruiker vi-4
Bee álnééhí:User vi-2	Sjabloon:Gebruiker vi-2
Bee álnééhí:User vi-1	Sjabloon:Gebruiker vi-1
Bee álnééhí:User tt-1	Sjabloon:Gebruiker tt-1
Bee álnééhí:User sw	Sjabloon:Gebruiker sw
Bee álnééhí:User stq-1	Sjabloon:Gebruiker stq-1
Bee álnééhí:User sr-4	Sjabloon:Gebruiker sr-4
Bee álnééhí:User sr-3	Sjabloon:Gebruiker sr-3
Bee álnééhí:User sr-2	Sjabloon:Gebruiker sr-2
Bee álnééhí:User sl-2	Sjabloon:Gebruiker sl-2
Bee álnééhí:User sk-4	Sjabloon:Gebruiker sk-4
Bee álnééhí:User sh-4	Sjabloon:Gebruiker sh-4
Bee álnééhí:User sh-1	Sjabloon:Gebruiker sh-1
Bee álnééhí:User sc-1	Sjabloon:Gebruiker sc-1
Bee álnééhí:User qu-3	Sjabloon:Gebruiker qu-3
Bee álnééhí:User qu-1	Sjabloon:Gebruiker qu-1
Bee álnééhí:User oc-2	Sjabloon:Gebruiker oc-2
Bee álnééhí:User nds-3	Sjabloon:Gebruiker nds-3
Bee álnééhí:User nah-1	Sjabloon:Gebruiker nah-1
Bee álnééhí:User mn-3	Sjabloon:Gebruiker mn-3
Bee álnééhí:User mn-1	Sjabloon:Gebruiker mn-1
Bee álnééhí:User mn	Sjabloon:Gebruiker mn
Bee álnééhí:User mk-2	Sjabloon:Gebruiker mk-2
Bee álnééhí:User mk	Sjabloon:Gebruiker mk
Bee álnééhí:User mg	Sjabloon:Gebruiker mg
Bee álnééhí:User lv-1	Sjabloon:Gebruiker lv-1
Bee álnééhí:User lt-4	Sjabloon:Gebruiker lt-4
Bee álnééhí:User lt-3	Sjabloon:Gebruiker lt-3
Bee álnééhí:User lt-1	Sjabloon:Gebruiker lt-1
Bee álnééhí:User li-4	Sjabloon:Gebruiker li-4
Bee álnééhí:User li-2	Sjabloon:Gebruiker li-2
Bee álnééhí:User lb-3	Sjabloon:Gebruiker lb-3
Bee álnééhí:User la-4	Sjabloon:Gebruiker la-4
Bee álnééhí:User la	Sjabloon:Gebruiker la
Bee álnééhí:User ksh-1	Sjabloon:Gebruiker ksh-1
Bee álnééhí:User jv-3	Sjabloon:Gebruiker jv-3
Bee álnééhí:User it-4	Sjabloon:Gebruiker it-4
Bee álnééhí:User is-4	Sjabloon:Gebruiker is-4
Bee álnééhí:User is-3	Sjabloon:Gebruiker is-3
Bee álnééhí:User io-1	Sjabloon:Gebruiker io-1
Bee álnééhí:User id-2	Sjabloon:Gebruiker id-2
Bee álnééhí:User ia-4	Sjabloon:Gebruiker ia-4
Bee álnééhí:User ia-1	Sjabloon:Gebruiker ia-1
Bee álnééhí:User hr-3	Sjabloon:Gebruiker hr-3
Bee álnééhí:User hi-4	Sjabloon:Gebruiker hi-4
Bee álnééhí:User hi-2	Sjabloon:Gebruiker hi-2
Bee álnééhí:User grc-3	Sjabloon:Gebruiker grc-3
Bee álnééhí:User grc-2	Sjabloon:Gebruiker grc-2
Bee álnééhí:User fi-4	Sjabloon:Gebruiker fi-4
Bee álnééhí:User et-2	Sjabloon:Gebruiker et-2
Bee álnééhí:User et	Sjabloon:Gebruiker et
Bee álnééhí:User el-4	Sjabloon:Gebruiker el-4
Bee álnééhí:User el-3	Sjabloon:Gebruiker el-3
Bee álnééhí:User cy-2	Sjabloon:Gebruiker cy-2
Bee álnééhí:User cy-1	Sjabloon:Gebruiker cy-1
Bee álnééhí:User cy	Sjabloon:Gebruiker cy
Bee álnééhí:User bs-2	Sjabloon:Gebruiker bs-2
Bee álnééhí:User bg-4	Sjabloon:Gebruiker bg-4
Bee álnééhí:User bg-3	Sjabloon:Gebruiker bg-3
Bee álnééhí:User bg-2	Sjabloon:Gebruiker bg-2
Bee álnééhí:User be-3	Sjabloon:Gebruiker be-3
Bee álnééhí:User be-1	Sjabloon:Gebruiker be-1
Bee álnééhí:User tt	Sjabloon:Gebruiker tt
Bee álnééhí:User gl-2	Sjabloon:Gebruiker gl-2
Bee álnééhí:User ro-3	Sjabloon:Gebruiker ro-3
Tʼááłáhági átʼéego:Dlǫ́ʼii yił Aheedaałtʼéhígíí	Categorie:Mangoest
Bee álnééhí:User nds-4	Sjabloon:Gebruiker nds-4
Tʼááłáhági átʼéego:Choyoołʼįįhí lzh-2	Categorie:Wikipedia:Gebruiker lzh-2
Bee álnééhí:User lzh-2	Sjabloon:Gebruiker zh-wen-2
Bee álnééhí:User eu-2	Sjabloon:Gebruiker eu-2
Tʼááłáhági átʼéego:Chʼosh Deildeełii	Categorie:Insecteneter
Tʼááłáhági átʼéego:Táłkáaʼgi Tsídii	Categorie:Anseriformes
Tʼááłáhági átʼéego:Chʼosh bijáád tseebíhígíí	Categorie:Spinachtige
Tʼááłáhági átʼéego:Shash	Categorie:Beer
Tʼááłáhági átʼéego:Tsin deiłkaałii	Categorie:Specht
Tʼááłáhági átʼéego:Tsékooh	Categorie:Kloof
Tó bichʼoshtsoh	Reuzenwaterwantsen
Tʼááłáhági átʼéego:Chʼosh bijáád neeznánígíí	Categorie:Tienpotige
Tʼááłáhági átʼéego:Bílaʼashdlaʼii bilį́į́ʼ danilínígíí	Categorie:Huisdier
Tʼááłáhági átʼéego:Dziil / Atsiniltłʼish álʼį́	Categorie:Energie
Tʼááłáhági átʼéego:Tsʼíʼii dóó Tséʼédǫ́ʼii	Categorie:Tweevleugelige
Tʼááłáhági átʼéego:Tązhii dóó Naaʼahóóhai Ndahalinígíí	Categorie:Hoen
Tʼááłáhági átʼéego:Tééh łééchąąʼí	Categorie:Hyena
Tʼááłáhági átʼéego:Wónitłʼizí	Categorie:Pissebed
Tʼááłáhági átʼéego:Kǫʼ naʼałbąąsii ninádaaltłiʼígi	Categorie:Spoorwegstation
Tʼááłáhági átʼéego:Daʼałtʼoʼígíí biyęęzhii deiłchíhígíí	Categorie:Cloacadier
Tʼááłáhági átʼéego:Nahachagii dóó Nahakʼízii	Categorie:Rechtvleugelige
Tʼááłáhági átʼéego:Chéłchaaʼ bigaantéłígíí	Categorie:Bladsprietkever
Tʼááłáhági átʼéego:Tábąąsdísí	Categorie:Strandlopers en snippen
Tʼááłáhági átʼéego:Séigoʼ	Categorie:Schorpioen (dier)
Tʼááłáhági átʼéego:Táłtłʼááhdę́ę́ʼ dóó tónteel biyiʼdę́ę́ʼ chʼiyáán	Categorie:Voedsel uit de zee
Tʼááłáhági átʼéego:Tsin naaʼeeł	Categorie:Schip
Tʼááłáhági átʼéego:Naʼashjéʼii	Categorie:Spin
Tʼááłáhági átʼéego:Jááłánii	Categorie:Duizendpotige
Tʼááłáhági átʼéego:Bisóodi	Categorie:Varken
Tʼááłáhági átʼéego:Choyoołʼįįhí pfl	Categorie:Wikipedia:Gebruiker pfl
Tʼááłáhági átʼéego:Choyoołʼįįhí kg-1	Categorie:Wikipedia:Gebruiker kg-1
Tʼááłáhági átʼéego:Azeeʼ	Categorie:Medicinale plant
Tʼááłáhági átʼéego:Choyoołʼįįhí nl-4	Categorie:Wikipedia:Gebruiker nl-4
Tʼááłáhági átʼéego:Naʼastsʼǫǫsí dóó Łéʼétsoh	Categorie:Muridae
Bee álnééhí:User cs-2	Sjabloon:Gebruiker cs-2
Bee álnééhí:Image label begin	Sjabloon:Afbeelding label begin
Tʼááłáhági átʼéego:Yootó Hahoodzodi kin naaznilígíí	Categorie:Plaats in New Mexico
Tʼááłáhági átʼéego:Choyoołʼįįhí lzh	Categorie:Wikipedia:Gebruiker lzh
Tʼááłáhági átʼéego:Choyoołʼįįhí nds-nl-N	Categorie:Wikipedia:Gebruiker nds-nl-M
Tʼááłáhági átʼéego:Choyoołʼįįhí vls-4	Categorie:Wikipedia:Gebruiker vls-4
Tʼááłáhági átʼéego:Choyoołʼįįhí fa-4	Categorie:Wikipedia:Gebruiker fa-4
Bee álnééhí:User nn-3	Sjabloon:Gebruiker nn-3
Bee álnééhí:User vi	Sjabloon:Gebruiker vi
Tʼááłáhági átʼéego:Choyoołʼįįhí en-1	Categorie:Wikipedia:Gebruiker en-1
Tʼááłáhági átʼéego:Choyoołʼįįhí de-1	Categorie:Wikipedia:Gebruiker de-1
Tʼááłáhági átʼéego:Choyoołʼįįhí da-N	Categorie:Wikipedia:Gebruiker da-M
Tʼááłáhági átʼéego:Choyoołʼįįhí gl-2	Categorie:Wikipedia:Gebruiker gl-2
Tʼááłáhági átʼéego:Choyoołʼįįhí or	Categorie:Wikipedia:Gebruiker or
Tłʼiish áníní	Ratelslangen
Yaaʼ bijáád tseebíhígíí	Teken (dieren)
Bee álnééhí:User vls-1	Sjabloon:Gebruiker vls-1
Hatinídę́ę́ʼ tsídiiłgaii	IJshoenders
Dahsání	Oerzon
Tsiiyázhí (dééł)	Psophia
Bee álnééhí:User nl-4	Sjabloon:Gebruiker nl-4
Bee álnééhí:User nn-1	Sjabloon:Gebruiker nn-1
Bee álnééhí:User lt-2	Sjabloon:Gebruiker lt-2
Bee álnééhí:User ru-3	Sjabloon:Gebruiker ru-3
Bee álnééhí:User be-4	Sjabloon:Gebruiker be-4
Bee álnééhí:User az-1	Sjabloon:Gebruiker az-1
Bee álnééhí:User nl-3	Sjabloon:Gebruiker nl-3
Bee álnééhí:User nn	Sjabloon:Gebruiker nn
Bee álnééhí:User az-4	Sjabloon:Gebruiker az-4
Bee álnééhí:User bar	Sjabloon:Gebruiker bar
Bee álnééhí:User li	Sjabloon:Gebruiker li
Bee álnééhí:User bar-2	Sjabloon:Gebruiker bar-2
Bee álnééhí:User fy	Sjabloon:Gebruiker fy
Bee álnééhí:User sv-4	Sjabloon:Gebruiker sv-4
Bee álnééhí:User nds-nl-1	Sjabloon:Gebruiker nds-nl-1
Bee álnééhí:User hi	Sjabloon:Gebruiker hi
Bee álnééhí:User hu-2	Sjabloon:Gebruiker hu-2
Bee álnééhí:User hr-4	Sjabloon:Gebruiker hr-4
Bee álnééhí:User sw-2	Sjabloon:Gebruiker sw-2
Bee álnééhí:User als-3	Sjabloon:Gebruiker als-3
Bee álnééhí:User bar-3	Sjabloon:Gebruiker bar-3
Bee álnééhí:User th-2	Sjabloon:Gebruiker th-2
Bee álnééhí:User sh-2	Sjabloon:Gebruiker sh-2
Bee álnééhí:User hu-3	Sjabloon:Gebruiker hu-3
Bee álnééhí:User ga-3	Sjabloon:Gebruiker ga-3
Bee álnééhí:User vi-3	Sjabloon:Gebruiker vi-3
Bee álnééhí:User id-1	Sjabloon:Gebruiker id-1
Bee álnééhí:User vls-4	Sjabloon:Gebruiker vls-4
Tsídiidaatsohí	Pelikanen
Akétłʼóól łichxííʼí yázhí	Tuinradijs
Tsé nahalinii (łóóʼ)	Synanceia
Tʼááłáhági átʼéego:Choyoołʼįįhí als-4	Categorie:Wikipedia:Gebruiker als-4
Special:RecentChanges	Speciaal:RecenteWijzigingen
Tʼááłáhági átʼéego:Choyoołʼįįhí ja-4	Categorie:Wikipedia:Gebruiker ja-4
Ábishjaaʼ łóóʼ	Dendrogramma
