Afrika	Afrika
Jabaan	Japan
Ameerikada koonfureed	Zuid-Amerika
Norway	Noorwegen
Ingiriiska	Engeland
Skotland	Schotland
Waalis	Wales
Waqooyiga Ayrland	Noord-Ierland
Ireland	Ierland (land)
Hungaria	Hongarije
Isbania	Spanje
Mareykanka	Verenigde Staten
Beljim	België
Luksemburg	Luxemburg (land)
Koon	Heelal
Dhul	Aarde (planeet)
Nolosha	Leven
Biniaadan	Mens
George Washington	George Washington
Finland	Finland
Iswiidhan	Zweden
Denmark	Denemarken
Boland	Polen
Lithuaniya	Litouwen
Talyaaniga	Italië
Iswisarland	Zwitserland
Austriya	Oostenrijk
Giriig	Griekenland
Turkiga	Turkije
Bortuqaal	Portugal
Yurub	Europa (werelddeel)
Aasiya	Azië
Woqooyiga Ameerika	Noord-Amerika
Antiarktis	Antarctica
Wikipedia	Wikipedia
Holland	Nederland
New York	New York City
Washington D.C	Washington D.C.
Baarliin	Berlijn
Los Angeles	Los Angeles
Boeing	Boeing
Kumbuyuutar	Computer
Jineefa	Genève (stad)
Internet	Internet
Barack Obama	Barack Obama
Uruguay	Uruguay
London	Londen
Qaahiro	Caïro (stad)
Baariis	Parijs
Android	Android (besturingssysteem)
Google	Google Inc.
Meksiko	Mexico (land)
Badweynta Atlaantik	Atlantische Oceaan
Badweynta Baasifik	Grote Oceaan
Kalifornia	Californië
Isniin	Maandag
Janaayo	Januari
Febraayo	Februari
Maarso	Maart
Farraare	Mars (planeet)
Kiinya	Kenia
Itoobiya	Ethiopië
Gaana	Ghana
Abriil	April
May	Mei
Juun	Juni
Luuliyo	Juli
Agoosto	Augustus (maand)
Sebteembar	September
Oktoobar	Oktober
Nofeembar	November
Diseembar	December
Talaado	Dinsdag
Arbaco	Woensdag
Khamiis	Donderdag
Jimco	Vrijdag
Sabti	Zaterdag
Axad	Zondag
Libaax	Leeuw (dier)
Faransiiska	Frankrijk
Esberanto	Esperanto
Ey	Hond
Midowga boqortooyada Britan	Verenigd Koninkrijk
Yaanyuur	Kat (dier)
Shiinaha	Volksrepubliek China
Af-Faransiis	Frans
Malaay	Vissen (dieren)
Khamri	Alcoholische drank
Barasiil	Brazilië
François Hollande	François Hollande
Ruushka	Rusland
Nibiri	Walvisachtigen
Labajibaarane	Vierkant (meetkunde)
Bad	Zee
Bada madaw	Zwarte Zee
Pi Sumad xisaabeed	Pi (wiskunde)
Wiki	Wiki
Toronto	Toronto
Alabama	Alabama
São Paulo	São Paulo (stad)
São Paulo (Gobol)	São Paulo (staat)
Wikimedia	Wikimedia Foundation
Jimmy Wales	Jimmy Wales
Jarmalka	Duitsland
Belarus	Wit-Rusland
Af-Jarmal	Duits
Island	IJsland
Estoniya	Estland
David Cameron	David Cameron
Raage	Saturnus (planeet)
Chocolate	Chocolade
Dagaalada	Oorlog
Kow	1 (getal)
Labo	2 (getal)
Sadax	3 (getal)
Afar (lambar)	4 (getal)
Shan	5 (getal)
0	0 (getal)
George W. Bush	George W. Bush
Laydi	Rechthoek
Latfiya	Letland
Ukrain	Oekraïne
Jamhuuriyadda Tashik	Tsjechië
Islofaakiya	Slowakije
Isloveeniya	Slovenië
Moldofa	Moldavië (land)
Romania	Roemenië
Bulgaria	Bulgarije
Roma	Rome (stad)
Jamhuriyada Makedonia	Macedonië (land)
Albania	Albanië
Griinland	Groenland
Kroatia	Kroatië
Bosniya	Bosnië en Herzegovina
Aserbiijaan	Azerbeidzjan
Andorra	Andorra
Jasiirada Qabrus	Cyprus
Joorjiya	Georgië
Kasakhstan	Kazachstan
Malta	Malta (land)
Monako	Monaco
Montenegro	Montenegro
Faatikan	Vaticaanstad
San Marino	San Marino
Boroksel	Brussel (stad)
Kuuba	Cuba (land)
Belise	Belize (land)
Barbados	Barbados
Indunisiya	Indonesië
Wolfgang Amadeus Mozart	Wolfgang Amadeus Mozart
Af-Turki	Turks
Koonfur Afrika	Zuid-Afrika
Aljeeriya	Algerije
Usbekistan	Oezbekistan
Biyo	Water
Alwaax	Hout
Telefishin	Televisie
Claude Monet	Claude Monet
Diego Velázquez	Diego Velázquez (kunstschilder)
Jili	Chili
El Greco	El Greco
Ciise	Jezus (traditioneel-christelijk)
Dusaa	Mercurius (planeet)
Taariikh	Geschiedenis
Apple Inc	Apple Inc.
Waxaraxir	Venus (planeet)
Jaceyl	Liefde
Cirjeex	Jupiter (planeet)
Uraano	Uranus (planeet)
Nicolas Sarkozy	Nicolas Sarkozy
Nebtuun	Neptunus (planeet)
Xiddigis	Astronomie
Singabuur	Singapore
Saynis	Wetenschap
Buluuto	Pluto (dwergplaneet)
Liechtenstein	Liechtenstein
Ciyaaraha	Sport
Adolf Hitler	Adolf Hitler
Facebook	Facebook
Julian Assange	Julian Assange
Dagaalkii koowaad	Eerste Wereldoorlog
Dagaalkii Labaad ee Aduunka	Tweede Wereldoorlog
Goorsheegto	Klok (tijd)
Linux	Linux
Xisaab	Wiskunde
Af-Laatiin	Latijn
Baxrayn	Bahrein
Armania	Armenië
Seerbiya	Servië
Bil	Maan
Istanbuul	Istanboel
Australia	Australië (land)
Fiisigis	Natuurkunde
Arjantiina	Argentinië
Isgaarsiinta	Telecommunicatie
Peru	Peru
Bayoloji	Biologie
Waqooyiga Kuuriya	Noord-Korea
Kambodiya	Cambodja
Qur'aan	Koran
Diinsoor (xayawaan)	Dinosauriërs
Islaam	Islam
Ljubljana	Ljubljana
World Wide Web	Wereldwijd web
Naag	Vrouw
Gabay	Poëzie
Chernobyl	Kernramp van Tsjernobyl
Milan	Milaan (stad)
Torino	Turijn (stad)
Liin dhanaan	Citroen (vrucht)
Moos	Banaan (vrucht)
Ubax	Bloem (plant)
Magaalo	Stad
Napoleon Bonaparte	Napoleon Bonaparte
Xidig	Ster (hemellichaam)
Qorax	Zon
Cir	Hemelgewelf
Tuulo	Dorp
Ooshiyaaniya	Oceanië
Bahda Midaysay Qoraxdu	Zonnestelsel
Ilig	Tand
Hydrogen	Waterstof (element)
Hiliyaam	Helium
Ilik	Tand (mens)
Cadaab	Hel (mythologie)
Wikimedia Commons	Wikimedia Commons
Liithiyaam	Lithium (element)
Beriiliyaam	Beryllium
Buug	Boek (document)
Maalin	Dag
Bariga Timor	Oost-Timor
Sanad	Jaar
Qarni	Eeuw
Oslo	Oslo
Lissabon	Lissabon
Dubay	Dubai (emiraat)
Lionel Messi	Lionel Messi
Booron	Boor (element)
Versailles	Versailles
Kaarboon	Koolstof
Nitrojiin	Stikstof (element)
Ogsajiin	Zuurstof (element)
FC Internazionale Milano	FC Internazionale Milano
Meere	Planeet
Muusig	Muziek
Moskow	Moskou
Foloriin	Fluor (element)
Af-Taliyaani	Italiaans (taal)
Niyoon	Neon (element)
Saint Petersburg	Sint-Petersburg
Jad	Tsjaad
Sodhiyaam	Natrium
Woqooyi	Noord (windstreek)
Magniisiyaam	Magnesium
Alumiiniyaam	Aluminium
New Zealand	Nieuw-Zeeland
Koonfur	Zuid
Hindiya	India
Silikoon	Silicium
Faransiyaam	Francium
Tuvalu	Tuvalu
Fosforos	Fosfor
Xadiid	IJzer (element)
Galbeed	West
Salfar	Zwavel
Bari (Jiho)	Oost (windstreek)
Jasiiradaha Solomon	Salomonseilanden
Koloriin	Chloor (element)
Koofurta Holland	Zuid-Holland
Balau	Palau (land)
Aargon	Argon
Nawru	Nauru
Firefox	Mozilla Firefox
Waqooyiga Holland	Noord-Holland
Botashiyaam	Kalium
Zeeland	Zeeland (provincie)
Kaalshiyaam	Calcium
Flevoland	Flevoland
Lead	Lood (element)
Jasiirada Marshall	Marshalleilanden
Kiribati	Kiribati
Mongolia	Mongolië
Fiji	Fiji
Iskaandhiyaam	Scandium
Titaaniyaam	Titanium
Fanansuwela	Venezuela
Jinkis Khan	Dzjengis Khan
Fanadhiyaam	Vanadium
Koroomiyaam	Chroom (element)
Faras	Paard (dier)
Amistardam	Amsterdam
Hub	Gevechtswapen
Xayawaan	Dierenrijk
Surinam	Suriname
Manganiis	Mangaan
Paraguay	Paraguay
Guyana	Guyana
Fan	Kunst
Ikwadoor	Ecuador
Reheniyaam	Renium
Kolombiya	Colombia
Kobalti	Kobalt
Tungsten	Wolfraam
Nikel	Nikkel
Boliifia	Bolivia
Osmiyaam	Osmium
Groningen	Groningen (provincie)
Kober	Koper (element)
Beer	Planten
Sinki	Zink (element)
Leonardo da Vinci	Leonardo da Vinci
Boqoshaa	Schimmels
Jamayka	Jamaica
Friesland	Friesland
Drenthe	Drenthe
Overijssel	Overijssel
Guatemala	Guatemala
Gelderland	Gelderland
Utrecht	Utrecht (provincie)
Bahamas	Bahama's
Dooro	Kip (vogel)
Antigua iyo Barbuda	Antigua en Barbuda
Hawaay	Hawaï
Dominika	Dominica
Doofaar	Varken (tam)
Haiti	Haïti
El Salfador	El Salvador
Iiraan	Iran
Ciraaq	Irak
Xikmad	Wijsheid (deugd)
Kosta Rika	Costa Rica
Israaiil	Israël
Magaalada Utrecht	Utrecht (stad)
Banama	Panama (land)
Yemen	Jemen
Virus	Virus (biologie)
Urdun	Jordanië
Nikaragua	Nicaragua
Florida	Florida (staat)
Qargistan	Kirgizië
Kuwayt	Koeweit
Laos	Laos
Lubnaan	Libanon
Jasiirada Maldiif	Maldiven
Ameerika	Amerika (continent)
Lo'	Rund
Malaysiya	Maleisië
Burma	Myanmar
Nebal	Nepal
Cumaan	Oman
Bakistaan	Pakistan
Qatar	Qatar
Ciyaarta Teeniska	Tennis
Sacuudi Carabiya	Saoedi-Arabië
Siri Lanka	Sri Lanka
Suuriya	Syrië
Gaaliyaam	Gallium
Tadsjikistan	Tadzjikistan
Pokemon	Pokémon
Taywan	Taiwan
YouTube	YouTube
Jermaaniyaam	Germanium
Tayland	Thailand
Tareen	Trein
Aarsenik	Arseen
Turkmenistan	Turkmenistan
Seleniyaam	Seleen
Iridiyaam	Iridium (element)
Imaaraatka Carabta	Verenigde Arabische Emiraten
Boromiin	Broom (element)
Balatiniyaam	Platina
Fiyetnam	Vietnam
Charlie Chaplin	Charlie Chaplin
Koonfur Kuuriya	Zuid-Korea
Kiribtoon	Krypton (element)
Afgaanistan	Afghanistan
Gangnam Style	Gangnam Style
Rubiidhiyaam	Rubidium
Dahab	Goud
Kanaalka Suweys	Suezkanaal
Bangladesh	Bangladesh
Maali	Mali
Sokrades	Socrates (filosoof)
Angola	Angola
Butaan	Bhutan
Twitter	Twitter
Barunay	Brunei
Tansaaniya	Tanzania
Meerkuri	Kwik
Roald Amundsen	Roald Amundsen
Harry Mulisch	Harry Mulisch
Filibiin	Filipijnen
Jamhuuriyadda Bartamaha Afrika	Centraal-Afrikaanse Republiek
Cirifka Koonfur	Zuidpool
Cirifka waqooyi	Noordpool
Isxaaq Newton	Isaac Newton
Albert Einstein	Albert Einstein
Istoroontiyaam	Strontium
Itriyaam	Yttrium
Bismuth	Bismut
Jaale	Geel (kleur)
Togo	Togo
Tunisiya	Tunesië
Saambiya	Zambia
Simbaabwi	Zimbabwe
Beijing	Peking
Koonfur Suudaan	Zuid-Soedan
Benin	Benin
Botswana	Botswana
Burkina Faso	Burkina Faso
Burundi	Burundi
Komoros	Comoren
Jamhuuriyadda Kongo	Congo-Brazzaville
Jamhuuriyada Dimuqaraadiga Kongo	Congo-Kinshasa
Jabuuti	Djibouti (land)
Boloniyaam	Polonium
Ikweetiga Guinea	Equatoriaal-Guinea
Eratareya	Eritrea
New Delhi	New Delhi
Ilmo	Baby
Astatiin	Astaat
Gabon	Gabon
Mahatma Gandhi	Mohandas Karamchand Gandhi
Gambia	Gambia (land)
Guinea	Guinee
Guinea-Bissau	Guinee-Bissau
Xeebta Foolmaroodi	Ivoorkust
Kamiruun	Kameroen
Kab Ferde	Kaapverdië
Lesotho	Lesotho
Liberia	Liberia
Libiya	Libië
Madagaskar	Madagaskar
Malaawi	Malawi
Mauritania	Mauritanië
Mauritius	Mauritius (land)
Marooko	Marokko
Musanbiig	Mozambique
Nambiya	Namibië
Nayjar	Niger (land)
Nayjeeriya	Nigeria
Yugandha	Oeganda
Ruwanda	Rwanda
Sirkooniyaam	Zirkonium
Sao Tome iyo Prinsipe	Sao Tomé en Principe
Sinigaal	Senegal
Seyshelles	Seychellen
Sierra Leone	Sierra Leone
Soomaaliya	Somalië
Niyobiyaam	Niobium
Julius Caesar	Julius Caesar
Suudaan	Soedan
Swasiland	Swaziland
Qaansa Roobaad	Regenboog (optica)
Molybdenum	Molybdeen
Teknetiyaam	Technetium
Qaramada Midoobay	Verenigde Naties
Juquraafi	Aardrijkskunde
Wadno	Hart
Maskax	Hersenen
Maqaar	Huid
Midab	Kleur
Rutheniyaam	Ruthenium
Roodhiyaam	Rhodium
Baluug	Blauw (kleur)
Baladiyaam	Palladium (element)
Naxaas	Zilver
Kaadmiyaam	Cadmium
Limburg	Limburg (Nederland)
Tin (curiye)	Tin (element)
Antimony	Antimoon
Teluriyaam	Telluur
Waqooyiga Brabant	Noord-Brabant
Aaydhiin	Jodium (element)
Siinoon	Xenon
Kaasiyaam	Cesium
Baariyaam	Barium
Haafniyaam	Hafnium
Aktiiniyaam	Actinium
Tantalum	Tantaal
Bill Clinton	Bill Clinton
Raadhiyaam	Radium
Raadhoon	Radon (element)
Lorraine	Lotharingen (Frankrijk)
Buerto Riko	Puerto Rico
Niedersachsen	Nedersaksen
Lombardia	Lombardije
Qudus	Jeruzalem
Rutherfordium	Rutherfordium
Dubniyaam	Dubnium
Siiborgiyaam	Seaborgium
Badweynta Hindiya	Indische Oceaan
Kosofo	Kosovo
Badda Karabiya	Caraïbische Zee
Bohriyaam	Bohrium
Hasiyaam	Hassium
Meitneriyaam	Meitnerium
Darmstadtiyaam	Darmstadtium
Roentgeniyaam	Röntgenium
Dortmund	Dortmund
Ununtriyaam	Ununtrium
Lifermoriyaam	Livermorium
Ununoktiyaam	Ununoctium
Maastricht	Maastricht
Jiilaal	Winter
Gu	Lente
Xagaa	Zomer
Dayr	Herfst
Sadaam Xuseen	Saddam Hoessein
Usaama bin Laadin	Osama bin Laden
Caarcaaro	Spinnen (dieren)
Miro	Vrucht (plant)
Lacagta	Geld
Xasharaad	Insecten
Faladimir Lenin	Vladimir Lenin
Uetersen	Uetersen
Augustus Octavian	Imperator Caesar Augustus
Microsoft Windows	Microsoft Windows
Jibraltaar	Gibraltar
Nokia	Nokia (bedrijf)
Baabuur	Auto
Juventus FC	Juventus FC
Texas	Texas (staat)
Bruno Mars	Bruno Mars
Sasiiliya	Sicilië
Sardiiniya	Sardinië
Fuuqbax	Ziekte van Crohn
Buenos Aires	Buenos Aires (stad)
Tokyo	Tokio
Barcelona	Barcelona (Spanje)
Abidjan	Abidjan
Minnesota	Minnesota
Baqdaad	Bagdad
Isuduwaha Waqtiga Caalamiga	UTC
AC Milan	AC Milan
Buuri	Tabak
Internet Explorer	Internet Explorer
Sigaar	Sigaret
Nayl armistaroong	Neil Armstrong
Maxamed Faarax	Mohammed Farah
München	München
Fiyena	Wenen
Kobanhaygan	Kopenhagen
Stockholm	Stockholm
Helsinki	Helsinki
Dublin	Dublin
Bratislava	Bratislava
Budapest	Boedapest
Frankfurt	Frankfurt am Main
Lanthanum	Lanthaan
Kitaabka quduska	Bijbel (christendom)
Phnom Penh	Phnom Penh
Ho Chi Minh City	Ho Chi Minhstad
Luteetiyaam	Lutetium
Mida Rumeed Kaniisada Ciise	Ware Jezuskerk
Ingiriis (luqad)	Engels
Bangkok	Bangkok
Dong Hoi	Đồng Hới
Concepción	Concepción (Chili)
Franck Ribéry	Franck Ribéry
Ottawa	Ottawa (stad)
Dayaxa Cirjeex	Lijst van manen van Jupiter
Juba	Djoeba
Końskowola	Końskowola
Dar es Salaam	Dar es Salaam (stad)
Khartuum	Khartoem
Dayaxa raage	Manen van Saturnus
2000	2000
2003	2003
2002	2002
2001	2001
2012	2012
2011	2011
2010	2010
2009	2009
2013	2013
2014	2014
2008	2008
2004	2004
2005	2005
2006	2006
2007	2007
1900	1900
1901	1901
Charles De Gaulle	Charles de Gaulle
1906	1906
1908	1908
1909	1909
1992	1992
1991	1991
1990	1990
1993	1993
1994	1994
1995	1995
1996	1996
1910	1910
1911	1911
1912	1912
1913	1913
1914	1914
1997	1997
1998	1998
1999	1999
1918	1918
Cunto	Voedsel
Mas	Slangen
Dayaxa docay	Manen van Neptunus
Dashiishe	1 januari
1920	1920
1919	1919
1921	1921
Georges Pompidou	Georges Pompidou
Malmö	Malmö (stad)
Birmingham	Birmingham (Verenigd Koninkrijk)
Microsoft	Microsoft
Borotoon	Proton (deeltje)
Kurów	Kurów (powiat Puławski)
Kimisteri	Scheikunde
Robin van Persie	Robin van Persie
27	27
1989	1989
1988	1988
1987	1987
1986	1986
1985	1985
1984	1984
1983	1983
1982	1982
1981	1981
1980	1980
Muqdisho	Mogadishu
Sana'a	Sanaa
1970	1970
1971	1971
1972	1972
1973	1973
1974	1974
1975	1975
1976	1976
1977	1977
1978	1978
1979	1979
1969	1969
18 Abriil	18 april
25 Abriil	25 april
26 Abriil	26 april
Dayax	Natuurlijke maan
Kristian Wulff	Christian Wulff
15 Meey	15 mei
SSC Napoli	SSC Napoli
1968	1968
1967	1967
1966	1966
1965	1965
1964	1964
27 Juun	27 juni
Kubadda Cagta	Voetbal
AS Roma	AS Roma
1963	1963
Holokost	Holocaust
1962	1962
Michael Jackson	Michael Jackson
Bogota	Bogota (stad)
29 Diseembar	29 december
Quito	Quito
Adhi	Geit
21 Oktoobar	21 oktober
Paramaribo	Paramaribo
Wiil	Jongen
Gabar	Meisje
Kanbera	Canberra
Sydney	Sydney
Cagaar	Groen (kleur)
Gaduud	Rood (kleur)
Perth	Perth (Australië)
Galbeed Australia (gobol)	West-Australië
New South Wales	Nieuw-Zuid-Wales
Wabiga Niil	Nijl
Jini	Djinn (mythisch wezen)
Wabiga Nijer	Niger (rivier)
Rabat	Rabat (Marokko)
Algiers	Algiers
Tunis	Tunis
Triboli	Tripoli (Libië)
Rede Globo	Rede Globo
Jabuuti (magaalo)	Djibouti (stad)
Tahraan	Teheran
Addis Abeba	Addis Abeba
Ankara	Ankara
Asmara	Asmara
Nijamiina	Ndjamena
Niamey	Niamey
Nawakshot	Nouakchott (stad)
1961	1961
Bamako	Bamako
Belgaraad	Belgrado
Dakar	Dakar
Banjul	Banjul
Konakri	Conakry
Bissau	Bissau (Guinee-Bissau)
Category:Template	Categorie:Wikipedia:Sjablonen
Monrofia	Monrovia (Liberia)
Braia	Praia
1960	1960
Akara	Accra
Dimishiq	Damascus
Yamoussoukro	Yamoussoukro
Faransiis Guyana	Frans-Guyana
Ougadougou	Ouagadougou
Freetown	Freetown
Abuja	Abuja
Lome	Lomé
Borto-Novo	Porto-Novo
Yawunde	Yaoundé
Malabo	Malabo
Librefille	Libreville
Bangui	Bangui (Centraal-Afrikaanse Republiek)
Kinshasa	Kinshasa
Barasafille	Brazzaville
Bujumbura	Bujumbura
Kigali	Kigali (stad)
Dodoma	Dodoma (stad)
Nayroobi	Nairobi
Lilongwe	Lilongwe (stad)
Lusaka	Lusaka (stad)
Qorax madoobaad	Zonsverduistering
Mabuto	Maputo (stad)
Kambaala	Kampala
Luanda	Luanda (stad)
Moroni	Moroni (Comoren)
Mabane	Mbabane
Maseru	Maseru (stad)
Dugsi	School (instelling)
Antananarifo	Antananarivo (stad)
Jaamacad	Universiteit
Gaborone	Gaborone
Harare	Harare
Pretoria	Pretoria
Bort Lois	Port Louis (stad)
Sao Tome	Sao Tomé (stad)
Windhoek	Windhoek
Wikipedia:Bacaadka	Wikipedia:Zandbak
Fiktoria	Victoria (Seychellen)
Guri	Huis (woning)
Kombuyuuterka Dhabta	Laptop
Computer Hardware	Hardware
Aljebra	Algebra
Webiyada	Rivier
Osasko	Osasco (Brazilië)
Garoonka ee Dong Hoi	Luchthaven Đồng Hới
Curitiba	Curitiba (gemeente)
Pangea	Pangea
Keyn	Bos (vegetatie)
Anne Frank	Anne Frank
Shilin Soomaali	Somalische shilling
Confucius	Confucius
Category:Taariikhda Ciraaq	Categorie:Geschiedenis van Irak
Corbin Bleu	Corbin Bleu
Category:Xisaab	Categorie:Wiskunde
Jasiiradaha Feroe	Faeröer
Maxamed Morsi	Mohamed Morsi
Euro	Euro
Bada Dhexe	Middellandse Zee
Masiixiyad	Christendom
Windows 8	Windows 8
Template:Dalalka Aasiya	Sjabloon:Navigatie landen Azië
Bariis	Rijst
Céline Dion	Céline Dion
Qaaradaha	Continent
Adelaide	Adelaide (Australië)
Shimbir	Vogels
Bilaha	Maand
Mustafa Kemal Atatürk	Mustafa Kemal Atatürk
1948	1948
Jeejniya	Tsjetsjenië
1949	1949
Garoosni	Grozny
1956	1956
1941	1941
1945	1945
1958	1958
1926	1926
1947	1947
1944	1944
1952	1952
Bill Gates	Bill Gates
Encyclopedia	Encyclopedie
DVD	Dvd
Bogga Hore	Hoofdpagina
CPU	Processor (computer)
1959	1959
Dhesibel	Decibel (eenheid)
Kubadda Koleyga	Basketbal
Kab town	Kaapstad
Bada Qaswiin	Kaspische Zee
Harta Fiktooriya	Victoriameer
Harada malaawi	Malawimeer
Salvador Dalí	Salvador Dalí
Finsent van Gogh	Vincent van Gogh
Hokusai	Katsushika Hokusai
Mishelangelo	Michelangelo Buonarroti
Bablo bekaso	Pablo Picasso
Rembrandt van Rijn	Rembrandt van Rijn
Eminem	Eminem
Bas	Autobus
Baabiyloon	Babylon (stad)
Katalooniya	Catalonië
Samarqanda	Samarkand (plaats)
Bukhaara	Buchara (stad)
Mekka	Mekka
Che Guvara	Che Guevara
Mao Zedong	Mao Zedong
Kabul	Kabul (stad)
Luqada Tamil-ka	Tamil
Filasoofiyada	Filosofie
50 Cent	50 Cent
Dr. Dre	Dr. Dre
Snoop Dogg	Snoop Dogg
Shaax	Thee (drank)
Tupac Shakur	Tupac Shakur
1507	1507
Shuuciyad	Communisme
Amadeyo afogadro	Constante van Avogadro
Liberalinimo	Liberalisme
Wadan	Land (geografie)
Qaran	Natie
Jow Bayden	Joe Biden
Hillary Clinton	Hillary Clinton
Category:Xiddigis	Categorie:Astronomie
1542	1542
1543	1543
Jaan Jaak Rosoo	Jean-Jacques Rousseau
Saxaara	Sahara
Hambeegar	Hamburger
1606	1606
Maktabad	Bibliotheek (algemeen)
FC Barcelona	FC Barcelona
Midowga afrika	Afrikaanse Unie
Siyaasadda,	Politiek
Jaamacada Carabta	Arabische Liga
Dimoqraadi	Democratie
Hay'ada laanqayrta cas	Rode Kruis
Gaashaanbuurta NATO	Noord-Atlantische Verdragsorganisatie
Qin Shi Huang	Qin Shi Huangdi
Bariga Dhexe	Midden-Oosten
Jamhuriyadda	Republiek
Hantiwadaag	Socialisme
Dowlad	Staat
Xisbi	Politieke partij
Kilimanjaaro	Kilimanjaro (berg)
Kristoffer Kolombus	Christoffel Columbus
Rixlaat Ibn Batuuta	Ibn Battuta
Kanaalka Banama	Panamakanaal
Dheg	Oor
San	Neus
Muruq	Spier (anatomie)
Hees	Lied
Kaneeco	Steekmuggen
Libaax Badeed	Haaien
Geel	Kamelen
Naasley	Zoogdieren
Maroodi	Olifanten
Quraansho	Mieren
Shini	Bijen
Software	Software
Af-Holandees	Nederlands
DNA	Desoxyribonucleïnezuur
Nuucyada dhirta	Soort
Hooyo	Moeder
Aabe	Vaderschap
Waalid	Ouder
Gaadiidka Dadweynaha	Vervoer
Debian	Debian
1669	1669
1670	1670
1671	1671
1672	1672
1673	1673
1674	1674
1675	1675
1676	1676
1677	1677
1678	1678
1679	1679
1680	1680
1856	1856
Af-Ruush	Russisch
Faladimir Putin	Vladimir Poetin
Dastuur	Grondwet
Dalalka Kommonwels	Gemenebest van Naties
OPEC	Organisatie van olie-exporterende landen
Rooti	Brood
UNESCO	UNESCO
Baaqa Caalamiga ee Xuquuqda Aadanaha	Universele verklaring van de rechten van de mens
1796	1796
1797	1797
1899	1889
Sawaaxili	Swahili
1893	1893
Unug	Cel (biologie)
Dhiig	Bloed
Qolfoof	Skelet
Sambab	Long (orgaan)
Hab Neefsi	Ademhalingsstelsel
Habdhiska Taranka	Voortplantingssysteem
Af-Romani	Roemeens
Roob	Regen (neerslag)
Dhulgariir	Aardbeving
Ibn Siinaa	Avicenna
Nelson Mandela	Nelson Mandela
Martin Luther King,	Martin Luther King
Ensiim	Enzym
Borotiin	Proteïne
Daad	Overstroming
Tsunami	Tsunami
Fulkaano	Vulkaan
Caad	Wolk
Tirignoometeri	Goniometrie
Joomitiri	Meetkunde
Qarnigii 2aad	2e eeuw
Qarnigii 1aad	1e eeuw
Dhaqaale	Economie
Warshad	Industrie
Farta laatiinka	Latijns alfabet
Suugaan	Literatuur
Category:Faransiiska	Categorie:Frankrijk
Category:Muusig	Categorie:Muziek
Kun Habeen Iyo Habeen	Duizend-en-een-nacht
Category:Suugaanta	Categorie:Literatuur
Category:Gabayada	Categorie:Dichtkunst
Waxbarasho	Onderwijs
Qoys	Familie (verwanten)
Hugo Chavez	Hugo Chávez
Nin	Man (geslacht)
Guur	Huwelijk
Midab Takoor	Racisme
Adoon	Slavernij
Dagaal Sokeeye	Burgeroorlog
Cumar	Omar ibn al-Chattab
Suldaan Suleymaan kan 1aad	Süleyman I
Bun	Koffie
Caano	Melk (drank)
Buur	Berg (landvorm)
Salaaxudiin al-Ayyuubi	Saladin
Karaaji	Karachi
Riyaal Madrid	Real Madrid CF
Dagaalkii qaboobaa	Koude Oorlog
Seoul	Seoel
Tomas Edison	Thomas Edison
Michael Faraday	Michael Faraday
Internet protocol	Internetprotocol
HTML	HyperText Markup Language
Af-Iswiidhan	Zweeds
Muxamed bin Muuse al-Khwarizmī	Al-Chwarizmi
Karl Marx	Karl Marx
Nabi Muuse C.S.	Mozes
Aqoon	Kennis
Naas	Borst
Atom	Atoom
Ileys	Licht
Af Giriig	Grieks
Operating system	Besturingssysteem
Naf	Ziel (filosofie)
Af-Faarsi	Perzisch
Diin	Religie
Nabi Ibraahiim C.S.	Abraham
Saladh	Salade
Yuhuuda	Jodendom
Af-Hebrow	Hebreeuws
Ibn Khalduun	Ibn Khaldun
Beer (xubin)	Lever
Cilminafsi	Psychologie
Badweyn	Oceaan
Gootama buuda	Gautama Boeddha
Muxamed	Mohammed
BBC	British Broadcasting Corporation
Shahrukh Khan	Shahrukh Khan
Al-Ghazaali	Al-Ghazali
Gerald Ford	Gerald Ford
Shiica	Sjiisme
Suufi	Soefisme
Carab	Tong (anatomie)
Chelsea FC	Chelsea FC
Arsenal F.C.	Arsenal FC
Ganac	Alvleesklier
Qolfoofta Dadka	Menselijk skelet
Qoor	Nek (anatomie)
Af	Mond (orgaan)
Elizabeth II	Elizabeth II van het Verenigd Koninkrijk
Caajiska	Vermoeidheid
Schiphol	Luchthaven Schiphol
Haarlem	Haarlem
Ronald Reagan	Ronald Reagan
Af-Zulu	Zoeloe (taal)
Foosto	Vat (verpakking)
Sabool	Armoede
Gordon Brown	Gordon Brown
Jadwalka Curiyayaasha	Periodiek systeem
Robert Mugabe	Robert Mugabe
Xamaam(Shinbir)	Duiven (vogels)
Bakteeri	Bacteriën
Geed	Boom (plant)
Canab	Druif
Malab	Honing
Hilib	Vlees
Barandho	Aardappel
Sonkor	Tafelsuiker
Khudaar	Groente
Robot	Robot
Makiinad	Machine
Saxaafad	Journalistiek
Taleefoon	Telefoontoestel
Dhaqan	Cultuur
RNA	Ribonucleïnezuur
Xidigisyahan	Astronoom
Habdhiska Wareega Dhiiga	Hart en vaatstelsel
Mindhicirka weyn	Dikke darm
Mindhicirka yar	Dunne darm
Ibn Haytham	Alhazen
Isku dhis	Samengestelde stof
Sharci dajinta	Wetgevende macht
Windows 7	Windows 7
Boqolleey	Procent
Windows Vista	Windows Vista
Fidel Castaro	Fidel Castro
Category:Barasiil	Categorie:Brazilië
Tamar	Energie
Abala-abalayn bayoloji	Taxonomie in de biologie
Awood	Kracht
Cufisjiidad	Zwaartekracht
Cuf	Massa (natuurkunde)
Bir	Metaal
Hawo	Gas (aggregatietoestand)
Dareere	Vloeistof
Adke	Vaste stof
Bushkuleeti	Fiets
Markab	Schip (transportmiddel)
Beeraha	Landbouw
Cudbi	Katoen
Tiknolajiga nano	Nanotechnologie
Xaansho	Papier
Bac	Plastic
Bed	Oppervlakte
Lambar	Getal (wiskunde)
Kiilogaraam	Kilogram
Cristiano Ronaldo	Cristiano Ronaldo
Mitir	Meter
Ilbiriqsi	Seconde
Galley	Mais
Kelvinka	Kelvin (eenheid)
Dalalka	Lijst van landen in 2015
Ludwik Lejzer Zamenhof	Lejzer Zamenhof
Mesobotaamiya	Mesopotamië
Buti	Beren
Britney Spears	Britney Spears
Habdhiska Dheefshiidka	Spijsvertering
Habka Samayska Cuntada	Fotosynthese
Kansar	Kanker
Boqortooyo	Koning (titel)
Qamadi	Tarwe
Kalandar	Kalender
Dhagool	Doofheid
Cudur	Ziekte
Niikotiin	Nicotine
Malaariyo	Malaria
Cunto xumida	Malnutritie
Benseliin	Penicilline
Nantes	Nantes
AIDS	Aids
Sokorow	Diabetes mellitus
Template:Location map Yemen	Sjabloon:Positiekaart Jemen
Mona Lisa	Mona Lisa
Horgale (Fiisikis)	SI-stelsel
Burj Khalifa	Burj Khalifa
Gidaarka Shiinaha	Chinese Muur
Abyoone	Geheel getal
Kubad	Bol (lichaam)
Dawladii Cabaasiyiinta	Kalifaat van de Abbasiden
Dawlada Cosmaniya	Ottomaanse Rijk
Koronto	Elektriciteit
Seef	Zwaard (wapen)
Pawlo Kuwelho	Paulo Coelho
Stephan El Shaarawy	Stephan El Shaarawy
Liin	Sinaasappel
Af-Soomaali	Somalisch
Aljaziira	Al Jazeera
Hal-xeraale	Puzzel
Carabi	Arabisch
Baar	Palmenfamilie
Dollar	Dollar (munt)
Araga	Optica
Calan	Vlag
Qalin Qori	Potlood
Saabaan	Meubilair
Template:Location map Sudan	Sjabloon:Positiekaart Soedan
Template:Location map Eritrea	Sjabloon:Positiekaart Eritrea
Template:Location map Ethiopia	Sjabloon:Positiekaart Ethiopië
Template:Location map Djibouti	Sjabloon:Positiekaart Djibouti
Template:Location map Somalia	Sjabloon:Positiekaart Somalië
Template:Location map Nigeria	Sjabloon:Positiekaart Nigeria
Template:Location map Uganda	Sjabloon:Positiekaart Oeganda
Geri	Giraffe (dier)
Faruur	Lip
Shaarbo	Snor (haargroei)
Midowga Sofiyet	Sovjet-Unie
Qolofta kore ee Dhulka	Aardkorst
Lil Wayne	Lil Wayne
FC Bayern München	FC Bayern München
Queen	Queen
Kanye West	Kanye West
Saableyda feeraha	Ribbenkast
Huguri	Keel (anatomie)
Wikipedia:Maqaallo Xul Ah	Wikipedia:Etalage
Template:Link FA	Sjabloon:Link FA
Maalmaha	Daglicht
Aduunka	Wereld (Aarde)
Wikipedia:Goob	Wikipedia:De kroeg
Nanjing	Nanking
Mayotte	Mayotte
Goobo	Cirkel
Cesc Fàbregas	Cesc Fàbregas
Mobile	Mobiele telefoon
Goronyo	Struisvogel
Kuuriya	Korea
Manchester	Manchester
1000	1000
999	999
Yeey	Wolf
1955	1955
1954	1954
1953	1953
1951	1951
1950	1950
1946	1946
1943	1943
1942	1942
1940	1940
1939	1939
1938	1938
1937	1937
1936	1936
Manchester United FC	Manchester United FC
1935	1935
1934	1934
Axdiga Cusub	Nieuwe Testament
Qafqaas	Kaukasus (gebied)
Sagaal	9 (getal)
Dabaqaroof	Schorpioenen (orde)
Koobka Adduunka	Wereldkampioenschap voetbal
Boolo	Pelecanus
Macdin Alkaliini ah	Alkalimetaal
Macdin dhuleed ah	Aardalkalimetaal
Rafael Correa	Rafael Correa
Transitional Metal	Overgangsmetaal
Bir la Mood	Metalloïde
Bir Ma Ahe	Niet-metaal
Guruubka 17	Halogeen
Neefta Gobta	Edelgas
5	5
4	4
3	3
Boqorad	Koningin (titel)
2	2
Buqarest	Boekarest
Louvre	Louvre
Motorhead	Motörhead
Dameer	Ezel (dier)
6	6
Axdigii Hore	Oude Testament
Saddax-xagal	Driehoek (meetkunde)
Lady Gaga	Lady Gaga
Luqada Hindo Yurub	Indo-Europese talen
Breinigerberg	Breinigerberg
Muammar Qadaafi	Moammar al-Qadhafi
Shabeel	Tijger
Francesco Totti	Francesco Totti
PSY	PSY
Nissan	Nissan Motor
Booyad	Tankauto
Walhade	Slinger (natuurkunde)
Samsung	Samsung Group
Skandinafiyen	Scandinavië
Aruba	Aruba
Smartphone	Smartphone
Shidaal	Aardolie
Isuduwe Habka Juqraafiga	Geografische coördinaten
Banki	Bank (financiële instelling)
1	1
10	10
20	20
30	30
Abkhazia	Abchazië
40	40
9	9
7	7
8	8
Todoba	7 (getal)
Sideed	8 (getal)
Todobaad	Week
Deero	Hertachtigen
Baraf	IJs (water)
Toon	Knoflook
Musée d'Orsay	Musée d'Orsay
Anthroboloji	Antropologie
Badacas	Rode Zee
13	13
Koonfur Ossetia	Zuid-Ossetië
Ulan Bator	Ulaanbaatar
51	51
Jasiirad	Eiland
Cad	Wit
Madaw	Zwart (kleur)
37	37
900	900
Lordi	Lordi
Basal	Ui (plant)
Lix	6 (getal)
700	700
Yaanyo	Tomaat
George H. W. Bush	George H.W. Bush
68	68
89	89
11	11
Quang Binh	Quảng Bình (provincie)
Entrena	Entrena
Dhulbare	Evenaar
NASA	National Aeronautics and Space Administration
Benito Mussolini	Benito Mussolini
15	15
14	14
17	17
500	500
150	150
Qaamuus	Woordenboek
Bermuda	Bermuda
Madax	Hoofd (anatomie)
Wellington	Wellington (stad in Nieuw-Zeeland)
23	23
800	800
Heesta qaranka	Volkslied (nationaal symbool)
42	42
Afarta jiho	Windstreek
18	18
Nuurad	Kalksteen
19	19
16	16
21	21
26	26
41	41
32	32
33	33
Falastiin	Palestina (regio)
Valletta	Valletta
200	200
38	38
43	43
39	39
24	24
79	79
61	61
104	104
29	29
102	102
100	100
Haramcad	Jachtluipaard
Afarta xilli	Seizoen
101	101
105	105
108	108
Dhuxul Dhagax	Steenkool
22	22
46	46
25	25
153	153
156	156
31	31
28	28
Liverpool	Liverpool
85	85
88	88
76	76
54	54
60	60
47	47
Guumees	Uilen (orde)
Nederlaan Antiilis	Nederlandse Antillen
Bahda Bisada	Katachtigen
Ambeer	Ampère (eenheid)
Isotope	Isotoop
Göteborg	Göteborg (stad)
Culeys	Gewicht
Geed Timir	Dadelpalm
Burris	Hamer (gereedschap)
Racibórz	Racibórz
Kobe Bryant	Kobe Bryant
Luqadaha Berberiga	Berbertalen
600	600
400	400
300	300
Tilburg	Tilburg (gemeente)
Dayax gacmeed	Kunstmaan
Horseed FC	Horseed FC
Taylor Swift	Taylor Swift
Khaalid bin Waliid	Khalid ibn Walid
Bariga Afrika	Oost-Afrika
Fiat	FIAT
Bartamaha Ameerika	Centraal-Amerika
Af-Cafari	Afar (taal)
Magrib	Maghreb
Amxaari	Amhaars
36)	36
Tin	Haar (zoogdier)
Wareeg	Omtrek
Portal:Af-maal	Portaal:Taal
Dhicis	Miskraam
Dhar	Textiel
Kacdoonka masar	Egyptische Revolutie (2011)
Willis Tower	Willis Tower
Kacbada	Kaäba
Beatriks	Beatrix der Nederlanden
Isuzu	Isuzu
Dublad	Trechter
159	159
107	107
103	103
152	152
240	240
197	197
70	70
Duqa	Burgemeester
81	81
69	69
87	87
65	65
66	66
67	67
55	55
34	34
44	44
35	35
64	64
151	151
155	155
50	50
260	260
45	45
49	49
230	230
Zhengzhou	Zhengzhou
154	154
52	52
82	82
84	84
73	73
72	72
62	62
71	71
75	75
74	74
83	83
78	78
77	77
90	90
80	80
91	91
190	190
109	109
53	53
270	270
Madaxweyne	President
63	63
86	86
401	401
99	99
98	98
110	110
137	137
138	138
140	140
130	130
210	210
220	220
Dell	Dell
180	180
158	158
157	157
106)	106
48	48
97	97
Yuumbi	Zeilvissen
56	56
93	93
Alofi	Alofi (plaats)
57	57
Jamestown	Jamestown (Sint-Helena, Ascension en Tristan da Cunha)
170	170
171	171
172	172
58	58
59	59
139	139
134	134
135	135
96)	96
92	92
133	133
176	176
131	131
Fowdo	Regeringsloosheid
Jasiirad Dhuleedka Carabta	Arabisch Schiereiland
250	250
280	280
290	290
Mindi	Mes (voorwerp)
Masaajid	Moskee
Akon	Akon
Dumnad	Domino (spel)
174	174
International Standard Book Number	Internationaal Standaard Boeknummer
132	132
178	178
Luqadaha Tashaadiga	Tsjadische talen
Drake	Drake (rapper)
Luqadaha Kushiitiga	Koesjitische talen
Afguri	Dialect
95	95
94	94
257	257
Biriq	Bliksem
Gacan	Hand
Af-Oromo	Afaan Oromo
Caleen	Blad
Jilaa	Acteur
Niue	Niue
Luqadaha Semitiga	Semitische talen
Justin Bieber	Justin Bieber
Xusni Mubaarak	Hosni Moebarak
Af-Tigrinya	Tigrinya (taal)
Dhululubo	Cilinder (meetkunde)
Subag	Boter (zuivel)
Yaasir Carafaat	Yasser Arafat
Fara-ka hadal	Gebarentaal
136	136
Injiil	Evangelie
Alexander Graham Bell	Alexander Graham Bell
Tasmaniya	Tasmanië
Rotterdam	Rotterdam
Saabuun	Zeep (reiniging)
Cabdillahi ibn Cabdi al Mudalib	Abdallah ibn Abd al-Muttalib
Mošovce	Mošovce
Shakira	Shakira
Jaamacadda Oxford	Universiteit van Oxford
Maxamuud Axmadinajaad	Mahmoud Ahmadinejad
CD	Compact disc
Al-Qaacida	Al Qaida
Maxamed Al-faatex	Mehmet II
Jeer	Nijlpaard
Furaat	Eufraat
Gacanka Faarsiga	Perzische Golf
Cilmiga bulshada	Sociale wetenschappen
Somaliland	Somaliland
Ciida sanadka cusub	Nieuwjaar
Babaay	Papaja
Brisbane	Brisbane
Fiitamiin	Vitamine
Towraad	Thora
Koonfur Joorjiya iyo Koonfurta Jasiiradaha Sanwij	Zuid-Georgia en de Zuidelijke Sandwicheilanden
Maahmaah	Spreekwoord
Noemi	Noemi
Website	Website
Ido	Ido (kunsttaal)
Sumeer	Soemer
Kolonbo	Colombo (stad)
Dariishad	Venster (muur)
Medina	Medina (Arabië)
Akkadiyaan	Akkadisch
Booliis	Politie
UEFA	UEFA
Tigris	Tigris
Koonfur Australia (gobol)	Zuid-Australië
Baarlamaan	Parlement
Maatar	Materie
Jaamacadda Cambridge	Universiteit van Cambridge
Fulinta (Dawlad)	Uitvoerende macht
Hurdo	Slaap (rust)
Neefta	Astma
Doon	Boot (vaartuig)
Queensland	Queensland
Mohammed ali Clay,	Muhammad Ali
Beyoncé Knowles	Beyoncé Knowles
Urur	Verzameling (wiskunde)
Siligo	Siligo
Riyo	Droom
Bur	Meel
Dhigaha	Lengtegraad
Kimikal dibusocod	Chemische reactie
Den Haag	Den Haag
Goriila	Gorilla's
Daylight saving time	Zomertijd
Daanta galbeed	Westelijke Jordaanoever
Maraykanka assalkoodii	Indianen
Siinaa	Sinaï (schiereiland)
Albaab	Deur
Rihanna	Rihanna
Hargab Doofaar	Varkensgriep
Cinjo	Nagel (anatomie)
Ugaadhsi	Jacht (activiteit)
Toshiro Mifune	Toshiro Mifune
Waji	Gelaat
Aleksander Fileming	Alexander Fleming
Musmaar	Draadnagel
Nabi Suleymaan C.S.	Salomo
Yahoo	Yahoo!
AK-47	AK-47
Mowjad	Golf (natuurkunde)
Dhexroor	Diameter
Bare	Onderwijzer
Internet Movie Database	Internet Movie Database
Dalai Lama	Dalai lama
Jilib (xubin)	Knie (anatomie)
ISO 4217	ISO 4217
Tomas hobis	Thomas Hobbes
Campora San Giovanni	Campora San Giovanni
Jirjiroole	Kameleons
Cusmaan bin Cafaan	Oethman ibn Affan
Jaandi	Legering
Nafto	Dieselolie
Qare	Watermeloen
Toban iyo shan	15 (getal)
Rikter Cabir	Schaal van Richter
Xamaas	Hamas
Ruhollah Khomeini	Ruhollah Khomeini
Rajab Dayib Erdogaan	Recep Tayyip Erdoğan
Mug	Inhoud (volume)
Jamaal Cabdinaasir	Gamal Abdel Nasser
Bluetooth	Bluetooth
Cali	Ali ibn Aboe Talib
Marinka Gaza	Gazastrook
Radio Studio 54 Network	Radio Studio 54 Network
Cabitaan	Drank
Qoori	Strand (kust)
Qabaal	Ellips (wiskunde)
Hobart	Hobart (Australië)
Dayax Gacmeed	Ruimtevaartuig
Doorashada	Verkiezing
Iskudhufasho	Vermenigvuldigen
Saxaraha Galbeed	Arabische Democratische Republiek Sahara
.et	.et
Geeska Afrika	Hoorn van Afrika
Lisa Gerrard	Lisa Gerrard
Nabi Yaxye C.S.	Johannes de Doper
Jennifer Lopez	Jennifer Lopez
Faraq	Aftrekken (wiskunde)
Breda (Netherlands)	Breda
Shuban	Diarree
Nancy	Nancy
Honiara	Honiara
PH	PH
Asiyriya	Assyrische Rijk
Qardhaas	Ruit (meetkunde)
Xayla Siilaasi	Haile Selassie
Xalab	Aleppo (stad)
Big Ben	Big Ben
Dhererka Mowjadda	Golflengte
Nabi Daa'uud C.S.	Koning David
Borussia Dortmund	Borussia Dortmund
Xidido	Wortel (plant)
Mole	Mol (eenheid)
Frank Lampard	Frank Lampard
Qallal	Epilepsie
Ramadaan	Ramadan
Baqal	Muildier/muilezel
Garaam	Gram (eenheid)
Shahaadah	Sjahada
Gacanka Cadmeed	Golf van Aden
Beeraha laalaada	Hangende tuinen van Babylon
Maas	Maas
Khadiija binti Khuweylad	Khadija
Waraabe	Hyena's
Sariir	Bed
Madaxwayne kuxigeen	Vicepresident
Cilmibaadhis	Wetenschappelijk onderzoek
Faaranhaayt	Fahrenheit
Dhuldaaqsiin	Savanne (landschap)
Dhogor	Wol
Toobin	Kegel (ruimtelijke figuur)
Daliban	Taliban
MP3	MP3
Ismaamulka Falastiin	Palestijnse Autoriteit
.ke	.ke
Fernando Torres	Fernando Torres
Gar	Baard (haargroei)
Nabi	Profeet
Derbi	Muur (bouwsel)
SMS	Sms
Yaxaas	Krokodillen
Majladda Time	Time (tijdschrift)
Dhedig	Vrouwelijk (biologie)
Farabadne	Duizendpoten
Amedeo Avogadro	Amedeo Avogadro
Shambay	Wilde kat
Sedex Geesoodka Bermuda	Bermudadriehoek
Arjen Robben	Arjen Robben
Xamid Karzai	Hamid Karzai
Lab	Mannelijk (biologie)
Rey mysterio	Rey Mysterio
Dayax madoobaad	Maansverduistering
Taxane	Matrix (wiskunde)
Kayene	Cayenne (stad)
John Cena	John Cena
Waran	Speer
Dadqalato	Kannibalisme
Busbus	Waterpokken
Provinces of Argentina	Provincies van Argentinië
Dekad	Haven
Garoonka Diyaaradaha ee Bole	Luchthaven Bole Internationaal
Dadka Berberiga	Berbers
Afganbi	Staatsgreep
Burcad Badeed	Zeeroverij
RSS	Really Simple Syndication
Lacagta Meherka	Bruidsschat
Barbaroole	Parallellogram
Leeb	Pijl (wapen)
Chris Paul	Chris Paul
Awood Socota	Kinetische energie
Koor	Trapezium
Qaanso	Boog (wapen)
Amiibada	Amoeba (geslacht)
Zlatan Ibrahimović	Zlatan Ibrahimović
GSM	GSM (communicatie)
Dhaban	Wang (anatomie)
Saint-Denis	Saint-Denis (Réunion)
Arsène Wenger	Arsène Wenger
Baabiylooniya	Babylonië
Muslim	Moslim
Warqadda aqoonsiga	Legitimatiebewijs
Template:Commonscat	Sjabloon:Commonscat
Qoorgooye	Hersenvliesontsteking
399	399
Iidi Amiin Daada	Idi Amin
Kayseri	Kayseri (stad)
CNN	CNN
Drogbaa	Didier Drogba
Dhakhaatiirta Bilaaxuduudaa	Artsen zonder Grenzen
Abwaan	Dichter
Manchester city	Manchester City FC
Ilaahay	Troms
John Dramani Mahama	John Dramani Mahama
Luqada Masaarida	Egyptisch
Anatooliya	Anatolië
Nabi Ciise	Isa (profeet)
Cudurka Ebola	Ebola
Template:Taxobox	Sjabloon:Taxobox
Carly Rae Jepsen	Carly Rae Jepsen
Toyota	Toyota
Osmose	Osmose
Af-Hawsa	Hausa (taal)
Saxan	Bord (maaltijd)
Mwai Kibaki	Mwai Kibaki
Jalaal Daalabaani	Jalal Talabani
Ismaaciil Cumar Geelle	Ismaïl Omar Guelleh
Nuur Al-Maliki	Nouri al-Maliki
Dileita Maxamed Dileita	Dileita Mohamed Dileita
Mark Rutte	Mark Rutte
Axmed Dafutoglu	Ahmet Davutoğlu
Robinho	Robinho
Bada Carbeed	Arabische Zee
Dhircun	Herbivoor
Calanka Denmark	Vlag van Denemarken
Jay-Z	Jay Z
Yuusuf Alqardaawi	Yusuf al-Qaradawi
Sahel	Sahel (landstreek)
Henry Kissinger	Henry Kissinger
Abu Hurayra	Aboe Hoeraira
Flums	Flums
Nabi Aadam C.S.	Adam
Diego Milito	Diego Milito
Habaryar	Tante
Abti	Oom
Ilmo adeer	Neef
Shumac	Kaars
Wikipedia:Sharaxaada Maqaalada Xulka Ah	Wikipedia:Etalage/Aanmelding kandidaten
Dhalo	Fles
Raqay	Tamarinde
Shabeelada Tamil	Tamiltijgers
Qaangaadh	Volwassene
Enjerneer	Ingenieur
Gacanka Caqaba	Golf van Akaba
KwaZulu-Natal Province	KwaZoeloe-Natal
Hilibcun	Carnivoor
AFC Ajax	AFC Ajax
Qaado	Lepel (bestek)
VOIP	IP-telefonie
Jibriil	Gabriël (aartsengel)
Astaamayn	Interpunctie
Taksi	Taxi (vervoer)
Soqotra	Socotra (eiland)
Timor	Timor
Almere	Almere
Xoor-dubbur	Stinkdieren
Dooli	Huismuis
Suul	Duim (vinger)
Mesut ozil	Mesut Özil
Turki	Turken
Ukun	Ei (voeding)
HyperText	Hypertekst
Xeeb	Kust
Ibb	Ibb
Lobamba	Lobamba
Walxaha	Periode (scheikunde)
Magarete2	Margaretha II van Denemarken
Calanka jabuuti	Vlag van Djibouti
Xareed	Zoet water
Calanka Suudaan	Vlag van Soedan
Daanyeer	Hominoidea
Sodium Hydroxide	Natriumhydroxide
Xoolo	Vee
Cirid	Tandvlees
Chalcogen	Zuurstofgroep
Tufaax	Malus
Shakaal	Hypotenusa
Biniktojiin	Stikstofgroep
Lambedusa	Lampedusa
Manuel Neuer	Manuel Neuer
Jalmad	Fluitketel
Eris	Eris
Wiz Khalifa	Wiz Khalifa
Agool	Roos (aandoening)
Barfasoor	Professor
Massari	Massari
Maydhax	Xyleem
Dhax kujir	Binnenstaat
Andalus	Al-Andalus
Sako	Zakat
Dhadhan	Smaak (zintuig)
ICAO	Internationale Burgerluchtvaartorganisatie
.so	.so
Western Cape Province	West-Kaap
Mario Balotelli	Mario Balotelli
Qiiq	Rook
Eastern Cape Province	Oost-Kaap
Cerebellum	Kleine hersenen
Haaruun Alrashiid	Haroen ar-Rashid
Kaftan	Grap
Funaanad	T-shirt
IMMAGINE&POESIA	Immagine & Poesia
Tangent	Raaklijn
Niisaabuur	Nisjapoer
Khilaafada Islaamka	Kalifaat
Cadan	Aden (stad)
Het Wilhelmus	Wilhelmus
Universidade Federal de Minas Gerais	Federale Universiteit van Minas Gerais
Mpumalanga Province	Mpumalanga
Northern Cape Province	Noord-Kaap
Mamawdsaw	Mamoudzou
Gauteng Province	Gauteng
Lug	Been (ledemaat)
Cagaarshow	Geelzucht
Du gamla, Du fria	Du gamla, Du fria
Shaydaanimo	Satanisme
Limpopo Province	Limpopo (provincie)
LG	LG Group
Ogaden	Ogaden
Alexandre Pato	Pato
Wabiga Jubba	Jubba
Qooleey	Postduif
Wabiga Shabeelle	Shebelle
Masago	Lodde
Marsho	Tandwiel
Zain Bikha	Zain Bhikha
Saynab bint Khuzayma	Zaynab bint Khuzayma
Nabi Yuusuf	Jozef (zoon van Jakob)
One Direction	One Direction
Mille	Oplosmiddel
Herpesviruses	Herpesvirussen
Degmo	District
Tomahok (gantaal)	Tomahawk (kruisvluchtwapen)
Dambas	As (verbranding)
Eduard Douwes Dekker	Eduard Douwes Dekker
Yuusuf Islaam	Cat Stevens
Kiyaawe	Sleutel (gereedschap)
Awood Kaydsan	Potentiële energie
Chris Brown	Chris Brown (zanger)
Universidade Estadual de Feira de Santana	Staatsuniversiteit van Feira de Santana
Aadan Cabdulle Cusmaan	Aden Abdullah Osman Daar
Saylac	Zeila
Anopheles	Anopheles
Malawad	Endeldarm
Universidade Federal da Bahia	Federale Universiteit van Bahia
Centro Federal de Educação Tecnológica de Minas Gerais	Centro Federal de Educação Tecnológica de Minas Gerais
Calanka Soomaaliya	Vlag van Somalië
Dhuuso	Winderigheid
Free State Province	Vrijstaat (provincie)
Maqal	Gehoor
Oorfane	Weeshuis
Ubuc	Romp (anatomie)
Meles Zenawi	Meles Zenawi
Nicki Minaj	Nicki Minaj
Wahaabi	Wahabisme
Diffusion	Diffusie
DDT	Dichloordifenyltrichloorethaan
Cadnaan Oktaar	Harun Yahya
Ibrahim Affelay	Ibrahim Afellay
Angry Birds	Angry Birds (computerspelserie)
Daango	Popcorn (voedsel)
Qalin	Pen
Aadaan	Azan
Usher	Usher
Hummaag noqod	Reflectie (straling)
North West Province	Noordwest (provincie)
Lelystad	Lelystad
Midabada Asaasiga	Primaire kleur
Isnidaamis	Schurft (mens)
Daaf	Bindvliesontsteking
CAF	Confédération Africaine de Football
Hargeysa	Hargeisa
Nabiyada Islaamka	Profeten van de islam
Xijaas	Hidjaz
Filibs	Koninklijke Philips
Kaliber	Kaliber (wapen)
Geed Hindi	Azadirachta indica
Jidh	Lichaam (biologie)
Qosol	Lachen (gedrag)
Nektar	Nectar (plant)
Mount kenya	Mount Kenya
Uunsi	Olibanum
Jomo Kenyatta	Jomo Kenyatta
Gacan (Joomitiri)	Straal (wiskunde)
Centimetre	Centimeter
Millimeter	Millimeter
Baadiye	Platteland
Portal:Taariikh	Portaal:Geschiedenis
Hunguriga neefta	Luchtpijp
Bowdo	Dijbeen
Qaamo-qashiir	Bof
Tiirarka Islaamka	Vijf zuilen van de islam
Fanaan	Zanger
Huulaaku Khan	Hulagu
Wadan soo kobcooyo	Ontwikkelingsland
Dhuxul	Houtskool
Shansho	Scheenbeen
Saac (faah faahin)	Horloge
Alchemist(Buug)	De Alchemist
The Notorious B.I.G.	The Notorious B.I.G.
Sanab	Standbeeld
Saadiyom bicarbonate	Natriumwaterstofcarbonaat
Nabi Ayuub C.S.	Job (persoon)
Fatima bint Muxamed	Fatima Zahra
Baras	Vitiligo
Sumad xisaabed	Lijst van wiskundige symbolen
Daan	Kaak (anatomie)
Ricir	Wervel (anatomie)
Qol	Ruimte (toegankelijk deel van een gebouw)
Dhado	Luchtvochtigheid
Curiye	Element
Mucaawiye bin Abii Sufyaan	Moe'awija I
Xasan Nasrallaah	Hassan Nasrallah
Mahathir Bin Maxamed	Mahathir Mohammed
Bidaar	Alopecia androgenetica
Aafda tahriibka	Mensenhandel
KLM	Koninklijke Luchtvaart Maatschappij
Johan Rudolph Thorbecke	Johan Rudolph Thorbecke
Gabareey-maanyo	Zeemeermin
Mitsubishi	Mitsubishi Group
Cashuura	Asjoera
Tamaashiir	Krijtgesteente
Memory card	Geheugenkaart
Daxal	Roest (metaal)
Will.i.am	Will.i.am
Saxaro	Mest
Gaamur	Teer
UFC	Ultimate Fighting Championship
Pitbull	Pitbull (rapper)
Aayad	Aya
Tariikhda Shiikh Axmed Yaasiin	Ahmad Yassin
Saxaabi	Sahaba
Gows	Kies
Shanbal	Bekken (muziekinstrument)
Harar	Harar
Dhismaha websiteka	Webdesign
Golcas	Gazella
Abuu Xaniifa	Abu Hanifa
Ammonium	Ammonium
Session Initiation Protocol	Session Initiation Protocol
Salafiya	Salafisme
Berbera	Berbera
Botka internetka	Bot (computerprogramma)
Bergen op Zoom	Bergen op Zoom
Mengista Xayle Maryam	Mengistu Haile Mariam
Mowliidka Nebiga	Mawlid an-Nabi
Ciraaqi Diinaar	Iraakse dinar
Adenoviridae	Adenovirussen
Daniel arap Moi	Daniel arap Moi
Nabi Huud	Hud (profeet)
Ne-Yo	Ne-Yo
Sin	Heup
Axmed Binu Xambal	Ahmad ibn Hanbal
Sheybaar	Microscoop
Peso (Arjantiina)	Argentijnse peso
Yamanta Koonfureed	Democratische Volksrepubliek Jemen
Assur	Aššur (stad)
Decimetre	Decimeter
Sean paul	Sean Paul
Yazidi (yasiidi)	Jezidi's
Calanka somaliland	Vlag van Somaliland
Soomaali Galbeed	Somali (Ethiopië)
Shilin Kiinyaati	Keniaanse shilling
Astaannta Qaranka ee Soomaaliya	Wapen van Somalië
Astaannta Qaranka ee Imaaraatka	Wapen van de Verenigde Arabische Emiraten
Velupillai Prabhakaran	Velupillai Prabhakaran
Federaaliisim	Federalisme
Biomolikule	Biomolecuul
Nabi Alyasac C.S.	Elisa (profeet)
Birr	Ethiopische birr
Jaad	Qat (plant)
Cows	Gazon (grasveld)
S-block	S-blok
Dab Damis	Brandweervoertuig
Kung fu	Kungfu
Maxamed Siyaad Barre	Siad Barre
Salo	Salo (Finland)
Ívi Adámou	Ivi Adamou
Cafar	Afar (volk)
Saliid Macsaro	Sesamolie
Cumar Mukhtaar	Omar Mukhtar
Angalool	Schelp
Flo Rida	Flo Rida
Eden Hazard	Eden Hazard
T.I.	T.I.
Budhcad badeeda geeska afrika	Piraterij in Somalië
Ayaan Xirsi Cali	Ayaan Hirsi Ali
P-block	P-blok
D-block	D-blok
F-block	F-blok
Cabdullaahi Yuusuf Axmed	Abdullahi Yusuf Ahmed
Ururka Dawladaha aan la aqoonsan Wali	UNPO
Darawal	Chauffeur
Addimo-yaqaan	Orthopedie
Dhul (dhulka lagu socdo)	Vloer
Faysal Bin Cabdil Caziiz	Faisal bin Abdoel Aziz al-Saoed
Wadar	Sommatie
Qormo saynis	Wetenschappelijke notatie
C.H	BC
Adam Levine	Adam Levine
Al-Faatixa	Soera De Opening
Al-Baqara	Soera De Koe
Hogaamiye Kooxeed	Krijgsheer
T-pain	T-Pain
Anggun	Anggun
Carlos the Jackal	Ilich Ramírez Sánchez
Fatima	Fatima
Mombaaso	Mombassa
Alexa Internet	Alexa Internet
Sheekh Xasan Albanaa	Hassan al-Banna
Daariq ibn Ziyaad	Tariq ibn Zijad
Seed	Pees (anatomie)
Al-Ikhlas	Soera De Toewijding
Suurad	Soera
Xadiis	Hadith
Sunna	Soenna
Allaah	Allah
Salaad	Salat (islam)
Xaj	Hadj
Malag	Engel
Astaannta Qaranka ee Kolombiya	Wapen van Colombia
Xisbiga shacabka iyo xoriyada Holalnd	Volkspartij voor Vrijheid en Democratie
Qeshm	Qishm
Bukhaari	Al-Bukhari
Dadka Soomaaliyeed	Somaliërs
Dagaalkii sokeeye ee Soomaaliya	Somalische Burgeroorlog
Jason Derulo	Jason Derülo
Macrakadii Ceyn Jaaluut	Slag bij Ain Jalut
Iskugeyn	Plus
FIFA	FIFA
Uumi	Damp
Iman model	Iman Abdulmajid
Amina bint Wahb	Aminah bint Wahab
Maryama al-Qibtiyya	Maria al-Qibtiyya
Xafsa bint Cumar	Hafsa bint Omar
Laf	Bot (anatomie)
Wayne Rooney	Wayne Rooney
Al Hudaydah	Al Hudaydah (stad)
Sheekh Shariif Axmed	Sharif Sheikh Ahmed
Kismaayo	Kismayo
R. Kelly	R. Kelly
Fool	Snijtand
Lacey Duvalle	Lacey Duvalle
Saaxil	Saaxil
Dhul Udug	Poent
Bakool	Bakool
Nabi Yacquub C.S.	Jakob (aartsvader)
Zubeyr bin Cawaam R.C	Zubayr ibn al-Awwam
Imaam Nawawi	An-Nawawi
Imaamu Shaafici	Mohammed Al-Shafi'i
Demba Ba	Demba Ba
Xasan Guuleed Abtidoon	Hassan Gouled Aptidon
K'naan	K'naan
Greyson Chance	Greyson Chance
Al-Shabaab	Al-Shabaab (Somalië)
Al Mahwit	Al Mahwit (stad)
Al Mukalla	Al Mukalla
Imaam Maalik	Malik ibn Anas
Cody Simpson	Cody Simpson
Madfac	Granaat (munitie)
Dagaalkii xoraynta ogaden	Ogaden-oorlog
Oromo	Oromo
Xasan Sheekh Maxamuud	Hassan Sheikh Mohamud
Rodolfo Graziani	Rodolfo Graziani
Maxamed Faarax Caydiid	Mohammed Farrah Aidid
Biyo baxa deg dega ah	Voortijdige zaadlozing
Dhulka Talyaaniga ee Soomaaliya	Italiaans-Somaliland
Saytuun	Psidium
Trey songz	Trey Songz
Macawiis	Sarong
Nuuraddin Faarax	Nuruddin Farah
Compaq	Compaq
Nabi Saalax	Salih (profeet)
Unimog	Mercedes-Benz Unimog
Lufthansa Duulimaadkii 181	Lufthansa-vlucht 181
Nabi Idriis	Idris (profeet)
Tooreey	Lemmet (mes)
Boosaaso	Bosaso
Axmed Deedat	Ahmed Deedat
Nabi Dulkifli	Zulkifl (profeet)
Abu Bakr	Aboe Bakr
Abuu Sufyaan	Aboe Sufyan
Caabudwaaq	Abudwak
IHH	IHH
Dun	Draad
Marek Grechuta	Marek Grechuta
Jeddah	Djedda
Shukaansi	Balts
Sacad bin Abii Waqaas	Sa`d ibn Abi Waqqas
Axmed Maxamed Maxamuud (Siilaanyo)	Ahmed Silanyo
Nabi Haaruun C.S.	Harun (profeet)
Afmadow	Afmadow
Xulka Qaranka Soomaaliya	Somalisch voetbalelftal
Woqooyi bari	Kaskazini-Mashariki
Masjid al-Aqsa	Al-Aqsamoskee
Dadka Tigriga	Tigrinya (volk)
Computer Engineering	Technische informatica
Masjid al-Xaram	Al-Masjid al-Haram
Caluula	Alula
Astaanta Calanka Soomaaliya	Somaliyaay toosoo
Amxaaro	Amharen
Rayhana bint Zayd	Raihana
Ta'izz	Ta'izz
Xaliimo Khaliif Cumar Magool	Magool
Murgacasho	Verstuiking
Nabi Ismaaciil C.S.	Ismail (profeet)
Dibi	Os (rund)
Paramore	Paramore
Tuur	Kyfose
Lafdhabar	Wervelkolom
Luís Carlos Almeida da Cunha	Nani (voetballer)
Paris Saint-Germain FC	Paris Saint-Germain
Ahlu sunno waljamaaca	Soennisme
Puntland	Puntland
Qureysh	Qoeraisj
Masjidka Nabiga	Moskee van de Profeet
Dagaalkii uxud	Slag bij Uhud
Sambuus	Samosa
Imaam Mujtahid Sheykhul-Islaam	Ahmad ibn Tajmijja
Bilaal ibn Ribaax	Bilaal Ibn Rabaah'
Fiat 124	Fiat 124
Busteejo	Busstation
Galatasaray SK	Galatasaray SK
IGAD	Intergovernmental Authority on Development
Astaanta Calanka Jabuuti	Hinjinne u sara kaca
Baydhabo	Baidoa
G-Spot	G-plek
Naxariis iyo Nabadgelyo Korkiisa Ha Ahaato	Sallallahu alaihi wa sallam
Salaada Magrib	Maghrib (islam)
Baskin-Robbins	Baskin-Robbins
Haparanda	Haparanda (stad)
Xarardheere	Harardheere
Baraawe	Barawe
Aakhiro	Leven na de dood
Dhuusamareeb	Dhuusa Marreeb
Jowhar	Jawhar (Somalië)
Shimbiris	Shimbiris
Marka	Marka
Biciid	Oryxen
Hiiraan	Hiiraan
Dhulka Biritishka ee Soomaaliya	Brits-Somaliland
Nabi Isxaaq C.S.	Isaak (aartsvader)
Zamenhof	Zamenhof
Shabeellaha Dhexe	Shabeellaha Dhexe
Hanti maguurto	Vastgoed
Salaada Subax	Fajr
Carta	Arta (stad in Djibouti)
Liiska dalalka dad ahaan	Lijst van landen naar inwonertal
Godol	Toeschietreflex
Mr. Lordi	Mr. Lordi
Bari (Gobol)	Bari (Somalië)
Wajeer	Wajir (stad)
Midowga Maxkamadaha Islaamiga	Unie van Islamitische Rechtbanken
Somaliland shilling	Somalilandse shilling
Taleefoonada fiilada	Vaste telefonie
UNICEF	UNICEF
Behra	Beira (antilope)
Godeey	Gode
Abuu Cubeydah Caamir ibn Jaraax	Abu Ubayda ibn al-Jarrah
Sanaag	Sanaag
Jigjiga	Jijiga
Salaada Casir	Asr (islam)
Centro Federal de Educação Tecnológica Celso Suckow da Fonseca	Centro Federal de Educação Tecnológica Celso Suckow da Fonseca
Salaada Cishe	Isha
Garoonka Diyaaradaha ee Da Nang	Internationale Luchthaven Đà Nẵng
Cirbadii dhimashada	Vijfstreepschorpioen
Nansi Ajram	Nancy Ajram
Azania	Azanië
Awdal	Awdal
Banaadir	Banaadir
Bari	Bari
Baay	Bay (Somalië)
Sedjibeke	Kubus (ruimtelijke figuur)
Beledweyne	Beledweyne
Garoowe	Garowe
Derg	Dergue
Kilometer	Kilometer
Xaawo	Eva (persoon)
Dhuun	Streptokokkenfaryngitis
Web feed	Webfeed
Salaada Duhur	Dhuhr
Hectometre	Hectometer
Gaarisa	Garissa (stad)
Eurobeat	Eurobeat
Decametre	Decameter
Sool	Sool (Somalië)
York University	York University
Buurta Xira	Grot van Hira
Gedo	Gedo
Saldanada geledi	Sultanaat Geledi
Gaalkacyo	Galkayo
Guddi	Commissie
Togdheer	Togdheer
Goobogali	Meerkeuzevraag
Galguduud	Galguduud
Woqooyi Galbeed	Woqooyi-Galbeed
Shabeellaha Hoose	Neder-Shabelle
Mudug	Mudug
Jubbada Hoose	Jubbada Hoose
Boorama	Borama
Taran	Product (wiskunde)
Reoviruses	Reovirus
Matoor	Motor (doorverwijspagina)
Wikipedia:Caawinaad	Portaal:Hulp en beheer
Wikipedia:Tutorial	Wikipedia:Snelcursus
Miraha Mucjisada	Mirakelbes
Pontifícia Universidade Católica de Minas Gerais	Pontifícia Universidade Católica de Minas Gerais
Galmudug	Galmudug
Canjeelo	Injera
Dawladii Mamaaliikta	Mamelukken
Digri	Dhikr
Burco	Burao
Ajdjadajd	Jubaland
Mandheera	Mandera (stad)
Gadabuursi	Gadabuursi
Sagaaro	Zilverdikdik
Nabi Shuceyb	Shu'aib (profeet)
Ibraahim Xasan Caddoow	Ibrahim Hassan Addow
Bu’aale	Bu'aale
Gabiley	Gabiley
Hobyo	Hobyo
Xudur	Hudur
Garbahaarey	Garbahaarreey
Ceerigaabo	Ceerigaabo
Galdogob	Galdogob
Iskushuban	Iskushuban
Laascaanood	Laascaanood
Eyl	Eyl
Calool	Maag
Jubbada Dhexe	Jubbada Dhexe
Nugaal	Nugaal
Ceres	Ceres
Dadka Tigrega	Tigre (volk)
Daallo Airlines	Daallo Airlines
Kaniini	Pil (geneesmiddel)
Taleex	Taleh
Liverpool FC	Liverpool FC
Xariiqanta Cagaaran	Groene Lijn (grens)
Duurjoog	Humbug
Tusbax	Tasbih
Sacad bin Zeyd	Said ibn Zayd
GCompris	GCompris
Saynab bint Muxamed	Zainab bint Mohammed
Wikipedia:Safaarad	Wikipedia:Ambassade
Naafto	Diesel
U qeybin	Delen
Dir	Dir (clan)
Samuel Eto'o	Samuel Eto'o
Shimbir soomaaliyeed	Erlangers fiskaal
Shabiixa	Shabiha
Qurac	Vachellia tortilis
Agnes Monica	Agnes Monica
Sabuur	Zaboer
Category:Jarmal	Categorie:Duitsland
Category:Talyaaniga	Categorie:Italië
Category:Qaramada Midoobey ee Maraykanka	Categorie:Verenigde Staten
Category:Ruushka	Categorie:Rusland
Category:Midowga boqortooyada Britan	Categorie:Verenigd Koninkrijk
Category:Isbania	Categorie:Spanje
Category:Shiinaha	Categorie:China
Category:Hindiya	Categorie:India
Category:Sucuudiga	Categorie:Saoedi-Arabië
Category:Turki	Categorie:Turkije
Category:Koonfur Afrika	Categorie:Zuid-Afrika
Category:Masar	Categorie:Egypte
Category:Iiraan	Categorie:Iran
Category:Arjantiina	Categorie:Argentinië
Tess Milne	Tess Milne
Category:Afqaanistan	Categorie:Afghanistan
Category:Austriya	Categorie:Oostenrijk
Category:Itoobiya	Categorie:Ethiopië
Category:Ciraaq	Categorie:Irak
Category:Nederland	Categorie:Nederland
Category:Bakistaan	Categorie:Pakistan
Category:Boland	Categorie:Polen
Category:Bortuqaal	Categorie:Portugal
Category:Suudaan	Categorie:Soedan
Category:Iswisarland	Categorie:Zwitserland
Category:Fiyetnam	Categorie:Vietnam
Category:Shimbir	Categorie:Vogel
Category:Fiisikis	Categorie:Natuurkunde
Category:Bayoloji	Categorie:Biologie
Category:Kimisteri	Categorie:Scheikunde
Category:Taariikh	Categorie:Geschiedenis
Category:Juqraafi	Categorie:Geografie
Category:Diin	Categorie:Religie
Category:Ciyaaraha	Categorie:Sport
Category:Saynis	Categorie:Wetenschap
Category:Filimaanta	Categorie:Film
Category:Isgaadhsiin	Categorie:Communicatie
Jamhuuriyadda Dimuqraadiga Soomaaliya	Somalische Democratische Republiek
Bolol	Echte huiszwam
Cabdiraxmaan bin Cawf	Abd al-Rahman ibn Awf
Dalxa bin Cubeydilah R.C.	Talha ibn Oebeydullah
Submission (film)	Submission
Waqtiga Bariga Afrika	Oost-Afrikaanse Tijd
Nabi Nuux C.S.	Nuh (profeet)
Riyaalu Saalixiin	Rijadus Salichin
Isaaq	Isaaq
Elman FC	Elman FC
Nabi Luud C.S.	Lut
Muxaram	Muharram
Category:Filasoofiyada	Categorie:Filosofie
Category:Cilminafsi	Categorie:Psychologie
Category:Masiixiyad	Categorie:Christendom
Category:Islaam	Categorie:Islam
Goronyo soomaaliyeed	Somalische struisvogel
Garbisaar	Hoofddoek
Raage Oomaar	Rageh Omaar
Qoryooley	Qoryooley
Jirriiban	Jariban
Nabi Ilyaas	Ilyas
Dafo	Arend (roofvogel)
Badh	Half
COA	Centraal Orgaan opvang asielzoekers
Ramla bint Abi Sufyan	Ramlah bint Abi-Sufyan
May 2013	Mei 2013
10-ka saxaabi ee Janada loogu bishaareeyay iyagoo nool	Asharatu mubashirun
Digaagad	Hen (kip)
Diig	Haan (kip)
Suxufi Ibraahim	Suhuf-i-Ibrahim
Jaamacadda Roma Tre	Roma Tre-universiteit
Ruqiya bint Muxamed	Roekajja bint Mohammed
Kobra	Cobra (reptiel)
Nabi Zakariye C.S.	Zakariya (profeet)
Umm Kaltuum bint Muxamed	Oem Koelthoem bint Mohammed
Nabi Yuunus C.S.	Jona (profeet)
Dad	Volk
Universidade do Estado de Minas Gerais	Universidade do Estado de Minas Gerais
Cuud	Bukhoor
Seedi	Zwager
Laan	Tak (plant)
Category:Dhaqan	Categorie:Cultuur
Category:Sanad	Categorie:Jaren
Category:Qaaradaha	Categorie:Continent
AZC	Asielzoekerscentrum
Maxamed Ibraahim Warsame	Mohamed Ibrahim Warsame
Edmond Debeaumarché	Edmond Debeaumarché
Dumaashi	Schoonzus
Indhafiiqid	Cataractextractie
Portal:Cilmi Fallag	Portaal:Astronomie
Portal:Juqraafi	Portaal:Geografie
Lughaya	Lughaye
Gunbur	Piramide (ruimtelijke figuur)
Jano	Paradijs
Quljeed	Quljeed
Saami qumman	Verhouding (wiskunde)
Anna Rita Del Piano	Anna Rita Del Piano
Category:Wikipedia bots	Categorie:Wikipedia:Bots
Portal:Bulsho	Portaal:Mens & maatschappij
Dila	Dilla (Somalië)
Cufka atamka	Atoommassa
Hotmail	Hotmail
Wikipedia:Graphics Lab	Wikipedia:De Wandschildering
Tooxin	Tooxin
Template:Wikipedialang	Sjabloon:Hoofdpagina - andere talen
Category:Wadamada	Categorie:Land
Wikipedia:Maamulka	Wikipedia:Moderator
Category:Shaqsiyadaad	Categorie:Persoon
Wikipedia:Requests for adminship	Wikipedia:Aanmelding moderatoren
Wikipedia:Bots	Wikipedia:Bots
Category:Amin	Categorie:Tijd
Category:Internet	Categorie:Internet
Category:Siyaasad	Categorie:Politiek
Category:Waxbarasho	Categorie:Onderwijs
Category:Araga	Categorie:Optica
Category:Fan	Categorie:Kunst
Masar	Egypte (land)
Category:Filasoofiyaasha	Categorie:Filosoof
Category:Doorashooyinka	Categorie:Verkiezingen
Template:Bot	Sjabloon:Bot
Kanada	Canada
Category:Denmark	Categorie:Denemarken
Category:Giriig	Categorie:Griekenland
Category:Iswiidhan	Categorie:Zweden
Category:Islofaakiya	Categorie:Slowakije
Wikipedia:Copyright	Wikipedia:Auteursrechten
Qolobaa Calankeed	Qolobaa Calankeed
Category:Microsoft	Categorie:Microsoft
Wikipedia:Ogaysiiska Maamulka	Wikipedia:Verzoekpagina voor moderatoren
Wikipedia:Goob/Farsamo	Wikipedia:SHEIC
Template:Flagicon	Sjabloon:Vlagland
Category:Wadamada Yurub	Categorie:Land in Europa
Category:Yurub	Categorie:Europa
Wikipedia:Bogga Isticmaalaha	Wikipedia:Gebruikerspagina
Portal:Dhacdooyinka Hadda	Portaal:In het nieuws
Template:Documentation	Sjabloon:Sjabdoc
Category:Delete	Categorie:Wikipedia:Weg
Wikipedia:Ilaalinta badelka	Help:Beveiligde pagina's
Wikipedia:Albaabka bulshada	Portaal:Gebruikersportaal
Category:Luqadaha wikipediyaasha	Categorie:Wikipedia:Babel
Wikipedia:Shan walxood	Wikipedia:Vijf zuilen
Wikipedia:Userboxes	Wikipedia:Gebruikersboxen
Abaaley	Goof Abaaley
Abaarey	Abaarey
Wikipedia:Saxiix	Wikipedia:Ondertekening
Cadaado	Adado (district)
Caa'isha binti Abiibakar	Aïsja
Ganacsi	Bedrijf
Bacadweyne	Bacadweyn
Badhaadhe	Badhaadhe
Instituto Federal da Bahia	Instituto Federal da Bahia
Template:Softredirect	Sjabloon:Softredirect
Template:Tirtir	Sjabloon:Nuweg
Category:Afafka	Categorie:Taal
Category:Kalandar	Categorie:Kalender
Category:Wikipedia	Categorie:Encyclopedie Wikipedia
Wikipedia:Masuul la'aan guud	Wikipedia:Vrijwaringsclausule
Category:Pages with broken file links	Categorie:Wikipedia:Pagina's met onjuiste bestandsverwijzingen
Wikipedia:Tirakoob	Wikipedia:Statistieken
Wikipedia:Xeerka Wiki	Wikipedia:Privacybeleid
Bursaalax	Bursaalax
Template:Navbox	Sjabloon:Navigatie
Template:Xaqiiq	Sjabloon:Bron?
Template:Tnavbar	Sjabloon:Tnavbar
Template:Clear	Sjabloon:Clearboth
Template:Nowrap	Sjabloon:Nowrap
Millan	Oplossing (scheikunde)
Wikipedia:Maqaalada aan u baahan laheen	Wikipedia:Archief/Wikipedia:Artikelen die elke Wikipedia zou moeten hebben
Category:Afrika	Categorie:Afrika
Category:Elektaroonig	Categorie:Elektronica
Category:Kitaabka quduska	Categorie:Bijbel
Category:Buugta	Categorie:Boek
Category:Bilaha	Categorie:Maand
Template:Babel	Sjabloon:Babel
Template:Reflist	Sjabloon:References
Category:Isbitaal	Categorie:Ziekenhuis
Wikipedia:Soo bandhigida xogta	Wikipedia:Bronvermelding
Wikipedia:Habka maqaalada Xulka Ah	Wikipedia:Etalage/Wat is een etalageartikel
Template:Digniin	Sjabloon:Stop
Template:Gumud	Sjabloon:Beginnetje
Template:User ar-1	Sjabloon:Gebruiker ar-1
Template:See also	Sjabloon:Zie ook
Template:User da-2	Sjabloon:Gebruiker da-2
Template:User da	Sjabloon:Gebruiker da
Template:User de	Sjabloon:Gebruiker de
Template:User de-1	Sjabloon:Gebruiker de-1
Template:User es	Sjabloon:Gebruiker es
Template:User de-3	Sjabloon:Gebruiker de-3
Template:User en-3	Sjabloon:Gebruiker en-3
Template:User en-1	Sjabloon:Gebruiker en-1
Template:User en-2	Sjabloon:Gebruiker en-2
Template:User en-4	Sjabloon:Gebruiker en-4
Template:User fi	Sjabloon:Gebruiker fi
Template:User en	Sjabloon:Gebruiker en
Template:User de-2	Sjabloon:Gebruiker de-2
Template:User fi-1	Sjabloon:Gebruiker fi-1
Template:User fr-1	Sjabloon:Gebruiker fr-1
Template:User sk	Sjabloon:Gebruiker sk
Template:User fr-2	Sjabloon:Gebruiker fr-2
Template:User ja	Sjabloon:Gebruiker ja
Template:User ja-1	Sjabloon:Gebruiker ja-1
Template:User fr	Sjabloon:Gebruiker fr
Category:Aasiya	Categorie:Azië
Category:Jili	Categorie:Chili
Category:Ameerikada koonfureed	Categorie:Zuid-Amerika
Template:Mod	Sjabloon:Modulo
Template:User es-2	Sjabloon:Gebruiker es-2
Template:Image label	Sjabloon:Afbeelding label
Template:Dalalka Afrika	Sjabloon:Navigatie landen Afrika
Template:Kutaal	Sjabloon:Tabel windroos
Template:Sidebar	Sjabloon:Zijbalk generiek
Wikipedia:Tutorial (Wikipedia links)	Wikipedia:Snelcursus (Wikipedia links)
Template:Maqaal Xul Ah	Sjabloon:Etalage
Category:Gaana	Categorie:Ghana
Category:User en	Categorie:Wikipedia:Gebruiker en
Category:User en-2	Categorie:Wikipedia:Gebruiker en-2
Template:Infobox	Sjabloon:Infobox generiek
Template:User eo	Sjabloon:Gebruiker eo
Template:User zh	Sjabloon:Gebruiker zh
Category:Farta	Categorie:Alfabet
Template:Min	Sjabloon:Min
Category:Astaannta Qaranka	Categorie:Wapen (heraldiek)
Category:Beeraha	Categorie:Landbouw
Template:Maamulka	Sjabloon:Link moderator
Category:Dowladaha	Categorie:Staat
Hiilalaaye	Hilalaye
Category:Falastiin	Categorie:Palestina
Category:Language user templates	Categorie:Wikipedia:Sjablonen babel
Template:Farac	Sjabloon:Infobox volk
Template:Macluumaad Qof Madax Ah	Sjabloon:Infobox ambtsbekleder
Category:Kacaanka	Categorie:Revolutionair
Template:Border	Sjabloon:Border
Category:Qoraaga	Categorie:Schrijver
Category:Jaamacadaha	Categorie:Universiteit
Template:User pt-1	Sjabloon:Gebruiker pt-1
Template:User nl	Sjabloon:Gebruiker nl
Template:Infobox website	Sjabloon:Infobox website
Template:Image label end	Sjabloon:Afbeelding label eind
Template:Documentation subpage	Sjabloon:Sjabdoc direct
Template:Infobox number	Sjabloon:Infobox getal
Template:Please don't change this page	Wikipedia:Archief/Wikipedia:Introductie 2
Category:Dekedaha	Categorie:Haven
Template:Macluumaad askariga	Sjabloon:Infobox militair persoon
Template:User	Sjabloon:Gebruikerlinks
Template:PD-because	Sjabloon:Sjabloon verwijderd
Template:Infobox former country	Sjabloon:Infobox historisch land
Template:Infobox Political post	Sjabloon:Infobox politiek ambt
Portal:Fiisikis	Portaal:Natuurkunde
Template:Usbuuc	Sjabloon:Zijbalk weekdagen
Template:Hooyga Maqaalada	Portaal:Wetenschapsgeschiedenis/Navigatiebalk
Category:Booliis	Categorie:Politie
Template:Astaamayn	Sjabloon:Zijbalk leestekens
Template:User sandbox	Sjabloon:Hoofding gebruikerskladblok
Template:User pt-3	Sjabloon:Gebruiker pt-3
Template:User pt-2	Sjabloon:Gebruiker pt-2
Category:Qalabka Waxlagu kariyo	Categorie:Keukenapparatuur
Category:User sk	Categorie:Wikipedia:Gebruiker sk
Category:User eo	Categorie:Wikipedia:Gebruiker eo
Category:User ja	Categorie:Wikipedia:Gebruiker ja
Category:User da-2	Categorie:Wikipedia:Gebruiker da-2
Category:Ganacsi	Categorie:Bedrijfsleven
Template:Correct title	Sjabloon:Titelcorrectie
Category:User ar	Categorie:Wikipedia:Gebruiker ar
Category:Jasiirad	Categorie:Eiland
Category:User da	Categorie:Wikipedia:Gebruiker da
Category:User sk-N	Categorie:Wikipedia:Gebruiker sk-M
Category:User de	Categorie:Wikipedia:Gebruiker de
Category:User fi	Categorie:Wikipedia:Gebruiker fi
Category:Nabiyada Islaamka	Categorie:Profeet uit de Koran
Template:Lambarada	Sjabloon:Zijbalk getalverzamelingen
Category:User ja-1	Categorie:Wikipedia:Gebruiker ja-1
Category:User ko	Categorie:Wikipedia:Gebruiker ko
Template:Macluumaad	Sjabloon:Information
Template:Biological classification	Sjabloon:Zijbalk biologische taxonomie
Wikipedia:Babel	Wikipedia:Babel
Template:Help contents back	Sjabloon:Help inhoud terug
Category:Abwaanada	Categorie:Dichter
Category:Badaha	Categorie:Zee
Category:Ingiriiska	Categorie:Engeland
Category:Taariikhda Soomaaliya	Categorie:Geschiedenis van Somalië
Category:Ururada caalamiga ah	Categorie:Internationale organisatie
Category:Gobolada Soomaaliya	Categorie:Regio van Somalië
Category:Juquraafiga Soomaaliya	Categorie:Geografie van Somalië
Category:Madaxda Soomaaliya	Categorie:President van Somalië
Category:Cilmiga bulshada	Categorie:Sociale wetenschap
Category:Wadamada Afrika	Categorie:Land in Afrika
Template:User da-3	Sjabloon:Gebruiker da-3
Template:User pt-4	Sjabloon:Gebruiker pt-4
Category:User so	Categorie:Wikipedia:Gebruiker so
Category:User so-N	Categorie:Wikipedia:Gebruiker so-M
Fenerbahce SK	Fenerbahçe SK
Universidade Federal do Recôncavo da Bahia	Universidade Federal do Recôncavo da Bahia
Category:Farshaxanka	Categorie:Kunstschilder
Wikipedia:Xeerka adeegsiga sawirada	Wikipedia:Beleid voor gebruik van media
Template:Raadiyoow	Sjabloon:Infobox radiozender
Category:Dhirta	Categorie:Boom (plant)
Portal:Baayooloji	Portaal:Biologie
Template:Mashquul	Sjabloon:Druk
Category:Juquraafiga Hindiya	Categorie:Geografie van India
Category:Jabuuti	Categorie:Djibouti
Category:Ereteriya	Categorie:Eritrea
Category:Kiinya	Categorie:Kenia
Category:Komoros	Categorie:Comoren
Category:Libiya	Categorie:Libië
Category:Diinta Soomaaliya	Categorie:Religie in Somalië
Category:Bari	Categorie:Bari (Somalië)
Category:Bakool	Categorie:Bakool
Category:Baay	Categorie:Bay
Category:Banaadir	Categorie:Banadir
Category:Lacagta	Categorie:Munteenheid
Category:Webiyada	Categorie:Rivier
Category:Juquraafiga Jabuuti	Categorie:Geografie van Djibouti
Template:User pt	Sjabloon:Gebruiker pt
Category:Togdheer	Categorie:Togdheer
Category:Holland	Categorie:Holland
Category:Soomaaliya	Categorie:Somalië
Category:Webiyada Soomaaliya	Categorie:Rivier in Somalië
Category:Juquraafiga Yemen	Categorie:Geografie van Jemen
Category:Magaalooyinka Yemen	Categorie:Stad in Jemen
Category:User nl	Categorie:Wikipedia:Gebruiker nl
Category:Hay'ada laanqayrta cas	Categorie:Rode Kruis
Category:Suuriya	Categorie:Syrië
Category:Qarnigii 16aad	Categorie:16e eeuw
Category:Qooriyada	Categorie:Strand
Category:Filasoofiyaasha Jarmalka	Categorie:Duits filosoof
Category:Shabeellaha Hoose	Categorie:Neder-Shabelle
Category:Shabeellaha Dhexe	Categorie:Midden-Shabelle
Codweyne	Oodweyne
Category:Harraha Afrika	Categorie:Meer in Afrika
Category:Madaxda Faransiiska	Categorie:President van Frankrijk
Category:Madaxda Iiraan	Categorie:President van Iran
Category:Norway	Categorie:Noorwegen
Category:Yemen	Categorie:Jemen
Category:Malaay	Categorie:Vis
Category:Mutolojiyada	Categorie:Mythologie
Category:Qaamuus	Categorie:Woordenboek
Category:Axdiga Cusub	Categorie:Nieuwe Testament
Category:Mudug	Categorie:Mudug
Category:Dhaqanka Soomaalida	Categorie:Cultuur in Somalië
Category:Wikimedia	Categorie:Wikimedia
Category:Radio	Categorie:Radio
Category:Xayawaan	Categorie:Dierenrijk
Category:Jamhuriyadda	Categorie:Republiek
Category:Muqdisho	Categorie:Mogadishu
Category:Nugaal	Categorie:Nugaal
Category:Hiiraan	Categorie:Hiiraan
Category:Bartamaha Ameerika	Categorie:Midden-Amerika
Category:Caasimadaha	Categorie:Hoofdstad
Category:Magaalooyinka Hindiya	Categorie:Stad in India
Category:Isgaarsiinta	Categorie:Telecommunicatie
Category:Gaadiidka	Categorie:Vervoer
Category:Woqooyi Galbeed	Categorie:Woqooyi Galbeed
Category:Ameerikada waqooyi	Categorie:Noord-Amerika
Category:Harraha	Categorie:Meer
Category:Saxaabada	Categorie:Sahaba
Category:Calamada	Categorie:Vlag
Template:Macluumaad luqadda	Sjabloon:Infobox taal
Category:Dimoqraadi	Categorie:Democratie
Kaaroot	Wortel (groente)
Category:Caasimadaha afrika	Categorie:Hoofdstad in Afrika
Category:Komunistiyaasha Jarmalka	Categorie:Duits communist
Category:Magaalooyinka Soomaaliya	Categorie:Stad in Somalië
Category:Magaalooyinka Jabuuti	Categorie:Stad in Djibouti
Category:Guurka	Categorie:Huwelijk
Template:So	Sjabloon:So
Category:Caasimadaha yurub	Categorie:Hoofdstad in Europa
Category:Somaliland	Categorie:Somaliland
Category:Caafimaadka	Categorie:Gezondheid
Portal:Xisaab	Portaal:Wiskunde
Trojany	Trojany (Mazovië)
Category:Wadamada Aasiya	Categorie:Land in Azië
Portal:Siyaasadda	Portaal:Politiek
Category:Abidjan	Categorie:Abidjan
Tiirarka Iimaanka	Zuilen van geloof
Category:Antananarifo	Categorie:Antananarivo
Category:Awdal	Categorie:Awdal
Category:Bamako	Categorie:Bamako
Template:Colonne	Sjabloon:BeginKolommen
Eray bixin	Terminologie
Category:Jabuuti (magaalo)	Categorie:Djibouti (stad)
Category:Esperanto	Categorie:Esperanto
Category:Galguduud	Categorie:Galguduud
Category:Gedo	Categorie:Gedo
Khilaafadii Umawiyiinta	Omajjaden
Portal:Kimistari	Portaal:Scheikunde
Category:Linux	Categorie:Linux
Category:Jubbada Hoose	Categorie:Neder-Juba
Category:Jubbada Dhexe	Categorie:Midden-Juba
Category:Sanaag	Categorie:Sanaag
Category:Qabaa'ilada Soomaaliya	Categorie:Somalische clan
Category:Sool	Categorie:Sool
Category:Siyaasada Soomaaliya	Categorie:Politiek in Somalië
Category:Komunistiyaasha	Categorie:Communist
Category:Qiyaasaha Masaafooyinka	Categorie:Lengtemaat
Category:Midabada	Categorie:Kleur
Category:Triboli	Categorie:Tripoli
Category:User nl-4	Categorie:Wikipedia:Gebruiker nl-4
Wikipedia:Habka Maqaalada Cusub	Wikipedia:Archief/Wikipedia:Lezenswaardig/Wat is Lezenswaardig?
Template:Image label begin	Sjabloon:Afbeelding label begin
Category:Suuradaha Qur'aanka	Categorie:Soera
Category:User en-1	Categorie:Wikipedia:Gebruiker en-1
Category:Qabaa'ilada	Categorie:Clan
Portal:Caafimaad	Portaal:Geneeskunde
Kalagoyn	Minteken
Wikipedia:Tutorial (Talk pages)	Wikipedia:Snelcursus/Overlegpagina's
Wikipedia:Tutorial (Keep in mind)	Wikipedia:Snelcursus (Onthoud)
Template:User nl-3	Sjabloon:Gebruiker nl-3
Wikipedia:Tutorial (Wrap-up and more info)	Wikipedia:Snelcursus/Tot slot
Wikipedia:Tutorial (Registration)	Wikipedia:Snelcursus (Registratie)
Parvoviruses	Parvovirus
Rooman	Romeins aquaduct
Kim Cesarion	Kim Cesarion
Xandha	Xandha
Adnan Januzaj	Adnan Januzaj
Special:RecentChanges	Speciaal:RecenteWijzigingen
Aqriste	Reader
Sodoh	Schoonouder
Budunbuto	Budunbuto (Nugaal)
Category:Wabiyada Afrika	Categorie:Rivier in Afrika
Geesaley	Geesaley
Kurtunwaarey	Kurtunwaarey
Allaybaday	Allaybaday
