阿非利加洲	Afrika
日本	Japan
挪威	Noorwegen
英格蘭	Engeland
蘇格蘭	Schotland
愛爾蘭共和國	Ierland (land)
匈牙利	Hongarije
西班牙	Spanje
美國	Verenigde Staten
比利時	België
盧森堡	Luxemburg (land)
宇宙	Heelal
坤輿	Aarde (planeet)
死	Dood
人	Mens
華盛頓	George Washington
芬蘭	Finland
瑞典	Zweden
丹麥	Denemarken
波蘭	Polen
立陶宛	Litouwen
義大利	Italië
瑞士	Zwitserland
奧地利	Oostenrijk
希臘共和國	Griekenland
土耳其	Turkije
啤酒	Bier
葡萄牙	Portugal
歐羅巴洲	Europa (werelddeel)
亞細亞洲	Azië
南極洲	Antarctica
維基大典	Wikipedia
荷蘭	Nederland
紐約市	New York City
華盛頓哥倫比亞特區	Washington D.C.
柏林	Berlijn
電腦	Computer
共筆臺	MediaWiki
倫敦	Londen
巴黎	Parijs
安卓	Android (besturingssysteem)
谷歌	Google Inc.
墨西哥	Mexico (land)
太平洋	Grote Oceaan
熒惑	Mars (planeet)
衣索比亞	Ethiopië
迦納	Ghana
法國	Frankrijk
世界語	Esperanto
犬	Hond
英國	Verenigd Koninkrijk
貓	Kat (dier)
中華人民共和國	Volksrepubliek China
法蘭西語	Frans
維基爾雅	Wiktionary
乙醇	Ethanol
巴西	Brazilië
醇	Alcohol (stofklasse)
俄羅斯	Rusland
光導纖維	Optische vezel
正方形	Vierkant (meetkunde)
圓周率	Pi (wiskunde)
共筆	Wiki
魁北克	Quebec (provincie)
維基媒體基金會	Wikimedia Foundation
威霽彌	Jimmy Wales
德國	Duitsland
白俄羅斯	Wit-Rusland
德語	Duits
冰島	IJsland
愛沙尼亞	Estland
鎮星	Saturnus (planeet)
飛機	Vliegtuig
一	1 (getal)
二	2 (getal)
三	3 (getal)
〇	0 (getal)
無限	Oneindigheid
拉脫維亞	Letland
烏克蘭	Oekraïne
捷克	Tsjechië
斯洛伐克	Slowakije
羅馬尼亞	Roemenië
保加利亞	Bulgarije
羅馬	Rome (stad)
馬其頓	Macedonië (land)
格陵蘭	Groenland
哈薩克	Kazachstan
古巴	Cuba (land)
印度尼西亞	Indonesië
莫扎特	Wolfgang Amadeus Mozart
貝多芬	Ludwig van Beethoven
南非	Zuid-Afrika
商博良	Jean-François Champollion
阿爾及利亞	Algerije
水	Water
電視	Televisie
智利	Chili
耶穌	Jezus (traditioneel-christelijk)
伽利略	Galileo Galilei
辰星	Mercurius (planeet)
史	Geschiedenis
蘋果公司	Apple Inc.
太白	Venus (planeet)
語言	Taal
愛	Liefde
歲星	Jupiter (planeet)
銀河	Melkweg (sterrenstelsel)
大霹靂	Oerknal
天王星	Uranus (planeet)
英文維基大典	Engelstalige Wikipedia
海王星	Neptunus (planeet)
新加坡	Singapore
格致	Wetenschap
冥王星	Pluto (dwergplaneet)
列支敦士登	Liechtenstein
希特勒	Adolf Hitler
臉書	Facebook
第一次世界大戰	Eerste Wereldoorlog
第二次世界大戰	Tweede Wereldoorlog
烏邦土	Ubuntu (Linuxdistributie)
數學	Wiskunde
拉丁語	Latijn
巴林	Bahrein
塞爾維亞	Servië
月	Maan
澳大利亞	Australië (land)
物理	Natuurkunde
阿根廷	Argentinië
秘魯	Peru
生物學	Biologie
朝鮮民主主義人民共和國	Noord-Korea
柬埔寨	Cambodja
古蘭經	Koran
恐龍	Dinosauriërs
回教	Islam
大英百科	Encyclopædia Britannica
歐羅巴聯盟	Europese Unie
朋友	Vriendschap
馬里亞納海溝	Marianentrog
珠穆朗瑪峰	Mount Everest
拿破崙一世	Napoleon Bonaparte
恆星	Ster (hemellichaam)
日	Zon
巴斯特	Louis Pasteur
光年	Lichtjaar
大洋洲	Oceanië
太陽系	Zonnestelsel
氫	Waterstof (element)
氦	Helium
維基共享	Wikimedia Commons
鋰	Lithium (element)
鈹	Beryllium
日（曆法）	Dag
東帝汶	Oost-Timor
夜	Nacht
黑洞	Zwart gat
穀神星	Ceres (dwergplaneet)
妊神星	Haumea
鳥神星	Makemake
鬩神星	Eris (dwergplaneet)
硼	Boor (element)
碳	Koolstof
氮	Stikstof (element)
氧	Zuurstof (element)
行星	Planeet
威尼斯	Venetië (stad)
火影忍者	Naruto (manga)
莫斯科	Moskou
氟	Fluor (element)
義大利語	Italiaans (taal)
氖	Neon (element)
鈉	Natrium
鎂	Magnesium
鋁	Aluminium
紐西蘭	Nieuw-Zeeland
印度	India
硅	Silicium
磷	Fosfor
鐵	IJzer (element)
硫	Zwavel
東	Oost (windstreek)
氯	Chloor (element)
巴布亞新幾內亞	Papoea-Nieuw-Guinea
莎士比亞	William Shakespeare
氬	Argon
鉀	Kalium
鈣	Calcium
鉛	Lood (element)
蒙古國	Mongolië
鈧	Scandium
鈦	Titanium
委內瑞拉	Venezuela
成吉思汗	Dzjengis Khan
釩	Vanadium
鉻	Chroom (element)
阿姆斯特丹	Amsterdam
動物	Dierenrijk
錳	Mangaan
哥倫比亞	Colombia
鈷	Kobalt
鎢	Wolfraam
鎳	Nikkel
佛教	Boeddhisme
玻利維亞	Bolivia
銅	Koper (element)
千里達及托巴哥	Trinidad en Tobago
植物	Planten
鋅	Zink (element)
真菌	Schimmels
牙買加	Jamaica
夏威夷	Hawaï
海地	Haïti
伊朗	Iran
伊拉克	Irak
哥斯大黎加	Costa Rica
以色列	Israël
巴拿馬	Panama (land)
科威特	Koeweit
老撾	Laos
馬爾地夫	Maldiven
亞美利加洲	Amerika (continent)
馬來西亞	Maleisië
緬甸	Myanmar
尼泊爾	Nepal
阿曼	Oman
巴基斯坦	Pakistan
卡達國	Qatar
沙特阿拉伯	Saoedi-Arabië
斯里蘭卡	Sri Lanka
斯大林	Jozef Stalin
柏拉圖	Plato
鎵	Gallium
神奇寶貝	Pokémon
中華民國	Taiwan
鍺	Germanium
泰國	Thailand
砒	Arseen
硒	Seleen
溴	Broom (element)
鉑	Platina
越南	Vietnam
大韓民國	Zuid-Korea
氪	Krypton (element)
阿富汗	Afghanistan
江南風	Gangnam Style
銣	Rubidium
金	Goud
蘇彝士運河	Suezkanaal
孟加拉國	Bangladesh
蘇格拉底	Socrates (filosoof)
安哥拉	Angola
不丹	Bhutan
汶萊	Brunei
汞	Kwik
菲律賓	Filipijnen
中非	Centraal-Afrikaanse Republiek
鉈	Thallium
南極	Zuidpool
北極	Noordpool
牛頓	Isaac Newton
鍶	Strontium
釔	Yttrium
鉍	Bismut
尚比亞	Zambia
津巴布韋	Zimbabwe
北京市	Peking
南蘇丹	Zuid-Soedan
海參崴	Vladivostok
波札那	Botswana
剛果民主共和國	Congo-Kinshasa
吉布提	Djibouti (land)
加蓬	Gabon
甘地	Mohandas Karamchand Gandhi
利比亞	Libië
馬達加斯加	Madagaskar
摩洛哥	Marokko
莫桑比克	Mozambique
納米比亞	Namibië
尼日利亞	Nigeria
烏干達	Oeganda
索馬里	Somalië
凱撒	Julius Caesar
蘇丹	Soedan
斯威士蘭	Swaziland
鍀	Technetium
天演	Evolutie (biologie)
聯合國	Verenigde Naties
地理學	Aardrijkskunde
腦	Hersenen
布拉格	Praag
銀	Zilver
錫	Tin (element)
鈾	Uranium
鈈	Plutonium
碘	Jodium (element)
氙	Xenon
銫	Cesium
鐳	Radium
氡	Radon (element)
賈坎德邦	Jharkhand
耶路撒冷	Jeruzalem
印度洋	Indische Oceaan
科索沃	Kosovo
蕭邦	Frédéric Chopin
Category:類	Categorie:Alles
帕斯卡	Blaise Pascal
冬	Winter
春	Lente
夏	Zomer
秋	Herfst
薩達姆·海珊	Saddam Hoessein
拉登	Osama bin Laden
西班牙語	Spaans
巴赫	Johann Sebastian Bach
泉幣	Geld
奧古斯都	Imperator Caesar Augustus
諾基亞	Nokia (bedrijf)
德克薩斯州	Texas (staat)
布宜諾斯艾利斯	Buenos Aires (stad)
東京都	Tokio
密西西比河	Mississippi (rivier)
錫金	Sikkim
尼爾杭思朗	Neil Armstrong
斯德哥爾摩	Stockholm
墓誌	Grafschrift
里加	Riga
聖經	Bijbel (christendom)
金邊	Phnom Penh
真耶穌教會	Ware Jezuskerk
英語	Engels
曼谷	Bangkok
臺北市	Taipei (stad)
鎇	Americium
康賽普西翁	Concepción (Chili)
緬尼托巴	Manitoba
孔斯科沃拉	Końskowola
公元二千年	2000
二〇〇三年	2003
二〇〇二年	2002
二〇〇一年	2001
二〇一二年	2012
二〇一一年	2011
二〇一〇年	2010
二〇〇九年	2009
二氧化碳	Koolstofdioxide
二〇一三年	2013
二〇一四年	2014
二〇一五年	2015
二〇〇八年	2008
二〇〇四年	2004
二〇〇五年	2005
二〇〇六年	2006
二〇〇七年	2007
一氧化碳	Koolstofmonoxide
戴高樂	Charles de Gaulle
一九九二年	1992
一九九一年	1991
一九九〇年	1990
一九九三年	1993
一九九四年	1994
一九九五年	1995
一九九六年	1996
可縮放矢量圖形	Scalable Vector Graphics
萊比錫	Leipzig
一九九七年	1997
一九九八年	1998
一九九九年	1999
食物	Voedsel
光速	Lichtsnelheid
公曆一月一日	1 januari
公曆一月二日	2 januari
公曆一月三日	3 januari
公曆一月四日	4 januari
矮行星	Dwergplaneet
公曆一月五日	5 januari
公曆一月六日	6 januari
電子	Elektron
公曆一月七日	7 januari
公曆一月八日	8 januari
公曆一月九日	9 januari
公曆一月十日	10 januari
公曆一月十一日	11 januari
公曆一月十二日	12 januari
公曆一月十三日	13 januari
公曆一月十四日	14 januari
公曆一月十五日	15 januari
工業革命	Industriële revolutie
苯	Benzeen
微軟	Microsoft
質子	Proton (deeltje)
庫魯夫	Kurów (powiat Puławski)
公曆二月五日	5 februari
公曆二月八日	8 februari
化學	Scheikunde
中子	Neutron
公曆二月廿九日	29 februari
公曆三月十四日	14 maart
一九八九年	1989
一九八八年	1988
一九八七年	1987
一九八六年	1986
一九八五年	1985
一九八四年	1984
一九八三年	1983
一九八二年	1982
一九八一年	1981
一九八〇年	1980
一九七〇年	1970
一九七一年	1971
一九七二年	1972
一九七三年	1973
一九七四年	1974
一九七五年	1975
一九七六年	1976
一九七七年	1977
一九七八年	1978
一九七九年	1979
一九六九年	1969
公曆四月五日	5 april
衛星	Natuurlijke maan
公曆五月四日	4 mei
土衛六	Titan (maan)
一九六八年	1968
一九六七年	1967
一九六六年	1966
一九六五年	1965
一九六四年	1964
公曆六月廿日	20 juni
公曆七月廿三日	23 juli
足球	Voetbal
一九六三年	1963
一九六二年	1962
公曆九月十日	10 september
公曆十二月卅一日	31 december
公曆十月十日	10 oktober
灶神星	Vesta (planetoïde)
查理曼	Karel de Grote
木衛一	Io (maan)
木衛四	Callisto (maan)
木衛二	Europa (maan)
木衛三	Ganymedes (maan)
火	Vuur
新南威爾士州	Nieuw-Zuid-Wales
土衛二	Enceladus (maan)
天衛三	Titania (maan)
海衛一	Triton (maan)
雅加達	Jakarta
一九六一年	1961
Category:模板	Categorie:Wikipedia:Sjablonen
一九六〇年	1960
小行星	Planetoïde
日食	Zonsverduistering
二進制	Binair
阿斯圖里亞斯	Asturië (regio)
維基大典:沙盒	Wikipedia:Zandbak
卡爾梅克共和國	Kalmukkië
代數學	Algebra
地圖	Kaart (cartografie)
阿拉貢自治區	Aragón (regio)
前卅三年	33 v.Chr.
硫酸	Zwavelzuur
同海機場	Luchthaven Đồng Hới
Category:大韓民國紀事	Categorie:Geschiedenis van Zuid-Korea
Category:日本史	Categorie:Geschiedenis van Japan
伯力	Chabarovsk
Category:越南史	Categorie:Geschiedenis van Vietnam
孔子	Confucius
莎拉伯恩哈特	Sarah Bernhardt
Category:伊拉克史	Categorie:Geschiedenis van Irak
南加州大学	University of Southern California
Category:數學	Categorie:Wiskunde
Category:蒙古史	Categorie:Geschiedenis van Mongolië
Category:人造語言	Categorie:Kunsttaal
文藝復興	Renaissance
歐元	Euro
美金	Amerikaanse dollar
地中海	Middellandse Zee
遼	Liao-dynastie
杭州市	Hangzhou
基督教	Christendom
Template:亞洲	Sjabloon:Navigatie landen Azië
Template:然也	Sjabloon:Voor
金朝	Jin-dynastie (1115-1234)
柏林圍牆	Berlijnse Muur
稻	Rijst
大陸	Continent
京	Hoofdstad
Template:門	Sjabloon:Link portaal
一九四八年	1948
艾爾瑪善鎮	Almazán (gemeente)
一九四五年	1945
一九五八年	1958
日語	Japans
百科全書	Encyclopedie
維基大典:卷首	Hoofdpagina
一九五九年	1959
電晶體	Transistor
棒球	Honkbal
奧林匹克運動會	Olympische Spelen
長江	Jangtsekiang
喜瑪拉雅山	Himalaya
落磯山	Rocky Mountains
韃靼斯坦共和國	Tatarije
一二六三年	1263
古斯巴達	Sparta (Griekenland)
埃斯特雷馬杜拉	Extremadura
安達盧西亞	Andalusië
麥加	Mekka
毛澤東	Mao Zedong
西安市	Xi'an
拉薩市	Lhasa
哲學	Filosofie
Category:速刪候	Categorie:Wikipedia:Nuweg
茶	Thee (drank)
馬可·波羅	Marco Polo
一三六三年	1363
共產主義	Communisme
一三六八年	1368
迦太基	Carthago
大英博物館	British Museum
巴拉頓湖	Balatonmeer
蒙庇利埃	Montpellier
Category:天文	Categorie:Astronomie
吉他	Gitaar
同性戀	Homoseksualiteit
漢堡包	Hamburger
夸克	Quark
高斯	Carl Friedrich Gauss
一六四四年	1644
一六四五年	1645
Category:恒星	Categorie:Ster
李白	Li Bai
伽羅華	Évariste Galois
政府	Regering
秦始皇帝	Qin Shi Huangdi
秦二世皇帝	Qin Er Shi
中東	Midden-Oosten
漢	Han-dynastie
漢太祖高皇帝	Han Gaozu
漢孝惠皇帝	Han Huidi
漢少帝恭	Han Qianshaodi
漢少帝弘	Han Houshaodi
漢太宗孝文皇帝	Han Wendi
漢孝景皇帝	Han Jingdi
漢世宗孝武皇帝	Han Wudi
聖女貞德	Jeanne d'Arc
漢孝昭皇帝	Han Zhaodi
漢中宗孝宣皇帝	Han Xuandi
漢孝元皇帝	Han Yuandi
王莽	Wang Mang
意理	Ideologie
帝國主義	Imperialisme
共和	Republiek
國	Staat
漢肅宗孝章皇帝	Han Zhangdi
漢孝和皇帝	Han Hedi
漢孝殤皇帝	Han Shangdi
漢孝安皇帝	Han Andi
漢少帝懿	Markgraaf van Beixiang
漢孝順皇帝	Han Shundi
漢孝沖皇帝	Han Chongdi
漢孝質皇帝	Han Zhidi
漢孝桓皇帝	Han Huandi
漢孝靈皇帝	Han Lingdi
漢少帝辯	Han Shaodi
元	Yuan-dynastie
漢孝獻皇帝	Han Xiandi
德意志第三帝國	Nazi-Duitsland
哥倫布	Christoffel Columbus
庫克船長	James Cook
科爾蒂斯	Hernán Cortés
鄭和	Zheng He
大堡礁	Groot Barrièrerif
巴拿馬運河	Panamakanaal
晉	Jin-dynastie (265-420)
黃河	Gele Rivier
晉武帝	Sima Yan
隋	Sui-dynastie
西夏	Westelijke Xia
脫氧核酸	Desoxyribonucleïnezuur
趙宋	Song-dynastie
歐拉	Leonhard Euler
一七七四年	1774
一七七五年	1775
一七七六年	1776
一八六六年	1866
一八六七年	1867
一八六八年	1868
晝	Ochtend
拿破崙二世	Napoleon II
砒霜	Arseen(III)oxide
法律	Recht
一七九四年	1794
世界人權宣言	Universele verklaring van de rechten van de mens
一七九五年	1795
一七九六年	1796
漢語	Chinese talen
細胞	Cel (biologie)
全球暖化	Opwarming van de Aarde
禪宗	Zen
鼠標	Muis (computer)
聖奧思定	Augustinus van Hippo
精靈	Fee
朊	Proteïne
理則	Logica
龍捲風	Tornado (wervelwind)
幾何	Meetkunde
語法	Grammatica
熱帶氣旋	Tropische cycloon
計學	Economie
語言學	Taalkunde
文字	Schrift
阿拉伯字	Arabisch alfabet
漢字	Hanzi
西里爾字母	Cyrillisch alfabet
孫子兵法	De kunst van het oorlogvoeren
Category:音樂	Categorie:Muziek
紅樓夢	Droom van de rode kamer
Category:法國史	Categorie:Geschiedenis van Frankrijk
哈利波特	Harry Potter (boekenreeks)
放手銃	Masturbatie
法文維基大典	Franstalige Wikipedia
死刑	Doodstraf
人權	Rechten van de mens
乳	Melk (drank)
山	Berg (landvorm)
沙漠	Woestijn
孫文	Sun Yat-sen
薩拉丁	Saladin
阿育王	Asoka
阿克巴大帝	Akbar de Grote
香港	Hongkong
韓戰	Koreaanse Oorlog
南北戰爭	Amerikaanse Burgeroorlog
首爾特別市	Seoel
上海市	Shanghai
清	Qing-dynastie
越戰	Vietnamoorlog
歐几里得	Euclides van Alexandrië
巴斯克語	Baskisch
星座	Sterrenbeeld
拉脫維亞語	Lets
原子	Atoom
宗教	Religie
朝鮮語	Koreaans
笛卡兒	René Descartes
官話	Mandarijn (taal)
越南語	Vietnamees
猶太教	Jodendom
老子	Laozi
電鼠	Pikachu
尼采	Friedrich Nietzsche
司馬遷	Sima Qian
斯密亞丹	Adam Smith
朱熹	Zhu Xi
廷巴克圖	Timboektoe (stad)
洋	Oceaan
阿奎那	Thomas van Aquino
英王維多利亞	Victoria van het Verenigd Koninkrijk
釋迦牟尼	Gautama Boeddha
馬丁·路德	Maarten Luther
儒家	Confucianisme
腹	Buik
陰脈	Ader (anatomie)
福克蘭群島	Falklandeilanden
陽脈	Slagader
唐	Tang-dynastie
威爾斯王妃黛安娜	Diana Spencer
唐高祖	Tang Gaozu
唐太宗	Tang Taizong
唐玄宗	Tang Xuanzong
唐德宗	Tang Dezong
唐憲宗	Tang Xianzong
唐宣宗	Tang Xuānzong
小學	Lagere school
明	Ming-dynastie
明太祖	Hongwu
明惠宗	Jianwen
明成祖	Yongle
明仁宗	Hongxi
明宣宗	Xuande
明英宗	Zhengtong
明代宗	Jingtai (keizer)
明憲宗	Chenghua
明孝宗	Hongzhi
明武宗	Zhengde
明世宗	Jiajing
明穆宗	Longqing
明神宗	Wanli
明光宗	Taichang
明熹宗	Tianqi
明思宗	Chongzhen
電漿	Plasma (aggregatietoestand)
金正日	Kim Jong-il
元素週期表	Periodiek systeem
自殺	Zelfmoord
九一一事件	Aanslagen op 11 september 2001
電話	Telefoontoestel
梵語	Sanskriet
化合物	Samengestelde stof
算術	Rekenen
食鹽	Keukenzout
化學元素	Chemisch element
方程	Vergelijking (wiskunde)
映射	Functie (wiskunde)
角	Hoek (meetkunde)
分子	Molecuul
加速度	Versnelling (natuurkunde)
能量	Energie
弈	Go (bordspel)
金屬	Metaal
氣體	Gas (aggregatietoestand)
液體	Vloeistof
固體	Vaste stof
船舶	Schip (transportmiddel)
農	Landbouw
速度	Snelheid
納米科技	Nanotechnologie
勾股定理	Stelling van Pythagoras
證明	Wiskundig bewijs
數	Getal (wiskunde)
複數	Complex getal
公斤	Kilogram
公尺	Meter
大麥	Gerst
繪畫	Schilderkunst
華爾街	Wall Street
美國總統	President van de Verenigde Staten
東南亞	Zuidoost-Azië
瀋陽市	Shenyang
重慶市	Chongqing
天津市	Tianjin
武漢市	Wuhan
史前	Prehistorie
古埃及	Oude Egypte
白令海峽	Beringstraat
古希臘	Oude Griekenland
傑弗遜	Thomas Jefferson
希臘文維基大典	Griekse Wikipedia
麥	Tarwe
格里曆	Gregoriaanse kalender
拉丁文維基大典	Latijnse Wikipedia
麻雀 (棋牌)	Mahjong
鹽	Zouten
牛頓（單位）	Newton (eenheid)
度量衡	Meten
萬國公制	SI-stelsel
集論	Verzamelingenleer
哈里發塔	Burj Khalifa
長城	Chinese Muur
整數	Geheel getal
球	Bol (lichaam)
大憲章	Magna Carta
阿兹特克	Azteken
上塞納省	Hauts-de-Seine
東羅馬帝國	Byzantijnse Rijk
奧斯曼帝國	Ottomaanse Rijk
國內生產總值	Bruto binnenlands product
銃	Vuurwapen
伊比利半島	Iberisch Schiereiland
坦克	Tank (voertuig)
實數	Reëel getal
楈枒	Kokospalm
桃	Perzik
湘語	Xiangyu
冰酪	Roomijs
文胸	Beha
阿拉伯語	Arabisch
本州	Honshu
四國	Shikoku (eiland)
地中海氣候	Mediterraan klimaat
科西嘉	Corsica
頂級域名	Topleveldomein
斯洛文尼亞語維基大典	Sloveense Wikipedia
百度	Baidu
澳門	Macau
土衛一	Mimas (maan)
土衛四	Dione (maan)
土衛三	Tethys (maan)
土衛五	Rhea (maan)
廣東省	Guangdong
廣西壯族自治區	Guangxi
蘇聯	Sovjet-Unie
亡神星	Orcus
塞德娜	90377 Sedna
孟德斯鳩	Charles de Secondat, baron de La Brède et de Montesquieu
青馬大橋	Tsing Ma Brug
維基大典:卓著	Wikipedia:Etalage
Template:Link FA	Sjabloon:Link FA
維基大典:會館	Wikipedia:De kroeg
釜山廣域市	Busan
廣州市	Kanton (stad)
蔣中正	Chiang Kai-shek
南京市	Nanking
君士坦丁堡	Constantinopel
首爾地鐵	Metro van Seoel
北京大學	Universiteit van Peking
清華大學	Tsinghua-universiteit
烏魯木齊市	Ürümqi
江蘇省	Jiangsu
浙江省	Zhejiang
鄧小平	Deng Xiaoping
新好男孩	Backstreet Boys
西藏	Tibet (gebied)
西藏自治區	Tibetaanse Autonome Regio
圓	Cirkel
歐氏幾何	Euclidische ruimte
周恩來	Zhou Enlai
中國共產黨	Communistische Partij van China
馮諾曼	John von Neumann
偽基大典	Uncyclopedia
太平山	Victoria Peak
公理	Axioma
清聖祖	Kangxi
朝鮮文維基大典	Koreaanse Wikipedia
檀香山	Honolulu
紋章	Heraldiek
曼徹斯特聯足球俱樂部	Manchester United FC
平壤直轄市	Pyongyang
模 (代數)	Moduul
訓民正音	Hunmin Jeongeum
九	9 (getal)
清高宗	Qianlong
蕭伯納	George Bernard Shaw
黑龍江省	Heilongjiang
香港島	Hongkong (eiland)
鹼金屬	Alkalimetaal
非金屬	Niet-metaal
鹵素	Halogeen
稀有氣體	Edelgas
四川省	Sichuan
舊約	Oude Testament
聖誕節	Kerstmis
三角形	Driehoek (meetkunde)
印歐語系	Indo-Europese talen
穆阿邁爾·格達費	Moammar al-Qadhafi
獨島	Rotsen van Liancourt
江南區	Gangnam-gu
大田廣域市	Daejeon
大邱廣域市	Daegu
仁川國際機場	Incheon International Airport
仁川廣域市	Incheon
京畿道	Gyeonggi-do
自然數	Natuurlijk getal
萬國音標字	Internationaal Fonetisch Alfabet
河北省	Hebei
革奴自由文檔許可協議	GNU-licentie voor vrije documentatie
蛋撻	Eiertaartje
紐約	New York
公元元年	1
魯迅	Lu Xun (schrijver)
八	8 (getal)
馬德堡半球	Maagdenburger halve bollen
主禱文	Onzevader
蒜	Knoflook
白	Wit
黑	Zwart (kleur)
六九八年	698
巴爾幹半島	Balkan (schiereiland)
七二七年	727
墨索里尼	Benito Mussolini
四方	Windstreek
十	10 (getal)
原子序	Atoomnummer
九一八年	918
公元百年	100
五七〇年	570
四時	Seizoen
二二二年	222
利物浦	Liverpool
鐵達尼號	Titanic (schip, 1912)
五五二年	552
同位素	Isotoop
蜚蠊	Kakkerlakken
功率	Vermogen (natuurkunde)
螢	Glimwormen
索布語	Sorbisch
一八一二年戰爭	Oorlog van 1812
頂點	Knooppunt (wiskunde)
大理國	Koninkrijk van Dali
朝鮮正祖	Jeongjo van Joseon
福岡市	Fukuoka (stad)
建城	Ab urbe condita (jaartelling)
日本海	Japanse Zee
宮古列島	Miyako-eilanden
中亞	Centraal-Azië
琉球國	Koninkrijk Riukiu
朝鮮國	Joseondynastie
高麗國	Goryeo
大韓帝國	Keizerrijk Korea
渤海國	Bohai
高句麗	Koguryo
百濟	Paekche
新羅	Silla (Korea)
奧匈帝國	Oostenrijk-Hongarije
吸血鬼日記	The Vampire Diaries (televisieserie)
馬雅	Mayacultuur
印加國	Inca's
縣	County
韓非子	Han Fei
錦州市	Jinzhou
導數	Afgeleide
黃帝	Huang Di
釣魚臺列嶼	Senkaku-eilanden
中國	China
成都市	Chengdu
咖啡廳	Koffiehuis
蒲公英	Taraxacum
雪豹	Sneeuwpanter
白話維基大典	Chinese Wikipedia
二二一年	221
五四三年	543
五三六年	536
二三〇年	230
二〇二年	202
一九二年	192
總統	President
五五五年	555
五七一年	571
滿洲國	Mantsjoekwo
二三一年	231
二二五年	225
三一一年	311
二二〇年	220
三一三年	313
五八七年	587
五四八年	548
五四九年	549
五五一年	551
五五七年	557
二二三年	223
二二四年	224
二一九年	219
大運河	Grote Kanaal (China)
五八九年	589
華佗	Hua Tuo
三〇四年	304
五五〇年	550
五八六年	586
五八八年	588
五五四年	554
二二九年	229
五八三年	583
二六五年	265
二六三年	263
五八五年	585
五八二年	582
五五六年	556
四二〇年	420
二八〇年	280
五八一年	581
五五八年	558
國立臺灣大學	Nationale universiteit van Taiwan
國立中山大學	Nationale Sun Yat-sen Universiteit
客家語	Hakka (taal)
切羅基語	Cherokee (taal)
羅素悖論	Russellparadox
五六九年	569
贛語	Ganyu
爪哇語	Javaans
滿語	Mantsjoe (taal)
弧度	Radiaal (wiskunde)
五五三年	553
三〇七年	307
五八四年	584
杜甫	Du Fu
人口	Bevolking
瓦爾帕萊索	Valparaíso (stad)
青銅	Brons
情報及特殊使命局	Mossad
尼亞加拉瀑布	Niagarawatervallen
吳語	Wuyu
昭和天皇	Hirohito
基地組織	Al Qaida
穆罕默德二世	Mehmet II
希臘神話	Griekse mythologie
秦	Qin (staat)
新疆維吾爾族自治區	Sinkiang
郵局	Postkantoor
萬國首都全覽	Lijst van hoofdsteden
周	Zhou-dynastie
形而上學	Metafysica
白宮	Witte Huis (Washington D.C.)
北海道	Hokkaido (Japan)
科科斯（基林）群島	Cocoseilanden
胡志明	Hồ Chí Minh
明尼阿波利斯	Minneapolis
集	Verzameling (wiskunde)
順化市	Huế
閩東語	Mindong
閩南語	Minnanyu
離子	Ion (deeltje)
壯族	Zhuang (volk)
南斯拉夫	Joegoslavië
長毛象	Mammoeten
四邊形	Vierhoek
三船敏郎	Toshiro Mifune
文言	Klassiek Chinees
線	Lijn (meetkunde)
甲烷	Methaan
孫武	Sunzi
中央情報局	Central Intelligence Agency
語法學	Syntaxis (taalkunde)
聯合國安全理事會	Veiligheidsraad van de Verenigde Naties
眼鏡	Bril
火柴	Lucifer (voorwerp)
多邊形	Veelhoek
市場	Markt (economie)
南海	Zuid-Chinese Zee
朝鮮世宗	Sejong de Grote van Joseon
俳句	Haiku (dichtvorm)
黃海	Gele Zee
今上天皇	Akihito
橫濱市	Yokohama (stad)
普魯士	Pruisen
前四年	4 v.Chr.
柳州市	Liuzhou
皇帝	Keizer
索契	Sotsji
壓強	Druk (grootheid)
龍貓	My Neighbor Totoro
线粒体	Mitochondrion
吠陀	Veda's
橢圓	Ellips (wiskunde)
杠杆	Hefboom
自由亞洲電臺	Radio Free Asia
蟹	Krabben
前九十年	90 v.Chr.
酸鹼度	PH
美國革命	Amerikaanse Onafhankelijkheidsoorlog
安徽省	Anhui
前九十一年	91 v.Chr.
忠清北道	Chungcheongbuk-do
忠清南道	Chungcheongnam-do
內蒙古自治區	Binnen-Mongolië
金日成	Kim Il-sung
慶尚南道	Gyeongsangnam-do
慶尚北道	Gyeongsangbuk-do
全羅北道	Jeollabuk-do
全羅南道	Jeollanam-do
濟州特別自治道	Jeju-do
巴別塔	Toren van Babel
蔚山廣域市	Ulsan
光州廣域市	Gwangju
一元二次方程	Vierkantsvergelijking
李斯特	Franz Liszt
美式足球	American football
前八十七年	87 v.Chr.
哥德爾	Kurt Gödel
摩爾	Mol (eenheid)
華國鋒	Hua Guofeng
烷烴	Alkaan
希爾伯特	David Hilbert
前九十五年	95 v.Chr.
黃金分割	Gulden snede
福建省	Fujian (China)
班夫國家公園	Nationaal park Banff
查士丁尼一世	Justinianus I
前七十四年	74 v.Chr.
慶州市	Gyeongju
安東市	Andong (Zuid-Korea)
尚州市	Sangju
阿貝爾·塔斯曼	Abel Tasman
海南省	Hainan
功	Arbeid (natuurkunde)
漢語拼音	Hanyu pinyin
莽原氣候	Savanne (landschap)
甘肅省	Gansu
蘇州市	Suzhou (Jiangsu)
溫州市	Wenzhou
無錫市	Wuxi
湖州市	Huzhou
紹興市	Shaoxing
寧波市	Ningbo
紙鳶	Vliegeren
前二〇一年	201 v.Chr.
前二〇二年	202 v.Chr.
哈爾濱市	Harbin
油	Olie
拓撲學	Topologie
文身	Tatoeage
金融學	Financiën
雲南省	Yunnan
多項式	Polynoom
山東省	Shandong
中南半島	Indochina
天擇	Natuurlijke selectie
地質年代	Geologische tijdschaal
壟斷	Monopolie
河南省	Henan (China)
遼寧省	Liaoning
席德	Rodrigo Díaz de Vivar
刳剔者傑克	Jack the Ripper
前一五六年	156 v.Chr.
列奧尼達一世	Leonidas I van Sparta
前一三九年	139 v.Chr.
前一二二年	122 v.Chr.
前二〇六年	206 v.Chr.
西爾門·拉什迪	Salman Rushdie
前二〇三年	203 v.Chr.
化學鍵	Chemische binding
槍	Speer
前一四一年	141 v.Chr.
僧院	Klooster (gebouw)
白堊紀	Krijt (periode)
前二〇九年	209 v.Chr.
皮薩羅	Francisco Pizarro
點	Punt (wiskunde)
骰子	Dobbelsteen
吉林省	Jilin (provincie)
東海	Oost-Chinese Zee
前二三二年	232 v.Chr.
湖南省	Hunan
青海省	Qinghai
前一九七年	197 v.Chr.
前二〇七年	207 v.Chr.
前一八八年	188 v.Chr.
矢	Pijl (wapen)
前二〇五年	205 v.Chr.
鮨	Sushi
前二〇八年	208 v.Chr.
湖北省	Hubei
山西省	Shanxi
魔方	Rubiks kubus
伊洛瓦底省	Ayeyarwady
貴州省	Guizhou
京都議定書	Kyoto-protocol
聯合國大會	Algemene Vergadering van de Verenigde Naties
乙酸	Azijnzuur
安達曼海	Andamanse Zee
前二〇四年	204 v.Chr.
莊子	Zhuangzi
清孝欽顯皇后	Cixi (keizerin)
陝西省	Shaanxi
Template:共享類	Sjabloon:Commonscat
三八三年	383
德文維基大典	Duitstalige Wikipedia
拋物線	Parabool (wiskunde)
尿素	Ureum
平假名	Hiragana
波斯文維基大典	Perzische Wikipedia
質數	Priemgetal
五七二年	572
南北朝	Zuidelijke en Noordelijke Dynastieën
劉宋	Liu Song-dynastie
吾世	Minecraft
罷工	Staking
李舜臣汝諧	Yi Sun-sin
泰國地方	Provincies van Thailand
中華人民共和國地方	Provincies van China
日本都道府縣	Prefecturen van Japan
氧化物	Oxide
合數	Samengesteld getal
因數	Deler
口琴	Mondharmonica
朝鮮灣	Koreabaai
Template:Taxobox	Sjabloon:Taxobox
繩文時代	Jomonperiode
平行	Evenwijdig
百家姓	Baijiaxing
極品飛車	Need for Speed
海鳥	Zeevogel
閩語	Minyu
江西省	Jiangxi
阿卜杜拉·本·阿卜杜勒-阿齊茲·沙特	Abdoellah bin Abdoel Aziz al-Saoed
寧夏回族自治區	Ningxia
揚州市	Yangzhou
鎮江市	Zhenjiang
哈薩克文維基大典	Kazachse Wikipedia
嘉興市	Jiaxing
金華市	Jinhua
衢州市	Quzhou
台州市	Taizhou (Zhejiang)
舟山市	Zhoushan
石家莊市	Shijiazhuang
亞當與夏娃	Adam en Eva
珠海	Zhuhai
韶關市	Shaoguan
東莞市	Dongguan
俄羅斯正教會	Russisch-orthodoxe Kerk
鯢	Chinese reuzensalamander
空師	Luchtmacht
大名	Daimyo
苗栗縣	Miaoli (xiàn)
色盲檢測圖	Ishiharatest
威氏鷸	Amerikaanse watersnip
哈布斯堡氏	Huis Habsburg
中央銀行	Centrale bank
福州市	Fuzhou (Fujian)
南平市	Nanping
莆田市	Putian
三明市	Sanming
泉州市	Quanzhou
廈門市	Xiamen
漳州市	Zhangzhou
龍岩市	Longyan
寧德市	Ningde
西寧市	Xining
西遊記	De reis naar het westen
三國演義	Roman van de Drie Koninkrijken
水滸傳	Verhaal van de wateroever
鄂州市	Ezhou
福島縣	Fukushima (prefectuur)
豬油	Reuzel
新竹縣	Hsinchu (xiàn)
鞍山市	Anshan (Liaoning)
羅馬治世	Pax Romana
克羅內克	Leopold Kronecker
康托爾	Georg Cantor
戴德金	Richard Dedekind
寒武紀	Cambrium
十六元數	Sedenion
神聖羅馬皇帝腓特烈一世	Keizer Frederik I Barbarossa
前三八七年	387 v.Chr.
盲文	Braille
千葉縣	Chiba (prefectuur)
賽珍珠	Pearl S. Buck
聯合國秘書長	Secretaris-generaal van de Verenigde Naties
龐加萊	Henri Poincaré
西北水道	Noordwestelijke Doorvaart
十進制	Decimaal
烯烴	Alkeen
皇祚	Kimigayo
氣壓	Luchtdruk
箸	Eetstokjes
南投縣	Nantou (xiàn)
標點符號	Interpunctie
片假名	Katakana
民之旨	Jana-Gana-Mana
臺北一零一	Taipei 101
化學式	Molecuulformule
波斯	Perzische Rijk
群 (代數)	Groep (wiskunde)
三十六計	De 36 krijgslisten
三角函數	Goniometrische functie
六四事件	Tiananmenprotest
趙紫陽	Zhao Ziyang
胡耀邦	Hu Yaobang
安樂死	Euthanasie
姓氏	Achternaam
醛	Aldehyde
規	Passer (gereedschap)
物質之量	Stofhoeveelheid
平安北道	P'yŏngan-pukto
咸鏡南道	Hamgyŏng-namdo
島國	Eilandstaat
華山	Hua Shan
桃園市	Taoyuan (xiàn)
尺規作圖	Constructie met passer en liniaal
京都府	Kioto (prefectuur)
絕對值	Absolute waarde
羅賓漢	Robin Hood
表數法	Talstelsel
大阪府	Osaka (prefectuur)
瑪瑙	Agaat (variëteit)
愛媛縣	Ehime
圓錐曲線	Kegelsnede
海平面	Zeeniveau
羅馬皇帝表	Lijst van Romeinse keizers
矢量空間	Vectorruimte
距	Afstand
臺灣海峽	Straat van Taiwan
山口縣	Yamaguchi (prefectuur)
市盈率	Koers-winstverhouding
神奈川縣	Kanagawa (prefectuur)
中國地方	Chugoku
長野縣	Nagano (prefectuur)
殷商	Shang-dynastie
色諾芬	Xenophon
兵庫縣	Hyogo (prefectuur)
廣州恆大淘寶蹴鞠會	Guangzhou Evergrande FC
關係 (數學)	Tweeplaatsige relatie
等價	Equivalentierelatie
主格	Nominatief
泰國灣	Golf van Thailand
螳螂	Bidsprinkhanen
維基大典:書海	Wikipedia:Boekinformatie
征夷大將軍	Shogun (titel)
春節	Chinees nieuwjaar
切腹	Seppuku
色盲	Kleurenblindheid
彰化縣	Changhua (xiàn)
阿什莫爾島與卡捷島	Ashmore- en Cartiereilanden
農曆	Chinese kalender
可樂	Cola
高知縣	Kochi (prefectuur)
道德經	Tao Te Ching
萬有引力	Gravitatiewet van Newton
坐標幾何	Analytische meetkunde
芬瑟島	Fraser Island
蹴鞠	Cuju
臺南市	Tainan (stad)
與格	Datief
摩爾質量	Molaire massa
滿洲族	Mantsjoes
義大利半島	Apennijns Schiereiland
汽水	Frisdrank
天象館	Planetarium
岳陽市	Yueyang
李斯	Li Si
雲林縣	Yunlin
碗	Kom (servies)
全等	Congruentie (meetkunde)
義勇軍進行曲	Mars van de vrijwilligers
數理物理	Wiskundige natuurkunde
紅花	Saffloer
庖人	Kok (beroep)
大正天皇	Yoshihito
主義	Isme
毛納洛峰	Mauna Loa
富牌國際機場	Internationale Luchthaven Phu Bai
修道院	Abdij
符節	Wachtwoord
環 (代數)	Ring (wiskunde)
環球小姐	Miss Universe
香川縣	Kagawa (prefectuur)
曲線	Kromme
白求恩	Norman Bethune
平面幾何	Euclidische meetkunde
葉問	Yip Man
基數	Kardinaalgetal
二元運算	Binaire operatie
餘弦定理	Cosinusregel
新幹線	Shinkansen
雙曲線	Hyperbool (meetkunde)
星際爭霸	StarCraft
反射	Reflectie (straling)
嘉義縣	Chiayi (xiàn)
形意拳	Xing Yi Quan
近視	Bijziendheid
代數數	Algebraïsch getal
夏后氏	Xia-dynastie
連續	Continue functie (topologie)
教廷諸屬國	Kerkelijke Staat
濟南市	Jinan
十一月革命	Novemberrevolutie
中國抗日戰爭	Tweede Chinees-Japanse Oorlog
青島市	Qingdao
PSP	PlayStation Portable
葛利斯五八一丙	Gliese 581 c
官能團	Functionele groep
世氣公會	Wereld Meteorologische Organisatie
見即所得	Wysiwyg
新西班牙代王領	Nieuw-Spanje
織田信長	Oda Nobunaga
向日葵	Zonnebloem
南昌市	Nanchang
玫瑰之名	De naam van de roos
幾何原本	Elementen van Euclides
米高·哥連斯	Michael Collins (Iers politicus)
金本位	Gouden standaard (economie)
直積	Cartesisch product
艾狄胥	Paul Erdős
四元數	Quaternion
長沙市	Changsha
有機化合物	Organische verbinding
明治天皇	Meiji (keizer)
源實朝	Minamoto no Sanetomo
蜉蝣	Haften
伊藤博文	Ito Hirobumi
絞刑	Ophanging (levensbeëindiging)
門:史	Portaal:Geschiedenis
電極	Elektrode
阿拉伯數字	Arabisch-Indische cijfers
股骨	Dijbeen
子集	Deelverzameling
海東青	Giervalk
日文維基大典	Japanse Wikipedia
繁體字	Traditionele Chinese karakters
甲午戰爭	Eerste Chinees-Japanse Oorlog
哈丹格爾小提琴	Hardangerviool
克里希那穆提	Jiddu Krishnamurti
宦官	Eunuch
選擇公理	Keuzeaxioma
行星環	Planetaire ring
青藏高原	Tibetaans Hoogland
拓撲空間	Topologische ruimte
古文書	Paleografie
數學符表	Lijst van wiskundige symbolen
錫克金廟	Harmandir Sahib
卡奔塔利亞灣	Golf van Carpentaria
度量空間	Metrische ruimte
千分比	Promille
交換群	Abelse groep
高雄市	Kaohsiung
華盛頓歐文	Washington Irving
易經	Boek der Veranderingen
弩	Kruisboog
渤海	Bohaizee
甑帶瘡	Gordelroos
西楚霸王	Xiang Yu
戰艦	Slagschip
人魚	Zeemeermin
海倫公式	Formule van Heron
昆明市	Kunming
天氣預報	Weerbericht
人蔘	Panax ginseng
回族	Hui (volk)
蘭州市	Lanzhou
期貨	Future
鰂	Zeekatten (inktvissen)
林則徐	Lin Zexu
三國	Drie Koninkrijken (China)
春秋時代	Periode van Lente en Herfst
戰國	Periode van de Strijdende Staten
名偵探柯南	Detective Conan
區間	Interval (wiskunde)
清宣統帝	Puyi
併集	Vereniging (verzamelingenleer)
簡化字	Vereenvoudigde Chinese karakters
合肥市	Hefei
交集	Doorsnede (verzamelingenleer)
常染色體	Autosoom
啓	Xia Qi
簡歷	Curriculum vitae
蝴蝶效應	Vlindereffect
豐臣秀吉	Toyotomi Hideyoshi
假名	Kana (Japans)
民律大全	Corpus Iuris Civilis
白鱀豚	Chinese vlagdolfijn
弦	Koorde
平昌郡	Pyeongchang
泰國國際航空	Thai Airways International
北九州市	Kitakyushu
匈奴	Xiongnu
孟子	Mencius
桂林市	Guilin
海口市	Haikou
無機化合物	Anorganische verbinding
域 (代數)	Lichaam (Ned) / Veld (Be)
海拔	Hoogte
挪威廣播公司	Norsk Rikskringkasting
中原	Zhongyuan
道	Tao (filosofie)
世界語維基大典	Esperanto Wikipedia
刺身	Sashimi
中泰國	Centraal-Thailand
高錳酸鉀	Kaliumpermanganaat
鴉片戰爭	Eerste Opiumoorlog
魔鬼之詩篇	De duivelsverzen
有序對	Koppel (wiskunde)
金屬鍵	Metaalbinding
書面挪威語維基大典	Noorse Wikipedia
序數	Ordinaalgetal
南京大屠殺	Bloedbad van Nanking
吳廷琰	Ngô Đình Diệm
複式記帳	Dubbel boekhouden
麵	Noedels
路易斯安那購地案	Aankoop van Louisiana
扇	Waaier (ventilatie)
平安時代	Heianperiode
旦	Zonsopkomst
韓信點兵	Chinese reststelling
梅涅勞斯定理	Stelling van Menelaos
無窮小	Infinitesimaal
屏東縣	Pingtung (xiàn)
彰化市	Changhua
單鏡筒反光相機	Spiegelreflexcamera
雙城子	Oessoeriejsk
張飛	Zhang Fei
張衡	Zhang Heng
張居正	Zhang Juzheng
張騫	Zhang Qian
張三丰	Zhang Sanfeng
張仲景	Zhang Zhongjing
趙 (釋義)	Zhao
趙	Zhao (staat)
鄭成功	Koxinga
周瑜	Zhou Yu
諸葛亮	Zhuge Liang
烏克蘭語維基大典	Oekraïense Wikipedia
阿拉伯文維基大典	Arabische Wikipedia
金孟加拉	Amar Sonar Bangla
希伯來文維基大典	Hebreeuwse Wikipedia
洞里薩湖	Tonlé Sapmeer
賈姆謝德布爾	Jamshedpur
越南文維基大典	Vietnamese Wikipedia
負數	Negatief getal
中醫	Traditionele Chinese geneeskunde
高松市	Takamatsu
提格兰二世	Tigranes II
珠江	Parelrivier
泰西格致史	Wetenschapsgeschiedenis
五帝	Traditionele Chinese opvatting over de oudste Chinese geschiedenis
瑪格麗特一世	Margaretha I van Denemarken
日本國會	Kokkai
先哥倫布	Precolumbiaans
彼得一世島	Peter I-eiland
墓碑	Grafsteen
十二銅表法	Twaalftafelenwet
漢魏武王	Cao Cao
斬首	Onthoofding
垂直	Loodrecht (meetkunde)
無窮集合	Oneindige verzameling
冪集	Machtsverzameling
魚鉤	Vishaak
齊齊哈爾市	Qiqihar
椰蟹	Kokoskrab
俄文維基大典	Russische Wikipedia
平行公理	Parallellenpostulaat
春武里府	Changwat Chonburi
西線無戰事	Van het westelijk front geen nieuws
嘧啶	Pyrimidine
泰王國歌	Phleng Chat
冬至	Kortste dag
中國中央電視臺	China Central Television
圖蘭朵	Turandot (opera)
巴列維王朝	Pahlavidynastie
天皇	Keizer van Japan
熱帶雨林氣候	Tropisch regenwoudklimaat
袁世凱	Yuan Shikai
北海市	Beihai
袋鼠島	Kangaroo Island
阮世祖	Gia Long
君士坦丁堡普世宗主教區	Oecumenisch patriarchaat van Constantinopel
辛普生沙漠	Simpsonwoestijn
雷曼兄弟公司	Lehman Brothers
娜塔莎·北鼎斐	Natasha Bedingfield
開集	Open verzameling
測地線	Geodeet (wiskunde)
塞瓦定理	Stelling van Ceva
健陀羅	Gandhara
愛爾蘭共和國總統	President van Ierland
內積空間	Inwendig-productruimte
金奎植	Kim Kyu-sik
江戶	Edo (Japan)
金九	Kim Gu
泰山	Taishan (berg)
荀況	Xunzi
九江市	Jiujiang
占婆	Koninkrijk Champa
倒數	Omgekeerde
黃道兇賊	Zodiac Killer
陰陽五行	Wu Xing
盧溝橋事變	Marco Polobrugincident
關羽	Guan Yu
龜	Schildpadden
阮福晪	Bảo Đại
元 (釋義)	Yuan
空集	Lege verzameling
祖沖之	Zu Chongzhi
羅馬 (釋義)	Roma
左氏春秋	Commentaar van mijnheer Zuo op de Lente- en herfstannalen
瀨戶內海	Japanse Binnenzee
自由民主黨	Liberaal-Democratische Partij van Japan
環	Loop
利瑪竇	Matteo Ricci
原富	The Wealth of Nations
技術分析	Technische analyse
哆啦A夢	Doraemon
宋卡府	Changwat Songkhla
甲米府	Changwat Krabi
拉廊府	Changwat Ranong
伏羲	Fuxi
宜蘭縣	Yilan (xiàn)
法家	Legalisme (Chinese filosofie)
九龍	Kowloon
素叻府	Changwat Surat Thani
桐艾府	Changwat Trat
五代	Vijf Dynastieën en Tien Koninkrijken
森理世	Riyo Mori
補集	Complement (verzamelingenleer)
靖國神社	Yasukuni-schrijn
博他侖府	Changwat Phattalung
鹽田	Zoutpan
班武里府	Changwat Prachuap Khiri Khan
洛坤府	Changwat Nakhon Si Thammarat
春蓬府	Changwat Chumphon
新北市	Nieuw Taipei
臺中市	Taichung
漢昭烈皇帝	Liu Bei
三國志	Kroniek van de Drie Rijken
邁克學搖滾	Michael Learns to Rock
花蓮縣	Hualien (xiàn)
金門縣	Kinmen
臺東縣	Taitung (xiàn)
新竹市	Hsinchu
嘉義市	Chiayi
基隆市	Keelung
副省級市	Subprovinciale stad
從眾	Argumentum ad populum
牢不可破之聯盟	Volkslied van de Sovjet-Unie
相似	Gelijkvormigheid (meetkunde)
年號	Nian Hao
分離 (拓撲)	Gescheiden verzameling
大韓高宗	Gojong van Joseon
語序	Woordvolgorde
摩托羅拉	Motorola
賢哲賽義巴巴	Shirdi Sai Baba
雪景球	Sneeuwbol
淨土宗	Zuiver Land-boeddhisme
聖德太子	Shotoku Taishi
沈括	Shen Kuo
懿德天皇	Itoku
史記	Shiji
早稻田大學	Waseda-universiteit
孫吳	Koninkrijk Wu
論語	Gesprekken van Confucius
姜維	Jiang Wei
平清盛	Taira no Kiyomori
創意公用授權條款	Creative Commons-licenties
海寧市	Haining
小野田寬郎	Hiroo Onoda
清太宗	Hong Taiji
推古天皇	Suiko
清德宗	Guangxu
鎖國	Isolationisme
戈登	Charles George Gordon
清世祖	Shunzhi
清太祖	Nurhaci
進數	P-adisch getal
卡拉卡拉敕令	Constitutio Antoniniana
明智光秀	Akechi Mitsuhide
綏靖天皇	Suizei
阮攸	Nguyễn Du
吳大帝	Sun Quan
屈原	Qu Yuan
魏世祖文皇帝	Cao Pi
神農	Shennong
安寧天皇	Annei
發勃耳	Jean-Henri Fabre
張國榮	Leslie Cheung
後醍醐天皇	Go-Daigo
桓武天皇	Kammu
林彪	Lin Biao
清世宗	Yongzheng
呂布	Lü Bu
鴨脷洲	Ap Lei Chau
清穆宗	Tongzhi
王安石	Wang Anshi
拓撲閉包	Afsluiting (topologie)
閉集	Gesloten verzameling
閉開集	Clopen verzameling
曹魏	Koninkrijk Wei
作格	Ergatief
尖竹汶府	Changwat Chantaburi
陳省身	Shiing-Shen Chern
第十五屆亞洲運動會	Aziatische Spelen 2006
基斯孔哈拉斯	Kiskunhalas
覆蓋	Overdekking (topologie)
竭澤而漁	Overbevissing
通格	Absolutief
清仁宗	Jiaqing
正親町天皇	Ogimachi
董卓	Dong Zhuo
孫臏	Sun Bin
大韓純宗	Sunjong van Korea
婆羅多舞	Bharata natyam
朝鮮世祖	Sejo van Joseon
清宣宗	Daoguang
岳飛	Yue Fei
清文宗	Xianfeng
北柳府	Changwat Chachoengsao
羅勇府	Changwat Rayong
袁紹	Yuan Shao
阮景宗	Dong Khanh
司馬懿	Sima Yi
福澤諭吉	Fukuzawa Yukichi
安慶市	Anqing
安祿山	An Lushan
六安市	Lu'an
呂不韋	Lü Buwei
陳獨秀	Chen Duxiu
蒂邁歐篇	Timaeus (Plato)
魏 (釋義)	Wei
藤原定家	Fujiwara no Teika
夏侯惇	Xiahou Dun
曹仁	Cao Ren
坂本龍馬	Sakamoto Ryoma
王守仁	Wang Yangming
魏烈祖明皇帝	Cao Rui
朝鮮太祖	Taejo van Joseon
陸遜	Lu Xun (Wu)
李鴻章	Li Hongzhang
王羲之	Wang Xizhi
康托爾悖論	Paradox van Cantor
中秋	Midherfstfestival
光中帝	Quang Trung (keizer)
梁啟超	Liang Qichao
孫策	Sun Ce
墓	Graftombe
沙繳府	Changwat Sa Kaew
緊集	Compacte ruimte
依善	Isaan
冒頓單于	Mao Dun (heerser)
成都雙流國際機場	Internationale luchthaven Chengdu Shuangliu
發翔羽	Slagpen
赤腹蠑螈	Vuurbuiksalamander
南陽市	Nanyang
臺南	Tainan
南投	Nantou
秋葉原	Akihabara
虹吸	Hevel
南充市	Nanchong
北條時宗	Hojo Tokimune
阮聖祖	Minh Mạng
董仲舒	Dong Zhongshu
阮出帝	Ham Nghi
托勒密定理	Stelling van Ptolemaeus
丸龜市	Marugame
鄧麗君	Teresa Teng
殷墟	Yinxu
阮福昭	Thành Thái
夏帝履癸	Xia Jie
詩經	Boek der Liederen
阮福晃	Duy Tan
秋瑾	Qiu Jin
阮簡宗	Kien Phuc
阮福昇	Hiệp Hòa (keizer)
自斷	Autotomie
戈公省	Koh Kong (provincie)
效用	Nut (economie)
阮翼宗	Tự Đức
大月氏	Yuezhi
吳三桂	Wu Sangui
周公旦	Hertog van Zhou
阮弘宗	Khải Định
漢後主	Liu Shan
齊桓公	Huan (hertog)
商湯	Shang Tang
偏序	Partiële orde
康托爾定理	Stelling van Cantor
新山一國際機場	Internationale Luchthaven Tân Sơn Nhất
朝鮮半島	Koreaans Schiereiland
電車	Elektrisch treinstel
和服	Kimono
遜尼派	Soennisme
朝鮮宣祖	Seonjo van Joseon
朝鮮孝宗	Hyojong van Joseon
哥德巴赫猜想	Vermoeden van Goldbach
三國遺事	Samguk Yusa
三國史記	Samguk Sagi
朝鮮漢字	Hanja
國會議員	Parlementslid
摩爾體積	Molair volume
傲遊瀏覽器	Maxthon
復旦大學	Fudan-universiteit
朝鮮王朝實錄	Joseon Wangjo Sillok
廣開土王	Gwanggaeto de Grote
韓國放送公社	Korean Broadcasting System
涼宮春日系列	The Melancholy of Haruhi Suzumiya
莎阿南	Shah Alam (stad)
玉山	Yu Shan
大嶼山	Lantau
楚	Chu (staat)
梅爾維爾島	Melville-eiland (Australië)
新	Xin-dynastie
北太平洋露脊鯨	Grote oceaannoordkaper
海北藏族自治州	Haibei (autonome Tibetaanse prefectuur)
中庸	Doctrine van het Midden
中國禮儀之爭	Ritenstrijd
鳳凰	Feng Huang
阮恭宗	Duc Duc
阮憲祖	Thieu Tri
吳清源	Go Seigen
塔如濤群島	Nationaal park Tarutao
真言宗	Shingon
初音未來	Hatsune Miku
餛飩	Wantan
超濾法	Ultrafiltratie
曹真	Cao Zhen (generaal)
吉田松陰	Yoshida Shoin
泰文維基大典	Thaise Wikipedia
猫眼林克	Link (The Legend of Zelda)
蘇通長江大橋	Sutongbrug
尼奧寵物	Neopets
包頭市	Baotou
板橋區	Banqiao
大化革新	Taika
文天祥	Wen Tianxiang
呂正操	Lü Zhengcao
壬辰倭亂	Japanse invasies van Korea (1592-1598)
魏鄧哀王	Cao Chong
出雲國	Izumo (provincie)
新界	New Territories
三字經	Sanzijing
午餐肉	Spam (vlees)
呂底亞	Lydië
自焚	Zelfverbranding
廬山	Lushan
老撾之歌	Pheng Xat Lao
夏禹	Yu de Grote
藤原氏	Fujiwara (familie)
漢 (釋義)	Han
杭思朗	Armstrong
馬步芳	Ma Bufang
香港語言學學會粵語拼音方案	Jyutping
水龍頭	Kraan (regelaar)
子拓撲	Deelruimtetopologie
廣州地鐵	Metro van Kanton
車裂	Vierendeling
嘉定區	Jiading (district)
金山區	Jinshan (district)
性染色體	Geslachtschromosoom
斗六市	Douliu
算術基本定理	Hoofdstelling van de rekenkunde
存活期	Time to live
稠密	Dichte verzameling
崑曲	Kunqu
流亡政府	Regering in ballingschap
古魯特島	Groote Eylandt
中文數字	Chinese cijfers
天主教輔仁大學	Universitas Catholica Fu Jen
武器貿易條約	Wapenhandelsverdrag
龜船	Geobukseon
永樂大典	Yongle dadian
諡	Naamgeving van Chinese keizers
魏陳思王	Cao Zhi
吳起	Wu Qi
周文王	Zhou Wenwang
李時珍	Li Shizhen
東沙	Prataseilanden
陳勝	Chen Sheng
杭州灣	Hangzhoubaai
高雄捷運	Metro van Kaohsiung
和珅	Heshen
韓服	Hanbok
臺灣高速鐵路	Taiwan High Speed Rail
吳廣	Wu Guang
林尚義	Lam Sheung-Yee
張九齡	Zhang Jiuling
世界新七大奇蹟	New7Wonders of the World
屏東市	Pingtung
季羨林	Ji Xianlin
清明上河圖	Langs de rivier tijdens het Qingmingfestival
臺北捷運	Metro van Taipei
延邊州	Autonome Koreaanse Prefectuur Yanbian
崔顥	Cui Hao
桃園區	Taoyuan (stad)
李悝	Li Kui
攀牙灣	Baai van Phang Nga
色戒	Se, jie
日本雅樂	Gagaku
清明	Qingmingfestival
帝嚳	Diku
印地文維基大典	Hindi Wikipedia
琴	Guqin
範空間	Genormeerde vectorruimte
有界	Begrensdheid
鎮	Grote gemeente
梁武帝	Liang Wudi
魯	Lu (staat)
倫敦東隅	East End (Londen)
申 (地支)	Aap (astrologie)
歐羅巴	Europa
八元數	Octonion
結合代數	Associatieve algebra
春秋	Lente- en herfstannalen
地級市	Stadsprefectuur
泰北	Noord-Thailand
黃巾之亂	Gele Tulbandenopstand
沖繩縣	Okinawa (prefectuur)
崇明縣	Chongming
百度大典	Baidu Baike
基 (拓撲)	Basis (topologie)
二虎歌	Vader Jacob
赤壁之戰	Slag bij de Rode Muur
超複數	Hypercomplex getal
奧海鎮	Ojai
博者之謬	Gokkersmisvatting
古雅典	Oude Athene
漢傳佛教	Boeddhisme in China
渭水	Wei He
阿巴諾湖	Meer van Albano
康熙字典	Kangxi-woordenboek
證明論	Bewijstheorie
石	Koku
坂出市	Sakaide
族 (數學)	Geïndexeerde familie
仡佬族	Gelao
光圈	Diafragmagetal
禮記	Optekeningen over de riten
內點	Inwendige (topologie)
州際三十五號公路大橋	I-35W Mississippi River Bridge
北魏	Noordelijke Wei-dynastie
尚書	Boek der Documenten
雲隙光	Wolkenstralen
康威數	Surreëel getal
喃字	Chữ Nôm
天命	Hemels Mandaat
周界	Rand (topologie)
陸奧國	Mutsu (provincie)
東方計劃	Touhou Project
分液漏斗	Scheitrechter
晉國	Jin (staat)
魏	Wei (staat)
單連通	Enkelvoudig samenhangende ruimte
吳	Wu (staat)
藁人之謬	Stropopredenering
地球之年歲	Ouderdom van de Aarde
弗林德斯島 (塔斯曼尼亞)	Flinderseiland
曼谷大橋	Krungthep-brug
馬拉浦南	Malappuram (stad)
陸上風帆	Zeilwagenrijden
呂範	Lü Fan
景教	Kerk van het Oosten
代數 (代數)	Algebra (structuur)
羅勇市	Rayong (stad)
儋州市	Danzhou
維克多港	Victor Harbor
固始縣	Gushi (Henan)
臨安市	Lin'an
新會區	Xinhui
卡羅萊納箱龜	Carolina-doosschildpad
凌遲	Dood door duizend sneden
周公季	Ji van Zhou
美洲殖民	Geschiedenis van de Verenigde Staten (1607-1763)
燕	Yan (staat)
陸皓東	Lu Haodong
周武王	Zhou Wuwang
元維基	Meta-Wiki
去衣馳騁	Streaker
宋	Song (staat)
頌聖歌	Phleng Sansasoen Phra Barami
加藤清正	Kato Kiyomasa
泰南	Zuid-Thailand
五刑	Vijf straffen
大學	Grote Leer
閣帕岸島	Ko Pha Ngan
積拓撲	Producttopologie
縣級市	Stadsarrondissement
祁連山	Qilian Shan
厓山海戰	Slag bij Yamen
韓國	Korea (doorverwijspagina)
亞米利加蝲蛄	Rode rivierkreeft
公羊傳	Commentaar van Gongyang op de Lente- en herfstannalen
穀梁傳	Commentaar van Guliang op de Lente- en herfstannalen
藏學	Tibetologie
天子	Zoon van de Hemel
衛	Wey (staat)
三淸	San Qing
香港電台	RTHK
人民公社	Volkscommune
麻貴	Ma Gui
共形場論	Conforme veldentheorie
周幽王	Zhou Youwang
孟姜女	Mengjiangnü
孟子 (書)	De Mencius
零號元素	Neutronium
他彼河	Ta Pee
零零七島	Khao Phing Kan
吐谷渾	Tuyuhun
關門大橋	Kammonbrug
六朝	Zes Dynastieën
維基大典:大使館	Wikipedia:Ambassade
爾雅	Erya
旺角	Mong Kok
荊州	Jing
儀禮	Regels en riten
分數	Rationaal getal
紅統群島	Ang Thong National Marine Park
千字文	Qianziwen
周赧王	Nanwang
有司足下之函	Dear Boss-brief
翹傳	Truyện Kiều
古丁尼柏國家公園	Nationaal park Quttinirpaaq
泰王國股票交易所	Effectenbeurs van Thailand
乾燥氣候	Droog klimaat
沙繳市	Sa Kaew (stad)
周禮	Riten van Zhou
孝經	Boek van de kinderlijke gehoorzaamheid
拾穗	Arenleessters
神位	Shenzhupai
動物莊園	Animal Farm
Category:德國史	Categorie:Duitsland
Category:俄羅斯聯邦書	Categorie:Rusland
Category:大韓民國書	Categorie:Zuid-Korea
Category:羅馬帝國書	Categorie:Romeinse Rijk
Category:鳥	Categorie:Vogel
Category:植物	Categorie:Plant
Category:物理	Categorie:Natuurkunde
Category:自然科學	Categorie:Natuurwetenschappen
Category:化學	Categorie:Scheikunde
Category:史部	Categorie:Geschiedenis
Category:群	Categorie:Mens en maatschappij
Category:宗教	Categorie:Religie
Category:運動	Categorie:Sport
Category:經部	Categorie:Wetenschap
Category:聯合國	Categorie:Verenigde Naties
Category:地球	Categorie:Aarde
盈不足術	Regula falsi
維曼默宮	Vimanmekpaleis
道路連通	Samenhang
泰國軍人銀行	TMB Bank
韓	Han (staat)
昂船洲大橋	Stonecuttersbrug
桿秤	Unster
堪洽那披色大橋	Kanchanaphisek-brug
古羅馬	Oude Rome
政令指定都市	Decretaal gedesigneerde stad
羲和	Xihe
聖火降魔錄	Fire Emblem
夏侯氏	Xiahou
二十四孝	De 24 voorbeelden van xiao
多頭	Long gaan
不寐	Slapeloosheid
Category:釋義	Categorie:Wikipedia:Doorverwijspagina
Category:哲學	Categorie:Filosofie
Category:心理	Categorie:Psychologie
Category:佛教	Categorie:Boeddhisme
Category:基督教	Categorie:Christendom
Category:回教	Categorie:Islam
Category:猶太教	Categorie:Jodendom
反氦	Anti-alfadeeltje
嘉當矩陣	Cartan-matrix
華東師範大學	East China Normal University
藏文維基大典	Tibetaanse Wikipedia
量子群	Kwantumgroep
吳 (釋義)	Wu
彌敦道	Nathan Road
精緻拱門	Delicate Arch
大悲咒	Nilakantha dharani
溫度換算	Temperatuurschaal
吐蕃	Tibetaans rijk
鄰域	Omgeving (wiskunde)
家娛頻道	Jia Yu Channel
大澳	Tai O
香囊	Geurzakje
華夏	Huaxia
燒賣	Siew maai
Category:殘章	Categorie:Wikipedia:Beginnetje
Category:維基事	Categorie:Wikipedia:Beheer
Category:行星	Categorie:Planeet
Category:地質	Categorie:Geologie
明治	Meijiperiode
維基大典:陳年今誌	Wikipedia:Dag uit de geschiedenis
正數	Positief getal
Help:凡例	Wikipedia:Snelcursus/Bewerken
Template:太陽系	Sjabloon:Navigatie zonnestelsel
門:子	Portaal:Filosofie
門:集	Portaal:Kunst & Cultuur
Category:美國列傳	Categorie:Amerikaans persoon
Template:Tl	Sjabloon:Tl
Template:Userbox	Sjabloon:Gebruikersbox
Category:網頁瀏覽器	Categorie:Webbrowser
Template:世事	Sjabloon:Hoofdpagina - in het nieuws
Category:律法	Categorie:Recht
Category:計學	Categorie:Economie
維基大典:有秩選舉	Wikipedia:Aanmelding moderatoren
Category:醫學	Categorie:Geneeskunde
Category:政治	Categorie:Politiek
Category:教育	Categorie:Onderwijs
Category:藝術	Categorie:Kunst
會計	Boekhouding
密思兒	Egypte (land)
Category:統計	Categorie:Statistiek
Template:Bot	Sjabloon:Bot
加拿大	Canada
Category:卓著	Categorie:Wikipedia:Etalage-artikelen
維	Dimensie (algemeen)
Category:遊戲	Categorie:Spel
Category:幫助文檔	Categorie:Wikipedia:Help
維基大典:世事	Portaal:In het nieuws
Template:Documentation	Sjabloon:Sjabdoc
維基大典:簿之權限	Help:Overzicht van soorten Wikipediagebruikers
Category:維基提案	Categorie:Wikipedia:Voorstel
維基大典:聯繫	Help:Contact met Wikipedia
維基大典:市集	Portaal:Gebruikersportaal
Category:維基人	Categorie:Wikipedia:Babel
維基大典:忽略規則	Wikipedia:Negeer alle regels
維基大典:五柱	Wikipedia:Vijf zuilen
企業	Bedrijf
Template:Softredirect	Sjabloon:Softredirect
Template:刪	Sjabloon:Nuweg
Category:語言	Categorie:Taal
Category:語法	Categorie:Grammatica
Category:維基大典	Categorie:Encyclopedie Wikipedia
Category:諸語維基大典	Categorie:Wikipedia naar taal
Category:未索之頁	Categorie:Wikipedia:Niet te indexeren pagina's
Category:帶壞檔之頁	Categorie:Wikipedia:Pagina's met onjuiste bestandsverwijzingen
門:卷首	Portaal:Portalenoverzicht
Template:Navbox	Sjabloon:Navigatie
Template:捷徑	Sjabloon:Verwijzing
Category:時區	Categorie:Tijdzone
Category:維基大典維護	Categorie:Wikipedia:Onderhoud
社稷	Sheji
門:美國史	Portaal:Verenigde Staten
Template:Navbar	Sjabloon:Tnavbar
Template:Unicode	Sjabloon:Unicode
Category:格式模板	Categorie:Wikipedia:Sjablonen opmaak
Template:Clear	Sjabloon:Clearboth
Template:Nowrap	Sjabloon:Nowrap
阮氏	Ruan (achternaam)
維基大典:當有之文	Wikipedia:Archief/Wikipedia:Artikelen die elke Wikipedia zou moeten hebben
Category:數	Categorie:Getal
Category:書籍	Categorie:Boek
Template:Wikisource	Sjabloon:Wikisource
Template:Babel	Sjabloon:Babel
Template:共享	Sjabloon:Commons
Template:Link GA	Sjabloon:Link GA
Template:Reflist	Sjabloon:References
維基大典:掃興警示	Wikipedia:Leeswaarschuwing
Template:芻文	Sjabloon:Beginnetje
Template:See also	Sjabloon:Zie ook
Template:User de	Sjabloon:Gebruiker de
Template:User de-1	Sjabloon:Gebruiker de-1
Template:User es-2	Sjabloon:Gebruiker es
Template:User en-3	Sjabloon:Gebruiker en-3
Template:User en-1	Sjabloon:Gebruiker en-1
Template:User en-2	Sjabloon:Gebruiker en-2
Template:User en-4	Sjabloon:Gebruiker en-4
Template:User en	Sjabloon:Gebruiker en
Template:User de-2	Sjabloon:Gebruiker de-2
Template:User es-1	Sjabloon:Gebruiker es-1
Template:User fr-1	Sjabloon:Gebruiker fr-1
Template:User he-2	Sjabloon:Gebruiker he-2
Template:User id-3	Sjabloon:Gebruiker id-3
Template:User sk	Sjabloon:Gebruiker sk
Template:User fr-2	Sjabloon:Gebruiker fr-2
Template:User ja	Sjabloon:Gebruiker ja
Template:User ja-1	Sjabloon:Gebruiker ja-1
Template:User fr	Sjabloon:Gebruiker fr
Category:智利	Categorie:Chili
Category:廿一世紀	Categorie:21e eeuw
Category:User uk	Categorie:Wikipedia:Gebruiker uk
Category:User uk-N	Categorie:Wikipedia:Gebruiker uk-M
Template:Mod	Sjabloon:Modulo
Template:User uk	Sjabloon:Gebruiker uk
Category:百科全書	Categorie:Encyclopedie
Template:歡迎	Sjabloon:Hola
Category:User ms	Categorie:Wikipedia:Gebruiker ms
Template:Edit	Sjabloon:Edit
Template:Ref	Sjabloon:Ref
Category:連結模板	Categorie:Wikipedia:Sjablonen links
Template:Userbox-2	Sjabloon:Gebruikersbox-2
Category:User fr-1	Categorie:Wikipedia:Gebruiker fr-1
Template:Wikiquote	Sjabloon:Wikiquote
Template:Image label	Sjabloon:Afbeelding label
Template:Ja	Sjabloon:Jpn
Template:醫	Sjabloon:Disclaimer medisch lemma
Template:Es	Sjabloon:Es
Template:Disputed	Sjabloon:Twijfel
Template:Hide in print	Sjabloon:Niet afdrukken
Category:美國史	Categorie:Geschiedenis van de Verenigde Staten
Template:國	Sjabloon:Infobox land
Template:Infobox software	Sjabloon:Infobox software
Template:Wide image	Sjabloon:Panorama
Template:Military Conflict	Sjabloon:Infobox militair conflict
Template:Audio	Sjabloon:Audio
Template:電玩訊欄	Sjabloon:Infobox computerspel
Template:卓著	Sjabloon:Etalage
Category:User en-4	Categorie:Wikipedia:Gebruiker en-4
Category:User en	Categorie:Wikipedia:Gebruiker en
Category:User zh	Categorie:Wikipedia:Gebruiker zh
Category:User zh-N	Categorie:Wikipedia:Gebruiker zh-M
Category:User en-2	Categorie:Wikipedia:Gebruiker en-2
Category:曲	Categorie:Compositie
Template:Infobox	Sjabloon:Infobox generiek
Template:User zh	Sjabloon:Gebruiker zh
Template:Legend	Sjabloon:Legenda
Template:引網	Sjabloon:Citeer web
Category:食	Categorie:Voeding
Template:Coor URL	Sjabloon:MapsServer
Category:史書	Categorie:Historisch boek
Template:維基爾雅	Sjabloon:Wikt
Template:Multi-listen start	Sjabloon:Multi-listen start
Template:MongolUnicode	Sjabloon:MongolUnicode
Template:Languageicon	Sjabloon:Taalaanduiding
Category:農業	Categorie:Landbouw
Category:User ms-N	Categorie:Wikipedia:Gebruiker ms-M
Template:User ru	Sjabloon:Gebruiker ru
Category:二十世紀	Categorie:20e eeuw
Template:IPA	Sjabloon:IPA
Template:釋義二	Sjabloon:Zie dp
Category:東羅馬史	Categorie:Byzantijnse Rijk
Template:Dyk	Sjabloon:Hoofdpagina - wist je dat
Template:Archive box	Sjabloon:Archief
Template:Copyvio	Sjabloon:Auteur
Template:天下觀	Sjabloon:Wereldwijd
Template:Image label end	Sjabloon:Afbeelding label eind
Template:澳大利亞地方	Sjabloon:Navigatie bestuurlijke indeling Australië
Template:Purge	Sjabloon:Purge
Template:土星之衛星	Sjabloon:Navigatie manen Saturnus
Template:敗興	Sjabloon:Leeswaarschuwing
Template:中華人民共和國地方	Sjabloon:Navigatie bestuurlijke indeling China
Template:齋	Sjabloon:Gebruikerspagina
Template:Math.ceil	Sjabloon:Ceil
Template:User	Sjabloon:Gebruikerlinks
Template:User language-4	Sjabloon:Babel4
Category:公司	Categorie:Bedrijf
Template:User fr-3	Sjabloon:Gebruiker fr-3
Template:Th	Sjabloon:Th
Category:日本地方志	Categorie:Bestuurlijke indeling van Japan
Category:電腦	Categorie:Computer
Category:器	Categorie:Apparatuur
Template:非也	Sjabloon:Tegen
Category:複分析	Categorie:Complexe analyse
Category:User ja-N	Categorie:Wikipedia:Gebruiker ja-M
Category:茶	Categorie:Thee
Template:Browsebar	Portaal:Wetenschapsgeschiedenis/Navigatiebalk
Template:釋義	Sjabloon:Dp
Category:攝影	Categorie:Fotografie
Category:天皇本紀	Categorie:Keizer van Japan
Category:德意志第三帝國書	Categorie:Nazi-Duitsland
Category:朝鮮史	Categorie:Geschiedenis van Korea
Category:礦冶	Categorie:Mijnbouw
Template:User ksh	Sjabloon:Gebruiker ksh
Template:User yue-1	Sjabloon:Gebruiker yue-1
Category:廣州	Categorie:Kanton (stad)
Category:建築	Categorie:Architectuur
Category:生物	Categorie:Organisme
Template:De	Sjabloon:De
Template:Infobox person	Sjabloon:Infobox persoon
Category:鐵路	Categorie:Spoorweg
Template:洲	Sjabloon:Navigatie continenten en regio's van de wereld
Template:InterWiki	Sjabloon:InterWiki
Template:User th-1	Sjabloon:Gebruiker th-1
Category:金蘭之模	Categorie:Wikipedia:Sjablonen zusterproject
Template:User bg	Sjabloon:Gebruiker bg
Template:User la-1	Sjabloon:Gebruiker la-1
Template:歐洲	Sjabloon:Navigatie landen Europa
Category:User yue	Categorie:Wikipedia:Gebruiker yue
Category:User sk	Categorie:Wikipedia:Gebruiker sk
Category:User fr	Categorie:Wikipedia:Gebruiker fr
Category:User id	Categorie:Wikipedia:Gebruiker id
Category:User ja	Categorie:Wikipedia:Gebruiker ja
Category:User la	Categorie:Wikipedia:Gebruiker la
Category:User th	Categorie:Wikipedia:Gebruiker th
Category:User fr-3	Categorie:Wikipedia:Gebruiker fr-3
Category:User fr-2	Categorie:Wikipedia:Gebruiker fr-2
Category:User ja-2	Categorie:Wikipedia:Gebruiker ja-2
Category:User ko-N	Categorie:Wikipedia:Gebruiker ko-M
Category:User fr-N	Categorie:Wikipedia:Gebruiker fr-M
Category:User ru-N	Categorie:Wikipedia:Gebruiker ru-M
Category:娛樂	Categorie:Amusement
Category:商學	Categorie:Bedrijfsleven
Template:User yue	Sjabloon:Gebruiker yue
Category:文字	Categorie:Schriftsysteem
Category:User bg	Categorie:Wikipedia:Gebruiker bg
Category:道教	Categorie:Taoïsme
Category:User bg-N	Categorie:Wikipedia:Gebruiker bg-M
Category:User sk-N	Categorie:Wikipedia:Gebruiker sk-M
Category:User de	Categorie:Wikipedia:Gebruiker de
Category:User de-2	Categorie:Wikipedia:Gebruiker de-2
Category:User de-N	Categorie:Wikipedia:Gebruiker de-M
Category:User en-3	Categorie:Wikipedia:Gebruiker en-3
Category:User en-N	Categorie:Wikipedia:Gebruiker en-M
Category:User es	Categorie:Wikipedia:Gebruiker es
Category:User es-1	Categorie:Wikipedia:Gebruiker es-1
Category:User id-3	Categorie:Wikipedia:Gebruiker id-3
Category:匈奴書	Categorie:Xiong Nu
Template:Three Kingdoms Wars	Sjabloon:Zijbalk gevechten Drie Koninkrijken
Category:韓語	Categorie:Koreaans
Category:幾何	Categorie:Meetkunde
Category:User ja-1	Categorie:Wikipedia:Gebruiker ja-1
Category:User ko	Categorie:Wikipedia:Gebruiker ko
Category:User ko-1	Categorie:Wikipedia:Gebruiker ko-1
Category:User ko-2	Categorie:Wikipedia:Gebruiker ko-2
Category:User ksh	Categorie:Wikipedia:Gebruiker ksh
Category:User ksh-N	Categorie:Wikipedia:Gebruiker ksh-M
Category:User la-3	Categorie:Wikipedia:Gebruiker la-3
Category:斯巴達書	Categorie:Sparta
Category:User ru-1	Categorie:Wikipedia:Gebruiker ru-1
維基大典:巴别	Wikipedia:Babel
Category:大洋洲史	Categorie:Geschiedenis van Oceanië
Category:User ms-1	Categorie:Wikipedia:Gebruiker ms-1
長安	Chang'an (stad)
Template:Math.floor	Sjabloon:Floor
Template:Math.abs	Sjabloon:Abs
Category:以嗜好類之維基人	Wikipedia:Wikipedianen naar expertise
Category:朝鮮本紀	Categorie:Koning van Joseon
Category:廣東省	Categorie:Guangdong
Category:四川省	Categorie:Sichuan
Category:遼寧省	Categorie:Liaoning
Category:陝西省	Categorie:Shaanxi
Category:安徽省	Categorie:Anhui
Category:江西省	Categorie:Jiangxi
Category:江蘇省	Categorie:Jiangsu
Category:吉林省	Categorie:Jilin
Category:福建省	Categorie:Fujian
Category:海南省	Categorie:Hainan
Category:河北省	Categorie:Hebei
Category:黑龍江省	Categorie:Heilongjiang
Category:湖北省	Categorie:Hubei
Category:地理	Categorie:Fysische geografie
Category:水	Categorie:Water
Category:美洲史	Categorie:Geschiedenis van Amerika
Template:提案	Sjabloon:Voorstel
Category:社會科學	Categorie:Sociale wetenschap
Template:Zh	Sjabloon:Zh
Template:Navigationsleiste	Sjabloon:Navigatie uitklapbaar
Template:User ja-2	Sjabloon:Gebruiker ja-2
Template:User ko-2	Sjabloon:Gebruiker ko-2
Template:User ko-1	Sjabloon:Gebruiker ko-1
Template:User ru-2	Sjabloon:Gebruiker ru-2
Template:天王星之衛星	Sjabloon:Navigatie manen Uranus
Category:User ru	Categorie:Wikipedia:Gebruiker ru
Category:User ru-2	Categorie:Wikipedia:Gebruiker ru-2
Category:User th-1	Categorie:Wikipedia:Gebruiker th-1
Category:User yue-1	Categorie:Wikipedia:Gebruiker yue-1
Category:User yue-N	Categorie:Wikipedia:Gebruiker yue-M
Template:En	Sjabloon:En
Category:山東省	Categorie:Shandong
Category:雲南省	Categorie:Yunnan
Category:浙江省	Categorie:Zhejiang
Category:青海省	Categorie:Qinghai
Category:河南省	Categorie:Henan
Category:湖南省	Categorie:Hunan
Template:Lang	Sjabloon:Lang
Category:日本文學	Categorie:Japanse literatuur
Category:群學	Categorie:Sociologie
Template:2images	Sjabloon:Dubbele afbeelding
域	Champ
Category:三世紀	Categorie:3e eeuw
Category:十七世紀	Categorie:17e eeuw
Category:七世紀	Categorie:7e eeuw
Category:東羅馬本紀	Categorie:Keizer van Byzantium
Category:門	Categorie:Wikipedia:Portalen
Template:Ko	Sjabloon:Ko
Template:Main	Sjabloon:Zie hoofdartikel
Category:希臘史	Categorie:Geschiedenis van Griekenland
Category:澳大利亞史	Categorie:Geschiedenis van Australië
Category:北韓紀事	Categorie:Geschiedenis van Noord-Korea
Category:加拿大史	Categorie:Geschiedenis van Canada
Template:User ko	Sjabloon:Gebruiker ko
Template:User ru-1	Sjabloon:Gebruiker ru-1
Template:User zh-1	Sjabloon:Gebruiker zh-1
Template:User zh-2	Sjabloon:Gebruiker zh-2
Template:User zh-3	Sjabloon:Gebruiker zh-3
Template:User zh-4	Sjabloon:Gebruiker zh-4
Category:俄羅斯史	Categorie:Geschiedenis van Rusland
Template:Multi-listen end	Sjabloon:Multi-listen end
Category:中華自治區	Categorie:Regio van China
Category:羅馬皇帝本紀	Categorie:Romeins keizer
維基大典:維基聊齋	Wikipedia:Humor en onzin/Opmerkelijke pagina's
Category:戲劇	Categorie:Theater
Template:中立	Sjabloon:Neutraal
Category:中東史	Categorie:Geschiedenis van het Midden-Oosten
Category:User zh-1	Categorie:Wikipedia:Gebruiker zh-1
Category:User zh-4	Categorie:Wikipedia:Gebruiker zh-4
Category:User zh-3	Categorie:Wikipedia:Gebruiker zh-3
Category:User zh-2	Categorie:Wikipedia:Gebruiker zh-2
Category:刑法	Categorie:Strafrecht
Category:酸	Categorie:Zuur
Category:算法	Categorie:Algoritme
Category:一世紀	Categorie:1e eeuw
Category:十四世紀	Categorie:14e eeuw
Category:二世紀	Categorie:2e eeuw
Category:四世紀	Categorie:4e eeuw
Category:十八世紀	Categorie:18e eeuw
Category:八世紀	Categorie:8e eeuw
Category:整數	Categorie:Natuurlijk getal
Category:香港列傳	Categorie:Hongkongs persoon
粵語	Kantonees
Category:藤原氏	Categorie:Fujiwara-clan
Category:印歐語系	Categorie:Indo-Europese taalfamilie
Category:量子場論	Categorie:Kwantumveldentheorie
Category:泰國銀行	Categorie:Thaise bank
Category:化學元素	Categorie:Chemisch element
Template:中國世界遺產	Sjabloon:Navigatie werelderfgoed China
Category:姓氏	Categorie:Achternaam
Category:朝鮮民主主義人民共和國書	Categorie:Noord-Korea
Category:英國史	Categorie:Geschiedenis van het Verenigd Koninkrijk
Category:中華史	Categorie:Geschiedenis van China
Category:新聞學	Categorie:Journalistiek
Category:前二世紀	Categorie:2e eeuw v.Chr.
Category:前三世紀	Categorie:3e eeuw v.Chr.
Category:越南地理志	Categorie:Geografie van Vietnam
Category:高句麗書	Categorie:Goguryeodynastie
Category:蘇聯書	Categorie:Sovjet-Unie
Category:古羅馬史	Categorie:Romeinse oudheid
Category:高麗書	Categorie:Goryeodynastie
Category:朝鮮書	Categorie:Joseondynastie
Category:前一世紀	Categorie:1e eeuw v.Chr.
Category:新羅書	Categorie:Silladynastie
Category:美國總統世家	Categorie:President van de Verenigde Staten
Category:歐洲史	Categorie:Geschiedenis van Europa
Category:魚	Categorie:Vis
Category:北京市	Categorie:Peking
Category:果	Categorie:Fruit
Category:天候學	Categorie:Klimatologie
Category:亞洲地理志	Categorie:Geografie van Azië
Category:人類學	Categorie:Antropologie
Category:作業系統	Categorie:Besturingssysteem
Category:清書	Categorie:Qing-dynastie
Category:宋書	Categorie:Song-dynastie
Category:周書	Categorie:Zhou-dynastie
Category:阮氏大南書	Categorie:Nguyen-dynastie
Category:天演	Categorie:Evolutie
Category:動物	Categorie:Dierenrijk
Category:俄羅斯加盟共和國	Categorie:Deelrepubliek van Rusland
Category:三國書	Categorie:Drie koninkrijken
Category:兵器	Categorie:Wapen
Category:紀年	Categorie:Chronologie
Category:中華史誌	Categorie:Chinese historiografie
Category:弦論	Categorie:Snaartheorie
Category:數學分析	Categorie:Wiskundige analyse
Category:樂器	Categorie:Muziekinstrument
Category:漢字	Categorie:Chinees schrift
Category:氣象	Categorie:Meteorologie
Category:實驗儀器	Categorie:Laboratoriuminstrument
Category:香港	Categorie:Hongkong
Category:PS2遊戲	Categorie:PlayStation 2-spel
Category:鹽	Categorie:Zout
Category:廣西壯族自治區	Categorie:Guangxi
Category:衣	Categorie:Kleding
Category:上海市	Categorie:Shanghai
Category:龜	Categorie:Schildpad
Category:中華節日	Categorie:Chinese feestdag
Category:節日	Categorie:Festival
Category:臺北市	Categorie:Taipei
Category:書體	Categorie:Lettertype
Category:古希臘史	Categorie:Griekse oudheid
Category:交通	Categorie:Vervoer
Category:刑	Categorie:Straf
Category:玩	Categorie:Speelgoed
Category:數趣	Categorie:Recreatieve wiskunde
Category:群論	Categorie:Groepentheorie
Category:數論	Categorie:Getaltheorie
Category:拓撲學	Categorie:Topologie
Category:疇人	Categorie:Wiskundige
Category:雕塑	Categorie:Beeldhouwkunst
Category:大韓民國大統領世家	Categorie:President van Zuid-Korea
Category:漢語	Categorie:Chinese talen
Category:澳門	Categorie:Macau
Category:日本文	Categorie:Japans schrift
Category:塔	Categorie:Toren
便利店	Gemakswinkel
Category:中華人民共和國書	Categorie:Volksrepubliek China
Category:衛星	Categorie:Natuurlijke maan
Category:數學史	Categorie:Geschiedenis van de wiskunde
夏至	Langste dag
Template:依余之見	Sjabloon:Opmerking
臺北	Taipei
中國 (釋義)	China (doorverwijspagina)
門:數學	Portaal:Wiskunde
Category:北韓本紀	Categorie:President van Noord-Korea
Category:武漢市	Categorie:Wuhan
Template:User lzh-1	Sjabloon:Gebruiker zh-wen-1
Category:User lzh-2	Categorie:Wikipedia:Gebruiker lzh-2
Template:User lzh-2	Sjabloon:Gebruiker zh-wen-2
Category:代數	Categorie:Algebra
Category:雅典列傳	Categorie:Persoon uit het oude Athene
Category:雅典書	Categorie:Oude Athene
Category:鹼	Categorie:Base
Category:橋	Categorie:Brug
Category:占城書	Categorie:Champa
Category:矮行星	Categorie:Dwergplaneet
Category:地震	Categorie:Aardbeving
Category:東正教會	Categorie:Oosters-orthodoxe Kerk
Category:電極	Categorie:Elektrode
Category:版權	Categorie:Auteursrecht
Category:世界語	Categorie:Esperanto
Category:語法格	Categorie:Naamval
Category:杭州市	Categorie:Hangzhou
Category:南亞史	Categorie:Geschiedenis van Zuid-Azië
Category:內蒙古自治區	Categorie:Binnen-Mongolië
Category:蘇州市	Categorie:Suzhou
Category:律史	Categorie:Rechtsgeschiedenis
門:化學	Portaal:Scheikunde
Category:秦書	Categorie:Qin-dynastie
Category:中華民國書	Categorie:Republiek China
Category:有機化學	Categorie:Organische chemie
Category:製鹽	Categorie:Zoutwinning
Category:船舶	Categorie:Schip
Category:中華特別行政區	Categorie:Speciale Administratieve Regio van de Volksrepubliek China
Category:衡器	Categorie:Meetinstrument
Category:桃園市	Categorie:Táoyuán
Category:電話	Categorie:Telefonie
Category:User cdo	Categorie:Wikipedia:Gebruiker cdo
Category:User cdo-N	Categorie:Wikipedia:Gebruiker cdo-M
Category:應用科學	Categorie:Toegepaste wetenschap
Category:中華當世諸省	Categorie:Provincie van China
Category:輿圖學	Categorie:Cartografie
Category:西安市	Categorie:Xi'an
Template:Image label begin	Sjabloon:Afbeelding label begin
Category:儒家	Categorie:Confucianisme
Category:民法	Categorie:Burgerlijk recht
Category:廿四史	Categorie:Vierentwintig Geschiedenissen
Category:User cmn	Categorie:Wikipedia:Gebruiker cmn
Category:User lzh	Categorie:Wikipedia:Gebruiker lzh
Category:User en-1	Categorie:Wikipedia:Gebruiker en-1
Category:User de-1	Categorie:Wikipedia:Gebruiker de-1
Category:語言標示模	Categorie:Wikipedia:Sjablonen ISO-639
Category:非洲史	Categorie:Geschiedenis van Afrika
雨冰	IJzel
Template:海王星之衛星	Sjabloon:Navigatie manen Neptunus
維基大典:驛站	Wikipedia:Archief/Wikipedia:TourBus - Bushalte Wikipedia NL
Template:湖北行政區劃	Sjabloon:Navigatie provincie Hubei
Template:法國二戰期間的坦克與裝甲車	Sjabloon:Navigatie gevechtsvoertuigen Frankrijk Tweede Wereldoorlog
Template:Multi-listen item	Sjabloon:Multi-listen item
Template:Style/IPA	Sjabloon:Style/IPA
Template:Style/yid	Sjabloon:Style/yid
麗水市	Lishui
Special:近易	Speciaal:RecenteWijzigingen
Module:String	Module:String
雨傘運動	Protesten in Hongkong in 2014
代言 (動漫)	Mascotte (symbool)
